"yday","location","time","location_total.counts","positive.counts","negative.counts","neutral.counts","counts","lon","lat"
221,"ATLANTA GA",1,7,2,4,1,7,-84.38757324,33.74927521
221,"AUSTIN TX",1,2,0,1,1,2,-97.74386597,30.26748466
221,"BALTIMORE MD",1,2,0,2,0,2,-76.6115799,39.29075623
221,"BEAVERTON OR",1,2,0,1,1,2,-122.8055344,45.48670197
221,"BOSTON MA",1,2,0,1,1,2,-71.05905151,42.35883713
221,"BOULDER CO",1,1,0,0,1,1,-105.2715302,40.01483917
221,"CHARLOTTE NC",1,2,1,0,1,2,-80.84257507,35.22746277
221,"CHESAPEAKE VA",1,1,0,0,1,1,-76.27422333,36.81948853
221,"CHICAGO IL",1,4,1,2,1,4,-87.6503067,41.85000992
221,"CINCINNATI OH",1,1,0,1,0,1,-84.51939392,39.10413742
221,"COLUMBIA MO",1,1,0,0,1,1,-92.33429718,38.95169067
221,"COLUMBIA SC",1,1,1,0,0,1,-81.04045105,34.00138855
221,"COLUMBUS OH",1,5,1,3,1,5,-82.99890137,39.96136475
221,"DALLAS TX",1,3,0,1,2,3,-96.80088043,32.78369904
221,"DAYTON OH",1,4,0,3,1,4,-84.19126892,39.75915146
221,"DEBARY FL",1,1,0,1,0,1,-81.30838776,28.88345909
221,"DENVER CO",1,1,0,1,0,1,-104.9853745,39.73901749
221,"DERBY KS",1,1,0,0,1,1,-97.26980591,37.54567719
221,"FEDERAL WAY WA",1,2,1,0,1,2,-122.314415,47.32177734
221,"FLINT MI",1,1,0,1,0,1,-83.68744659,43.01246643
221,"FREEPORT IL",1,1,0,0,1,1,-89.62126923,42.29691696
221,"GREENVILLE SC",1,1,0,0,1,1,-82.39870453,34.84753418
221,"HOUSTON TX",1,2,0,1,1,2,-95.36399841,29.76376343
221,"JERSEY CITY NJ",1,1,0,0,1,1,-74.07667542,40.72816849
221,"KANSAS CITY MO",1,2,0,1,1,2,-94.57884979,39.09976578
221,"LOS ANGELES CA",1,5,0,3,2,5,-118.2459106,34.05225754
221,"MIAMI FL",1,1,0,0,1,1,-80.19329071,25.77483749
221,"MINNEAPOLIS MN",1,1,0,1,0,1,-93.26397705,44.97980118
221,"NEW CASTLE DE",1,2,0,1,1,2,-75.56227875,39.66440964
221,"NEW YORK NY",1,4,0,3,1,4,-74.00528717,40.7145195
221,"OAKLAND CA",1,1,0,1,0,1,-122.2733154,37.80438614
221,"PONTIAC MI",1,3,0,2,1,3,-83.29104614,42.63900757
221,"PORTLAND OR",1,2,0,1,1,2,-122.6786423,45.52309418
221,"POWDER SPRINGS GA",1,1,1,0,0,1,-84.68379974,33.8599205
221,"SACRAMENTO CA",1,1,0,1,0,1,-121.4959793,38.58154297
221,"ST LOUIS MO",1,30,6,7,17,30,-90.19819641,38.62716675
221,"TAMPA FL",1,2,1,0,1,2,-82.4580307,27.94833755
221,"VIRGINIA BEACH VA",1,4,1,2,1,4,-75.97751617,36.8533783
221,"WASHINGTON DC",1,11,2,6,3,11,-77.01257324,38.88911819
221,"WILMINGTON DE",1,1,0,0,1,1,-75.54558563,39.74601364
222,"ABERDEEN MD",2,1,0,1,0,1,-76.16343689,39.50980759
222,"ABILENE TX",2,3,1,1,1,3,-99.73384094,32.44894028
222,"ADA OK",2,1,0,1,0,1,-96.67899323,34.77481842
222,"ADDISON TX",2,1,1,0,0,1,-96.82976532,32.96215057
222,"AIKEN SC",2,1,0,1,0,1,-81.71619415,33.55714417
222,"AKRON OH",2,18,4,7,7,18,-81.51885223,41.08151627
222,"ALAMEDA CA",2,3,1,1,1,3,-122.2444763,37.76513672
222,"ALAMOGORDO NM",2,1,0,1,0,1,-105.9584656,32.90003967
222,"ALAMOSA CO",2,2,0,0,2,2,-105.8724442,37.46229935
222,"ALBANY GA",2,1,0,1,0,1,-84.15510559,31.58296013
222,"ALBANY NY",2,2,0,0,2,2,-73.75520325,42.6529007
222,"ALBUQUERQUE NM",2,20,2,9,9,20,-106.6517639,35.08336639
222,"ALEXANDRIA VA",2,30,9,9,12,30,-77.04605103,38.80503082
222,"ALLEN TX",2,1,0,1,0,1,-96.67116547,33.10336685
222,"ALLENTOWN PA",2,1,0,1,0,1,-75.46569824,40.60851288
222,"ALPENA MI",2,8,2,4,2,8,-83.43292999,45.06164551
222,"AMARILLO TX",2,2,0,2,0,2,-101.8324051,35.22210312
222,"AMERICUS GA",2,1,0,1,0,1,-84.23246002,32.07291031
222,"AMES IA",2,2,1,1,0,2,-93.61370087,42.02269363
222,"AMHERST MA",2,2,0,0,2,2,-72.5192337,42.37371826
222,"AMORY MS",2,3,1,1,1,3,-88.48745728,33.98094559
222,"ANAHEIM CA",2,5,1,2,2,5,-117.9165115,33.8354454
222,"ANCHORAGE AK",2,27,7,17,3,27,-149.8811951,61.21649933
222,"ANDERSON IN",2,1,0,0,1,1,-85.68051147,40.1053772
222,"ANN ARBOR MI",2,24,1,11,12,24,-83.74536896,42.28347015
222,"ANNAPOLIS MD",2,1,1,0,0,1,-76.49166107,38.97844696
222,"ANSONIA CT",2,1,0,1,0,1,-73.0779953,41.34640884
222,"ANTIOCH CA",2,1,0,1,0,1,-121.808136,38.0049057
222,"APEX NC",2,1,0,0,1,1,-78.84952545,35.73279572
222,"APPLE VALLEY MN",2,8,1,3,4,8,-93.21794128,44.73189926
222,"APPLETON WI",2,1,0,1,0,1,-88.41551208,44.2618866
222,"ARCATA CA",2,2,0,0,2,2,-124.08564,40.86624527
222,"ARDMORE OK",2,3,1,0,2,3,-97.14401245,34.17425156
222,"ARGONNE WI",2,1,0,1,0,1,-88.87945557,45.65941238
222,"ARLINGTON TN",2,2,0,1,1,2,-89.66139984,35.29637527
222,"ARLINGTON TX",2,17,8,4,5,17,-97.10882568,32.73590469
222,"ARNAUDVILLE LA",2,1,0,0,1,1,-91.93197632,30.39797974
222,"ASHEVILLE NC",2,6,1,4,1,6,-82.55367279,35.60134888
222,"ASHLAND OR",2,5,2,2,1,5,-122.7111359,42.19425583
222,"ASHLEY IN",2,2,0,0,2,2,-85.06525421,41.52718735
222,"ASPEN CO",2,1,0,0,1,1,-106.8185959,39.19105911
222,"ATHENS OH",2,5,2,2,1,5,-82.10113525,39.32934952
222,"ATLANTA GA",2,545,124,215,206,545,-84.38757324,33.74927521
222,"ATLANTIC CITY NJ",2,4,1,1,2,4,-74.42202759,39.36457062
222,"ATTLEBORO MA",2,1,0,1,0,1,-71.28439331,41.94469833
222,"AUBURN AL",2,2,0,1,1,2,-85.48087311,32.61021423
222,"AUBURN WA",2,2,0,1,1,2,-122.2304688,47.30677795
222,"AURORA CO",2,10,2,8,0,10,-104.8693161,39.73983765
222,"AUSTELL GA",2,1,1,0,0,1,-84.63414001,33.81290054
222,"AUSTIN TX",2,124,32,36,56,124,-97.74386597,30.26748466
222,"AUSTINTOWN OH",2,1,0,1,0,1,-80.76424408,41.10162354
222,"AVALON CA",2,1,0,0,1,1,-118.329773,33.34281921
222,"BAKERSFIELD CA",2,2,0,1,1,2,-119.0206375,35.37326813
222,"BALLWIN MO",2,1,0,0,1,1,-90.54669189,38.5951004
222,"BALTIMORE MD",2,235,45,111,79,235,-76.6115799,39.29075623
222,"BARTLETT IL",2,1,0,1,0,1,-88.18564606,41.9950676
222,"BARTLETT TN",2,4,1,2,1,4,-89.87441254,35.20460892
222,"BARTONVILLE IL",2,5,2,1,2,5,-89.65235138,40.6502037
222,"BATON ROUGE LA",2,21,5,7,9,21,-91.15479279,30.45132256
222,"BAXTER SPRINGS KS",2,3,2,0,1,3,-94.73813629,37.02472305
222,"BAY VILLAGE OH",2,1,1,0,0,1,-81.92155457,41.48464966
222,"BAYTOWN TX",2,6,3,3,0,6,-94.97782135,29.73608589
222,"BEAUMONT TX",2,2,0,0,2,2,-94.10238647,30.08622551
222,"BEAVERTON OR",2,13,4,5,4,13,-122.8055344,45.48670197
222,"BEDFORD IN",2,1,0,1,0,1,-86.48697662,38.86146164
222,"BELL CA",2,3,0,2,1,3,-118.1889572,33.97753906
222,"BELLEFONTAINE OH",2,1,0,1,0,1,-83.75959015,40.36141205
222,"BELLEVILLE IL",2,4,1,1,2,4,-89.98438263,38.52002716
222,"BELLEVUE NE",2,1,0,1,0,1,-95.89156342,41.13648224
222,"BELLINGHAM WA",2,2,0,1,1,2,-122.4727402,48.76121521
222,"BELVIDERE IL",2,1,0,1,0,1,-88.84451294,42.26396942
222,"BEMIDJI MN",2,1,0,1,0,1,-94.88105774,47.47352982
222,"BEND OR",2,4,0,3,1,4,-121.3171387,44.0577774
222,"BENICIA CA",2,1,0,0,1,1,-122.1603012,38.04900742
222,"BENTON HARBOR MI",2,1,0,1,0,1,-86.45429993,42.11692429
222,"BENTONVILLE AR",2,1,1,0,0,1,-94.20933533,36.3728447
222,"BEREA KY",2,2,0,1,1,2,-84.29612732,37.5687027
222,"BERKELEY CA",2,51,14,18,19,51,-122.2752533,37.87145615
222,"BERKELEY MO",2,4,1,2,1,4,-90.33169556,38.75470734
222,"BESSEMER AL",2,2,0,1,1,2,-86.95465851,33.40222549
222,"BETHLEHEM PA",2,2,0,1,1,2,-75.36949921,40.62598801
222,"BEVERLY HILLS CA",2,13,1,5,7,13,-118.4019775,34.07383347
222,"BILOXI MS",2,2,1,1,0,2,-88.89369202,30.40021133
222,"BINGHAMTON NY",2,2,0,2,0,2,-75.91755676,42.0986557
222,"BIRMINGHAM AL",2,36,11,19,6,36,-86.80226898,33.52098846
222,"BLACKSBURG VA",2,6,0,5,1,6,-80.41369629,37.22999573
222,"BLADENSBURG MD",2,1,0,1,0,1,-76.9335556,38.93954849
222,"BLOOMINGTON IL",2,1,0,0,1,1,-88.99375916,40.48418045
222,"BLOOMINGTON IN",2,2,0,1,1,2,-86.53382874,39.16920471
222,"BLOOMINGTON MN",2,2,0,2,0,2,-93.29154205,44.82648849
222,"BLUFF CITY TN",2,2,0,0,2,2,-82.26051331,36.47451019
222,"BOCA RATON FL",2,3,1,0,2,3,-80.08280182,26.35960197
222,"BOLINGBROOK IL",2,1,0,0,1,1,-88.06878662,41.69866562
222,"BOSTON MA",2,148,32,60,56,148,-71.05905151,42.35883713
222,"BOULDER CO",2,2,1,0,1,2,-105.2715302,40.01483917
222,"BOWIE MD",2,17,5,7,5,17,-76.77848816,39.00718689
222,"BRADLEY IL",2,1,0,1,0,1,-87.86099243,41.14196014
222,"BRANDON MS",2,1,1,0,0,1,-89.98616028,32.27327728
222,"BRIDGEPORT CT",2,9,1,2,6,9,-73.2040863,41.16743088
222,"BRIGHTON MI",2,1,0,1,0,1,-83.78043365,42.52965546
222,"BRISTOL CT",2,16,3,9,4,16,-72.94853973,41.67193222
222,"BROCKTON MA",2,4,2,1,1,4,-71.01748657,42.08340454
222,"BROOKINGS OR",2,2,2,0,0,2,-124.2865219,42.05229187
222,"BROOKLYN PARK MN",2,3,2,1,0,3,-93.35662079,45.09407043
222,"BROOMFIELD CO",2,2,0,1,1,2,-105.0877686,39.92069244
222,"BRYAN TX",2,16,14,2,0,16,-96.3704071,30.67456818
222,"BUENA PARK CA",2,1,0,1,0,1,-117.999939,33.86748123
222,"BUFFALO NY",2,18,3,11,4,18,-78.87787628,42.8867836
222,"BURBANK CA",2,1,0,1,0,1,-118.3104782,34.18065262
222,"BURLINGAME CA",2,1,0,1,0,1,-122.3685074,37.58408737
222,"BURLINGTON VT",2,5,1,2,2,5,-73.20542908,44.47687531
222,"BURNSVILLE NC",2,1,0,1,0,1,-82.30067444,35.91744614
222,"BUTLER PA",2,3,0,3,0,3,-79.89468384,40.86117172
222,"BYRON WY",2,2,0,2,0,2,-108.5082169,44.79620361
222,"CALHOUN GA",2,1,0,1,0,1,-84.95102692,34.50297165
222,"CAMBRIDGE MA",2,16,3,11,2,16,-71.10369873,42.36532593
222,"CAMDEN AR",2,1,0,1,0,1,-92.83481598,33.58491898
222,"CAMDEN NJ",2,11,1,5,5,11,-75.118927,39.92608261
222,"CAMDEN SC",2,1,0,0,1,1,-80.60647583,34.24704742
222,"CANTON OH",2,1,0,1,0,1,-81.37824249,40.79906845
222,"CAPE GIRARDEAU MO",2,1,0,1,0,1,-89.51838684,37.30613327
222,"CAPITOL HEIGHTS MD",2,3,0,2,1,3,-76.91506195,38.88552475
222,"CARBONDALE IL",2,2,0,1,1,2,-89.2168808,37.7274704
222,"CARLISLE PA",2,1,0,0,1,1,-77.18848419,40.20173264
222,"CARMEL IN",2,1,0,1,0,1,-86.12607574,39.97961426
222,"CARRBORO NC",2,2,1,0,1,2,-79.07286835,35.91213989
222,"CARROLLTON GA",2,2,0,2,0,2,-85.07631683,33.58019638
222,"CARROLLTON TX",2,1,1,0,0,1,-96.89080811,32.95380783
222,"CARY NC",2,9,0,4,5,9,-78.78055573,35.79200745
222,"CASA GRANDE AZ",2,4,1,1,2,4,-111.7590179,32.87965393
222,"CAYCE SC",2,1,1,0,0,1,-81.05870819,33.97318649
222,"CENTREVILLE IL",2,1,1,0,0,1,-90.12549591,38.58330154
222,"CHAMPAIGN IL",2,4,1,2,1,4,-88.24346161,40.11659622
222,"CHANDLER AZ",2,1,0,1,0,1,-111.8428345,33.3062439
222,"CHANUTE KS",2,1,0,1,0,1,-95.45789337,37.67946243
222,"CHAPEL HILL NC",2,45,10,22,13,45,-79.05697632,35.91110611
222,"CHARLESTON SC",2,28,9,12,7,28,-79.93032074,32.77671814
222,"CHARLOTTE NC",2,220,42,95,83,220,-80.84257507,35.22746277
222,"CHARLOTTESVILLE VA",2,25,7,12,6,25,-78.49123383,38.03798676
222,"CHATTANOOGA TN",2,10,0,7,3,10,-85.30583954,35.04058456
222,"CHEEKTOWAGA NY",2,1,0,1,0,1,-78.75413513,42.90357208
222,"CHESAPEAKE VA",2,36,14,11,11,36,-76.27422333,36.81948853
222,"CHESTER PA",2,1,0,1,0,1,-75.35475159,39.84973145
222,"CHESTERFIELD MO",2,1,0,0,1,1,-90.5772934,38.6631279
222,"CHEVY CHASE MD",2,8,3,1,4,8,-77.07595825,38.97138977
222,"CHICAGO IL",2,478,92,216,170,478,-87.6503067,41.85000992
222,"CHICO CA",2,102,19,51,32,102,-121.839447,39.72846222
222,"CHULA VISTA CA",2,3,1,0,2,3,-117.0857468,32.64037704
222,"CINCINNATI OH",2,57,14,28,15,57,-84.51939392,39.10413742
222,"CITRUS HEIGHTS CA",2,1,1,0,0,1,-121.2829208,38.70672607
222,"CLARKSDALE MS",2,1,0,1,0,1,-90.57128143,34.20030212
222,"CLARKSVILLE TN",2,5,0,1,4,5,-87.35944366,36.52993011
222,"CLAYTON MO",2,2,1,1,0,2,-90.32382965,38.64260101
222,"CLEAR LAKE SHORES TX",2,9,2,4,3,9,-95.03226471,29.54773712
222,"CLEARFIELD UT",2,1,0,0,1,1,-112.0273361,41.11647415
222,"CLEMSON SC",2,6,3,2,1,6,-82.83683014,34.68382645
222,"CLEVELAND OH",2,79,18,34,27,79,-81.69516754,41.49978256
222,"CLINTON MS",2,2,0,1,1,2,-90.33226776,32.34069061
222,"CLINTON SC",2,2,1,1,0,2,-81.88014984,34.47286224
222,"COCOA BEACH FL",2,1,0,1,0,1,-80.6068573,28.3203907
222,"COLLEGE PARK GA",2,11,1,9,1,11,-84.44933319,33.65347672
222,"COLLEGE PARK MD",2,7,2,4,1,7,-76.93619537,38.98080444
222,"COLLEGE STATION TX",2,2,0,1,1,2,-96.33758545,30.62316895
222,"COLLEGEDALE TN",2,1,0,0,1,1,-85.05016327,35.0533371
222,"COLORADO SPRINGS CO",2,8,0,7,1,8,-104.8225174,38.83369446
222,"COLUMBIA KY",2,1,0,0,1,1,-85.30601501,37.10298538
222,"COLUMBIA MO",2,26,7,12,7,26,-92.33429718,38.95169067
222,"COLUMBIA SC",2,28,4,9,15,28,-81.04045105,34.00138855
222,"COLUMBUS GA",2,3,0,1,2,3,-84.98313141,32.46828842
222,"COLUMBUS MS",2,1,0,0,1,1,-88.42742157,33.49581909
222,"COLUMBUS OH",2,92,11,40,41,92,-82.99890137,39.96136475
222,"COMPTON CA",2,12,5,5,2,12,-118.2218704,33.89606857
222,"CONCORD NC",2,3,1,1,1,3,-80.57880402,35.4092598
222,"CONWAY AR",2,2,0,1,1,2,-92.4426651,35.08877563
222,"CONYERS GA",2,1,0,1,0,1,-84.0175705,33.66764832
222,"COOKEVILLE TN",2,1,0,1,0,1,-85.50189972,36.16290665
222,"CORONA CA",2,9,2,3,4,9,-117.5688171,33.87516785
222,"CORPUS CHRISTI TX",2,3,0,2,1,3,-97.42076874,27.77859879
222,"CORTLAND NY",2,1,0,0,1,1,-76.17972565,42.60138702
222,"CORVALLIS OR",2,3,0,1,2,3,-123.2646637,44.56417084
222,"COSTA MESA CA",2,1,1,0,0,1,-117.9204407,33.64131927
222,"COVINGTON LA",2,1,0,0,1,1,-90.10121918,30.475914
222,"CRESTON IA",2,1,0,1,0,1,-94.3616333,41.05845642
222,"CREVE COEUR MO",2,1,1,0,0,1,-90.42288971,38.66108322
222,"CROTON-ON-HUDSON NY",2,1,0,0,1,1,-73.89041901,41.2085762
222,"CROWN POINT IN",2,1,0,1,0,1,-87.36541748,41.41695023
222,"CUMMING GA",2,1,0,1,0,1,-84.1401825,34.2074852
222,"CUYAHOGA FALLS OH",2,6,4,2,0,6,-81.48397064,41.1338768
222,"DALLAS TX",2,191,30,78,83,191,-96.80088043,32.78369904
222,"DALY CITY CA",2,4,0,1,3,4,-122.4645081,37.70376968
222,"DANVILLE IL",2,1,1,0,0,1,-87.62978363,40.12442398
222,"DARLINGTON SC",2,1,0,0,1,1,-79.86645508,34.30082321
222,"DAVIDSON NC",2,1,0,0,1,1,-80.8433075,35.49843216
222,"DAVIE FL",2,1,1,0,0,1,-80.23148346,26.0657177
222,"DAVIS CA",2,3,0,0,3,3,-121.7421722,38.54467773
222,"DAYTON OH",2,23,4,9,10,23,-84.19126892,39.75915146
222,"DAYTONA BEACH FL",2,7,1,4,2,7,-81.02253723,29.21147537
222,"DEBARY FL",2,3,0,1,2,3,-81.30838776,28.88345909
222,"DECATUR GA",2,10,2,5,3,10,-84.29631805,33.77489471
222,"DECATUR IL",2,1,0,0,1,1,-88.95516968,39.84060287
222,"DELAWARE OH",2,2,1,1,0,2,-83.06757355,40.29886627
222,"DELRAY BEACH FL",2,2,0,1,1,2,-80.07209778,26.46233368
222,"DELTA CO",2,1,0,1,0,1,-108.0698395,38.74222946
222,"DENTON TX",2,6,0,5,1,6,-97.13349915,33.21514893
222,"DENVER CO",2,84,23,37,24,84,-104.9853745,39.73901749
222,"DES MOINES IA",2,5,2,0,3,5,-93.6210022,41.59817123
222,"DETROIT MI",2,142,23,64,55,142,-83.04567719,42.33172226
222,"DONIPHAN MO",2,1,0,1,0,1,-90.82394409,36.62110138
222,"DOUGLAS GA",2,9,2,5,2,9,-82.84980011,31.50903511
222,"DOVER DE",2,2,0,0,2,2,-75.52090454,39.15853882
222,"DOVER NH",2,5,0,2,3,5,-70.88840485,43.2059021
222,"DOYLESTOWN PA",2,1,0,1,0,1,-75.1292038,40.31054688
222,"DREW MS",2,1,0,1,0,1,-90.53083038,33.81049728
222,"DUBUQUE IA",2,1,0,1,0,1,-90.67155457,42.51130295
222,"DURANT OK",2,1,0,1,0,1,-96.37478638,33.99116135
222,"DURHAM NC",2,36,8,15,13,36,-78.89787292,35.99412918
222,"EAST LANSING MI",2,3,1,1,1,3,-84.48403931,42.73703384
222,"EAST ORANGE NJ",2,17,2,4,11,17,-74.21418762,40.76618958
222,"EAST PALO ALTO CA",2,2,0,1,1,2,-122.143013,37.46857452
222,"EAST POINT GA",2,2,2,0,0,2,-84.43933868,33.67996979
222,"EDEN PRAIRIE MN",2,5,1,0,4,5,-93.48716736,44.85310745
222,"EDINBURG TX",2,2,0,1,1,2,-98.16417694,26.30259705
222,"EDMOND OK",2,2,0,2,0,2,-97.48453522,35.65326309
222,"EDWARDSVILLE IL",2,6,1,3,2,6,-89.95322418,38.8115654
222,"EL CERRITO CA",2,2,0,1,1,2,-122.3142548,37.91544342
222,"EL MONTE CA",2,1,0,1,0,1,-118.0298996,34.06880569
222,"EL PASO TX",2,16,0,7,9,16,-106.4620514,31.78388405
222,"ELGIN IL",2,2,0,1,1,2,-88.28123474,42.03733444
222,"ELIZABETH CITY NC",2,1,1,0,0,1,-76.22274017,36.3025322
222,"ELIZABETH NJ",2,3,1,2,0,3,-74.21881866,40.66823578
222,"ELKHART IN",2,1,0,1,0,1,-85.97689056,41.68212128
222,"ENGLEWOOD CO",2,2,0,2,0,2,-104.9884491,39.6479187
222,"ERIE PA",2,8,1,3,4,8,-80.08492279,42.12926483
222,"EUGENE OR",2,6,0,5,1,6,-123.0898361,44.05194855
222,"EVANSTON IL",2,13,4,5,4,13,-87.69037628,42.04132843
222,"EVANSVILLE IN",2,4,1,0,3,4,-87.56850433,37.97795486
222,"EVERETT WA",2,1,0,1,0,1,-122.2045441,47.97843552
222,"FAIR HAVEN NJ",2,3,0,0,3,3,-74.03659821,40.35977936
222,"FAIRBANKS AK",2,2,0,1,1,2,-147.7185669,64.83367157
222,"FAIRBURN GA",2,1,0,1,0,1,-84.58108521,33.56713867
222,"FAIRFAX VA",2,3,0,1,2,3,-77.30588531,38.84661865
222,"FAIRFIELD OH",2,3,1,1,1,3,-84.56064606,39.34600449
222,"FARGO ND",2,7,1,2,4,7,-96.79805756,46.87498474
222,"FARMINGTON HILLS MI",2,1,0,1,0,1,-83.3771286,42.48558807
222,"FARMINGTON MO",2,3,0,0,3,3,-90.4220047,37.78110504
222,"FAYETTEVILLE AR",2,2,0,0,2,2,-94.15759277,36.06256104
222,"FAYETTEVILLE NC",2,6,2,1,3,6,-78.87771606,35.05313873
222,"FEDERAL WAY WA",2,9,3,2,4,9,-122.314415,47.32177734
222,"FERGUSON MO",2,10,2,3,5,10,-90.306633,38.74429321
222,"FERNDALE WA",2,1,0,0,1,1,-122.5937119,48.84636688
222,"FINDLAY OH",2,1,0,1,0,1,-83.64990997,41.04424286
222,"FLINT MI",2,15,3,7,5,15,-83.68744659,43.01246643
222,"FLORENCE SC",2,1,0,1,0,1,-79.76351166,34.19935226
222,"FLORISSANT MO",2,13,2,7,4,13,-90.32299042,38.78946304
222,"FOREST PARK IL",2,1,0,1,0,1,-87.81355286,41.87948608
222,"FORKS WA",2,1,0,0,1,1,-124.3879929,47.94977951
222,"FORT ATKINSON WI",2,1,0,0,1,1,-88.83695984,42.92907715
222,"FORT COLLINS CO",2,2,0,2,0,2,-105.0858688,40.58546066
222,"FORT LAUDERDALE FL",2,31,8,16,7,31,-80.14283752,26.12309074
222,"FORT MYERS FL",2,5,0,3,2,5,-81.87184143,26.64133644
222,"FORT SMITH AR",2,1,1,0,0,1,-94.39919281,35.3862114
222,"FORT VALLEY GA",2,1,0,1,0,1,-83.88742828,32.5541687
222,"FORT WALTON BEACH FL",2,2,0,1,1,2,-86.61834717,30.40767479
222,"FORT WAYNE IN",2,3,1,2,0,3,-85.13967896,41.07278061
222,"FORT WORTH TX",2,36,5,16,15,36,-97.32135773,32.72562027
222,"FRANKFORT KY",2,2,1,0,1,2,-84.87322235,38.20124054
222,"FREDERICK MD",2,1,0,1,0,1,-77.40981293,39.41444397
222,"FREMONT CA",2,4,0,1,3,4,-121.9740372,37.55101776
222,"FRESNO CA",2,10,2,3,5,10,-119.7739868,36.74755478
222,"FRIDLEY MN",2,1,0,1,0,1,-93.2636261,45.08617401
222,"FULLERTON CA",2,2,1,0,1,2,-117.9268646,33.87014771
222,"GAINESVILLE FL",2,15,3,6,6,15,-82.32462311,29.65203285
222,"GAINESVILLE GA",2,1,0,1,0,1,-83.82389832,34.29787827
222,"GALESBURG IL",2,1,0,1,0,1,-90.37152863,40.9480629
222,"GALLATIN TN",2,1,0,0,1,1,-86.44691467,36.38848495
222,"GARDEN CITY NY",2,1,0,0,1,1,-73.63320923,40.72684097
222,"GARDEN GROVE CA",2,4,2,1,1,4,-117.943718,33.77397156
222,"GARLAND TX",2,1,0,1,0,1,-96.63926697,32.91297531
222,"GARY IN",2,1,0,0,1,1,-87.33873749,41.59325409
222,"GENEVA OH",2,1,0,1,0,1,-80.94763184,41.80530167
222,"GEORGETOWN TX",2,1,0,0,1,1,-97.67801666,30.6329689
222,"GLENDALE CA",2,2,0,1,1,2,-118.2566681,34.1423645
222,"GONZALES LA",2,1,0,0,1,1,-90.92044067,30.23900986
222,"GOOSE CREEK SC",2,2,1,1,0,2,-80.03201294,32.98114395
222,"GRAND FORKS ND",2,2,0,2,0,2,-97.03855133,47.92044067
222,"GRAND JUNCTION CO",2,1,0,1,0,1,-108.5520706,39.06374741
222,"GRAND RAPIDS MI",2,17,4,6,7,17,-85.66797638,42.96317291
222,"GRANITE CITY IL",2,3,0,3,0,3,-90.14891815,38.70147705
222,"GRAPEVINE TX",2,1,0,1,0,1,-97.07859802,32.93464279
222,"GRAY COURT SC",2,1,0,0,1,1,-82.11286926,34.60851669
222,"GREEN BAY WI",2,2,0,0,2,2,-88.01370239,44.51335907
222,"GREENBELT MD",2,9,2,3,4,9,-76.87561035,39.00544357
222,"GREENEVILLE TN",2,1,0,1,0,1,-82.83133698,36.16376495
222,"GREENSBORO NC",2,37,5,14,18,37,-79.79152679,36.0729599
222,"GREENVILLE NC",2,6,2,4,0,6,-77.37215424,35.61170959
222,"GREENVILLE SC",2,29,2,16,11,29,-82.39870453,34.84753418
222,"GREENWOOD IN",2,1,0,1,0,1,-86.10647583,39.61371994
222,"GRIFFIN GA",2,1,0,0,1,1,-84.26403046,33.24713135
222,"GRIFFITH IN",2,1,0,1,0,1,-87.42803955,41.52181625
222,"GROTON CT",2,2,1,0,1,2,-72.07763672,41.3502121
222,"GULF SHORES AL",2,1,1,0,0,1,-87.70103455,30.24625969
222,"GULFPORT MS",2,6,2,3,1,6,-89.09369659,30.37276649
222,"HADDONFIELD NJ",2,2,0,1,1,2,-75.03710937,39.89155197
222,"HAGERSTOWN MD",2,1,0,1,0,1,-77.71956635,39.641819
222,"HALLSTEAD PA",2,2,0,2,0,2,-75.74239349,41.96153259
222,"HAMMOND IN",2,7,1,2,4,7,-87.50006104,41.58346558
222,"HAMMOND LA",2,7,3,2,2,7,-90.46140289,30.50458908
222,"HAMPTON VA",2,2,0,1,1,2,-76.34473419,37.03002548
222,"HANOVER PA",2,1,0,1,0,1,-76.98248291,39.80073929
222,"HARKER HEIGHTS TX",2,3,2,0,1,3,-97.66394806,31.08788109
222,"HARTFORD CT",2,9,0,3,6,9,-72.68445587,41.76383591
222,"HARTLEY IA",2,1,0,1,0,1,-95.4770813,43.18453598
222,"HASTINGS NE",2,3,2,0,1,3,-98.38917542,40.58628845
222,"HATTIESBURG MS",2,6,0,2,4,6,-89.29040527,31.32738686
222,"HAWTHORNE CA",2,1,1,0,0,1,-118.3549194,33.91656113
222,"HAWTHORNE NJ",2,10,0,8,2,10,-74.15322876,40.94930649
222,"HAYWARD CA",2,1,0,1,0,1,-122.0832672,37.66890335
222,"HELENA MT",2,2,1,0,1,2,-112.0374527,46.59269333
222,"HENDERSON NV",2,7,3,1,3,7,-114.9741058,36.03540421
222,"HENDERSON TN",2,1,0,0,1,1,-88.64147949,35.43937683
222,"HENRIETTA NY",2,1,0,1,0,1,-77.61167145,43.05939865
222,"HERNANDO MS",2,16,0,14,2,16,-89.99411774,34.82405853
222,"HERRIN IL",2,1,0,0,1,1,-89.02784729,37.80303574
222,"HICKORY NC",2,1,0,0,1,1,-81.34054565,35.72800827
222,"HIGH POINT NC",2,2,0,1,1,2,-80.00497437,35.95609665
222,"HIGHLAND CA",2,2,1,1,0,2,-117.2105789,34.12824631
222,"HILLSBORO OH",2,2,0,2,0,2,-83.61119843,39.20261765
222,"HOBOKEN NJ",2,2,0,1,1,2,-74.0316925,40.7443428
222,"HOLLYWOOD FL",2,12,4,7,1,12,-80.14926147,26.01175499
222,"HOMESTEAD FL",2,1,0,0,1,1,-80.47710419,25.46927071
222,"HOMEWOOD AL",2,2,1,1,0,2,-86.80097961,33.47186661
222,"HOPE MILLS NC",2,1,0,1,0,1,-78.94456482,34.97066498
222,"HORN LAKE MS",2,1,0,0,1,1,-90.03000641,34.96072769
222,"HOUGHTON MI",2,2,0,1,1,2,-88.56951141,47.12665558
222,"HOUMA LA",2,1,0,1,0,1,-90.71982574,29.59630585
222,"HOUSTON TX",2,286,50,127,109,286,-95.36399841,29.76376343
222,"HUNTINGTON BEACH CA",2,5,0,4,1,5,-118.0006027,33.66012955
222,"HUNTINGTON NY",2,1,0,0,1,1,-73.42463684,40.86833191
222,"HUNTINGTON WV",2,3,2,0,1,3,-82.44620514,38.4181366
222,"HUNTSVILLE AL",2,16,3,8,5,16,-86.58609772,34.73073959
222,"HUTCHINSON KS",2,2,0,1,1,2,-97.93050385,38.06093216
222,"HYATTSVILLE MD",2,1,0,0,1,1,-76.94467163,38.95636749
222,"INDIANA PA",2,1,0,1,0,1,-79.15187073,40.6216507
222,"INDIANAPOLIS IN",2,50,11,15,24,50,-86.15828705,39.76844788
222,"INGLEWOOD CA",2,15,3,6,6,15,-118.354805,33.96157074
222,"INGLIS FL",2,2,1,0,1,2,-82.66842651,29.03089333
222,"IOWA CITY IA",2,8,2,4,2,8,-91.53023529,41.66130066
222,"IRVING TX",2,4,1,0,3,4,-96.94924927,32.81419754
222,"ISSAQUAH WA",2,7,0,3,4,7,-122.0345993,47.52977753
222,"ITHACA NY",2,5,2,1,2,5,-76.49575043,42.44075775
222,"ITTA BENA MS",2,1,0,1,0,1,-90.32006073,33.49521255
222,"JACKSON AL",2,1,0,1,0,1,-87.89234924,31.51841354
222,"JACKSON MS",2,36,5,14,17,36,-90.19654846,32.298172
222,"JACKSON TN",2,1,0,1,0,1,-88.81397247,35.61472321
222,"JACKSON WY",2,1,0,0,1,1,-110.7644806,43.4798851
222,"JACKSONVILLE BEACH FL",2,6,3,3,0,6,-81.39300537,30.29505539
222,"JACKSONVILLE FL",2,34,7,14,13,34,-81.65545654,30.33253288
222,"JACKSONVILLE NC",2,1,0,1,0,1,-77.42939758,34.75283813
222,"JANESVILLE WI",2,1,0,1,0,1,-89.01893616,42.68303299
222,"JEFFERSON CITY MO",2,1,0,0,1,1,-92.17385864,38.57698441
222,"JENNINGS MO",2,1,1,0,0,1,-90.26077271,38.71944046
222,"JERSEY CITY NJ",2,33,9,11,13,33,-74.07667542,40.72816849
222,"JOHNSON CITY TN",2,2,0,1,1,2,-82.35308075,36.31352615
222,"JOLIET IL",2,3,0,2,1,3,-88.08213043,41.52493668
222,"JONESBORO AR",2,1,0,1,0,1,-90.70430756,35.84226608
222,"JONESBORO GA",2,1,1,0,0,1,-84.35381317,33.52181625
222,"JONESBORO LA",2,1,0,0,1,1,-92.71629333,32.24162292
222,"JOPLIN MO",2,1,0,1,0,1,-94.5140686,37.08442688
222,"KALAMAZOO MI",2,20,5,6,9,20,-85.58725739,42.29179764
222,"KANSAS CITY MO",2,162,37,58,67,162,-94.57884979,39.09976578
222,"KATY TX",2,2,0,2,0,2,-95.82484436,29.78606224
222,"KENNER LA",2,1,0,0,1,1,-90.24167633,29.99442101
222,"KENNESAW GA",2,1,0,0,1,1,-84.61528015,34.02365875
222,"KENT OH",2,2,0,1,1,2,-81.35736084,41.15368271
222,"KEY WEST FL",2,2,1,1,0,2,-81.78218079,24.556427
222,"KEYSTONE HEIGHTS FL",2,2,0,0,2,2,-82.03114319,29.78640366
222,"KILLEEN TX",2,3,1,2,0,3,-97.72832489,31.11753464
222,"KINGSTON NY",2,1,0,0,1,1,-73.99665833,41.92714691
222,"KINLOCH MO",2,3,1,0,2,3,-90.32682037,38.74011612
222,"KIRKLAND WA",2,2,0,2,0,2,-122.2108688,47.6813736
222,"KIRKWOOD MO",2,3,0,3,0,3,-90.40686798,38.5832901
222,"KISSIMMEE FL",2,6,1,3,2,6,-81.40729523,28.29271317
222,"KITTY HAWK NC",2,1,0,1,0,1,-75.70478058,36.06485367
222,"KNOXVILLE TN",2,20,5,9,6,20,-83.92067719,35.96077728
222,"LA CROSSE WI",2,1,0,1,0,1,-91.23967743,43.80151367
222,"LAFAYETTE CA",2,6,4,0,2,6,-122.1200104,37.88574982
222,"LAFAYETTE CO",2,1,0,1,0,1,-105.0904388,39.99370956
222,"LAFAYETTE LA",2,7,2,2,3,7,-92.01987457,30.22468185
222,"LAKE CHARLES LA",2,2,0,1,1,2,-93.21766663,30.22713852
222,"LAKE WORTH FL",2,1,0,1,0,1,-80.05649567,26.61662102
222,"LAKELAND FL",2,5,2,3,0,5,-81.95620728,28.04432487
222,"LAKEWOOD CA",2,1,0,1,0,1,-118.1357193,33.85370636
222,"LAKEWOOD CO",2,1,0,1,0,1,-105.0827332,39.70486069
222,"LAKEWOOD OH",2,6,1,1,4,6,-81.79773712,41.48223114
222,"LAMAR CO",2,1,0,0,1,1,-102.6111527,38.08679581
222,"LANCASTER CA",2,1,0,1,0,1,-118.1386871,34.69804001
222,"LANCASTER PA",2,3,1,1,1,3,-76.30498505,40.03824234
222,"LANDOVER HILLS MD",2,1,0,0,1,1,-76.89152527,38.94342804
222,"LANSDOWNE PA",2,2,0,1,1,2,-75.27108765,39.93852234
222,"LANSING MI",2,4,0,4,0,4,-84.55532074,42.73265839
222,"LAS VEGAS NV",2,96,28,30,38,96,-115.1382141,36.17488098
222,"LATROBE PA",2,1,1,0,0,1,-79.37892914,40.32139206
222,"LAUDERDALE LAKES FL",2,1,0,0,1,1,-80.20793915,26.1671524
222,"LAWRENCE KS",2,32,4,16,12,32,-95.23565674,38.97153091
222,"LAWRENCEBURG KY",2,1,0,1,0,1,-84.89624023,38.03728867
222,"LAWRENCEVILLE GA",2,1,0,1,0,1,-83.98753357,33.95662308
222,"LEESBURG VA",2,1,0,1,0,1,-77.56890869,39.11256027
222,"LELAND NC",2,1,0,1,0,1,-78.04415131,34.25672913
222,"LEWISVILLE TX",2,1,0,0,1,1,-96.99449921,33.04630661
222,"LILBURN GA",2,1,0,0,1,1,-84.14273834,33.89017868
222,"LIMA OH",2,1,0,1,0,1,-84.10490417,40.74259186
222,"LINCOLN NE",2,3,0,0,3,3,-96.6674118,40.80001068
222,"LITTLE ROCK AR",2,30,12,12,6,30,-92.28178406,34.7369194
222,"LIVERPOOL NY",2,1,0,1,0,1,-76.21547699,43.10769653
222,"LOGAN UT",2,1,0,1,0,1,-111.8171616,41.73900604
222,"LONG BEACH CA",2,28,7,12,9,28,-118.1908112,33.7670517
222,"LONG BRANCH NJ",2,1,0,0,1,1,-73.991745,40.30428314
222,"LONGMONT CO",2,2,0,2,0,2,-105.1026764,40.16700745
222,"LORAIN OH",2,1,0,1,0,1,-82.17118073,41.45874023
222,"LORIS SC",2,1,0,0,1,1,-78.89011383,34.05680084
222,"LOS ANGELES CA",2,444,87,184,173,444,-118.2459106,34.05225754
222,"LOWELL MA",2,2,0,2,0,2,-71.31530762,42.63344574
222,"LUBBOCK TX",2,1,0,1,0,1,-101.8544312,33.59677505
222,"LYNCHBURG VA",2,1,0,0,1,1,-79.14174652,37.41383362
222,"LYNDEN WA",2,11,1,5,5,11,-122.455101,48.94639969
222,"LYNNWOOD WA",2,2,0,1,1,2,-122.3175736,47.82042313
222,"LYNWOOD CA",2,2,1,1,0,2,-118.2135544,33.93053055
222,"MADISON IL",2,1,0,0,1,1,-90.15700531,38.68284988
222,"MADISON MS",2,1,0,1,0,1,-90.11543274,32.46231079
222,"MADISON WI",2,26,5,10,11,26,-89.40128326,43.07303619
222,"MANASSAS PARK VA",2,1,0,0,1,1,-77.46895599,38.7841301
222,"MANCHESTER NH",2,7,2,2,3,7,-71.45406342,42.99581528
222,"MANHATTAN BEACH CA",2,1,0,0,1,1,-118.4129181,33.88484192
222,"MANHATTAN KS",2,3,2,1,0,3,-96.57228851,39.18354034
222,"MANITOU SPRINGS CO",2,1,0,1,0,1,-104.9184494,38.85948944
222,"MANKATO MN",2,7,2,2,3,7,-94.02125549,44.15895462
222,"MANNING SC",2,3,1,1,1,3,-80.21025085,33.69546509
222,"MAPLE HEIGHTS OH",2,2,0,2,0,2,-81.5656662,41.41540146
222,"MAPLEWOOD MO",2,8,3,1,4,8,-90.32471466,38.6126976
222,"MAPLEWOOD NJ",2,4,2,1,1,4,-74.27243805,40.77401733
222,"MARIETTA GA",2,5,3,0,2,5,-84.54958344,33.9527359
222,"MARION OH",2,1,0,1,0,1,-83.12861633,40.58881378
222,"MARION SD",2,1,0,1,0,1,-97.25938416,43.4214325
222,"MARQUETTE MI",2,3,0,2,1,3,-87.39571381,46.54323196
222,"MARSHALL MN",2,1,0,0,1,1,-95.78921509,44.4466362
222,"MARTINSVILLE VA",2,1,0,1,0,1,-79.87229156,36.69199371
222,"MARYVILLE MO",2,3,0,3,0,3,-94.87281036,40.34609604
222,"MAYWOOD IL",2,1,0,1,0,1,-87.84314728,41.87941742
222,"MCKINNEY TX",2,3,0,3,0,3,-96.6155777,33.19782257
222,"MEDFORD MA",2,1,0,0,1,1,-71.10526276,42.41849518
222,"MEDFORD OR",2,3,1,1,1,3,-122.8773193,42.32625961
222,"MEDIA PA",2,1,0,0,1,1,-75.38693237,39.91692734
222,"MELBOURNE FL",2,2,1,1,0,2,-80.60625458,28.07838249
222,"MEMPHIS TN",2,84,20,32,32,84,-90.01696014,35.1194191
222,"MERCED CA",2,1,1,0,0,1,-120.4848785,37.30197525
222,"MESA AZ",2,3,1,2,0,3,-111.8239059,33.42222214
222,"MESQUITE TX",2,1,0,1,0,1,-96.59959412,32.76692581
222,"MIAMI BEACH FL",2,2,0,1,1,2,-80.12982178,25.79146576
222,"MIAMI FL",2,81,16,36,29,81,-80.19329071,25.77483749
222,"MIAMI SHORES FL",2,1,0,0,1,1,-80.19244385,25.8637619
222,"MIDDLETOWN OH",2,1,0,0,1,1,-84.39844513,39.51361084
222,"MIDLAND MI",2,1,0,1,0,1,-84.24700928,43.61585236
222,"MILFORD DE",2,1,0,0,1,1,-75.42737579,38.9128685
222,"MILFORD MI",2,1,0,1,0,1,-83.59909821,42.59347534
222,"MILWAUKEE WI",2,31,4,11,16,31,-87.90684509,43.03887939
222,"MINDEN LA",2,3,3,0,0,3,-93.28716278,32.61589432
222,"MINNEAPOLIS MN",2,56,5,28,23,56,-93.26397705,44.97980118
222,"MISSION SD",2,1,0,1,0,1,-100.6579437,43.30659866
222,"MISSOULA MT",2,1,0,0,1,1,-113.9832687,46.87278366
222,"MISSOURI CITY TX",2,1,0,1,0,1,-95.5381012,29.61878204
222,"MOBILE AL",2,6,1,4,1,6,-88.04309845,30.69476128
222,"MODESTO CA",2,3,0,1,2,3,-120.9991455,37.63897324
222,"MONROE LA",2,2,1,1,0,2,-92.11960602,32.50980759
222,"MONTCLAIR NJ",2,4,0,3,1,4,-74.20848083,40.82605362
222,"MONTEREY CA",2,2,1,1,0,2,-121.8974838,36.6002388
222,"MONTGOMERY AL",2,21,3,9,9,21,-86.29966736,32.36724472
222,"MORRISVILLE NC",2,1,1,0,0,1,-78.82486725,35.82374954
222,"MORRO BAY CA",2,2,0,2,0,2,-120.8519135,35.36568451
222,"MOULTRIE GA",2,1,0,0,1,1,-83.78891754,31.18035507
222,"MOUNT CLEMENS MI",2,1,0,1,0,1,-82.87785339,42.59724808
222,"MOUNT VERNON IN",2,1,1,0,0,1,-87.89586639,37.93523407
222,"MOUNT ZION IL",2,1,0,0,1,1,-88.87430573,39.77131271
222,"MOUNTAIN VIEW CA",2,8,2,1,5,8,-122.0861969,37.3859024
222,"MUNCIE IN",2,7,2,5,0,7,-85.38398743,40.18970871
222,"MURFREESBORO TN",2,4,2,0,2,4,-86.39038086,35.84575653
222,"MUSKEGON MI",2,2,0,0,1,1,-86.25441742,43.23139763
222,"MYRTLE BEACH SC",2,1,0,0,1,1,-78.88601685,33.69656372
222,"NAMPA ID",2,2,1,1,0,2,-116.5658188,43.54054642
222,"NAPERVILLE IL",2,2,0,0,2,2,-88.14768219,41.78578949
222,"NEOGA IL",2,1,0,0,1,1,-88.45291901,39.31969833
222,"NEW BEDFORD MA",2,1,0,0,1,1,-70.93328857,41.63626862
222,"NEW BRIGHTON MN",2,1,0,1,0,1,-93.19654083,45.06001663
222,"NEW BRUNSWICK NJ",2,1,0,1,0,1,-74.45104218,40.48620987
222,"NEW CASTLE DE",2,14,3,7,4,14,-75.56227875,39.66440964
222,"NEW HAVEN CT",2,12,1,6,5,12,-72.92726898,41.3084259
222,"NEW ORLEANS LA",2,132,30,50,52,132,-90.07525635,29.95483589
222,"NEW PALTZ NY",2,1,0,1,0,1,-74.08605194,41.74787903
222,"NEW PORT RICHEY FL",2,1,0,0,1,1,-82.71899414,28.24477577
222,"NEW YORK NY",2,302,74,111,117,302,-74.00528717,40.7145195
222,"NEWARK DE",2,15,2,10,3,15,-75.74462128,39.68774414
222,"NEWARK NJ",2,8,3,3,2,8,-74.17185211,40.73570633
222,"NEWARK NY",2,1,0,1,0,1,-77.09454346,43.04671097
222,"NEWARK OH",2,1,0,0,1,1,-82.40110779,40.05843353
222,"NEWBURGH NY",2,1,0,0,1,1,-74.00939941,41.50367737
222,"NEWPORT NEWS VA",2,5,1,3,1,5,-76.42758942,36.97909927
222,"NIAGARA FALLS NY",2,1,0,1,0,1,-79.05632019,43.09456253
222,"NICEVILLE FL",2,1,0,1,0,1,-86.50150299,30.52109146
222,"NILES MI",2,1,0,1,0,1,-86.25424194,41.82971573
222,"NIXA MO",2,1,0,0,1,1,-93.29502869,37.04324341
222,"NOBLESVILLE IN",2,1,0,1,0,1,-86.01766205,40.03728104
222,"NORFOLK VA",2,26,3,13,10,26,-76.28334045,36.84831619
222,"NORMAL IL",2,1,0,0,1,1,-88.99052429,40.51409912
222,"NORMAN OK",2,3,0,1,2,3,-97.44689178,35.22203827
222,"NORMANDY MO",2,2,0,0,2,2,-90.29716492,38.72553635
222,"NORTH AUGUSTA SC",2,3,0,2,1,3,-81.96509552,33.5021019
222,"NORTH BEND WA",2,3,1,2,0,3,-121.7899017,47.49547195
222,"NORTH BERGEN NJ",2,3,0,1,2,3,-74.0112381,40.8045845
222,"NORTH BRANCH MI",2,4,1,1,2,4,-83.19683838,43.22947311
222,"NORTH LAS VEGAS NV",2,3,1,2,0,3,-115.1192093,36.19900131
222,"NORTH LITTLE ROCK AR",2,1,0,0,1,1,-92.26677704,34.76465988
222,"NORTH MIAMI FL",2,1,1,0,0,1,-80.18624115,25.8908596
222,"NORTHAMPTON MA",2,4,2,0,2,4,-72.64012146,42.32544708
222,"NORWALK CT",2,5,0,0,5,5,-73.40729523,41.11759949
222,"NORWOOD OH",2,1,0,1,0,1,-84.45967865,39.15586853
222,"NOVATO CA",2,1,1,0,0,1,-122.576561,38.11727142
222,"NOVI MI",2,1,1,0,0,1,-83.47566223,42.48064423
222,"NUTLEY NJ",2,1,0,0,1,1,-74.15930939,40.82229996
222,"NYACK NY",2,1,0,1,0,1,-73.91687012,41.09091568
222,"O'FALLON MO",2,1,1,0,0,1,-90.69979095,38.8109436
222,"OAK LAWN IL",2,1,1,0,0,1,-87.7545929,41.721138
222,"OAKLAND CA",2,117,27,46,44,117,-122.2733154,37.80438614
222,"OCEAN SPRINGS MS",2,1,0,0,1,1,-88.82833862,30.41417313
222,"OCEANSIDE CA",2,7,2,3,2,7,-117.3814011,33.19587326
222,"OGALLALA NE",2,8,3,2,3,8,-101.7200775,41.1279068
222,"OGDEN UT",2,1,0,1,0,1,-111.9730225,41.22582626
222,"OKLAHOMA CITY OK",2,5,1,2,2,5,-97.51699829,35.46761322
222,"OLATHE KS",2,7,2,5,0,7,-94.81970215,38.88142395
222,"OLD ORCHARD BEACH ME",2,1,1,0,0,1,-70.37640381,43.51769257
222,"OLIVE BRANCH MS",2,1,1,0,0,1,-89.82355499,34.96377563
222,"OLYMPIA WA",2,2,0,2,0,2,-122.8909378,47.04053497
222,"OMAHA NE",2,19,2,7,10,19,-95.93825531,41.25878906
222,"ONTARIO CA",2,2,0,0,2,2,-117.6528702,34.06340408
222,"ORANGE CA",2,3,0,3,0,3,-117.8544846,33.7877388
222,"ORANGE CITY IA",2,6,1,3,2,6,-96.05925751,43.00707626
222,"ORLANDO FL",2,83,21,24,38,83,-81.3789978,28.53886795
222,"ORMOND BEACH FL",2,1,0,0,1,1,-81.05541992,29.28623772
222,"OSHKOSH WI",2,3,0,1,2,3,-88.54268646,44.02453613
222,"OSSINING NY",2,4,2,0,2,4,-73.86093903,41.16327286
222,"OTTUMWA IA",2,1,0,1,0,1,-92.41059113,41.01459122
222,"OVERLAND PARK KS",2,2,0,1,1,2,-94.67124939,38.98216248
222,"OXFORD MS",2,5,0,2,3,5,-89.52319336,34.37203979
222,"OXNARD CA",2,1,1,0,0,1,-119.1790085,34.19766998
222,"PALISADES PARK NJ",2,1,0,1,0,1,-73.9969635,40.84852982
222,"PALM BAY FL",2,3,0,2,1,3,-80.58313751,28.03806496
222,"PALM SPRINGS CA",2,1,0,0,1,1,-116.5467758,33.83036423
222,"PALMDALE CA",2,4,1,1,2,4,-118.118454,34.57925034
222,"PALO ALTO CA",2,1,0,0,1,1,-122.1449661,37.44177628
222,"PANAMA CITY BEACH FL",2,1,0,0,1,1,-85.80211639,30.1792717
222,"PARIS IL",2,1,0,0,1,1,-87.69623566,39.61117172
222,"PARIS TX",2,1,0,0,1,1,-95.55589294,33.66113663
222,"PARK CITY UT",2,25,4,13,8,25,-111.5018539,40.65143204
222,"PARMA OH",2,1,0,0,1,1,-81.72257996,41.40510178
222,"PASADENA CA",2,10,0,6,4,10,-118.1466675,34.14794922
222,"PATERSON NJ",2,2,0,2,0,2,-74.17102051,40.91714478
222,"PEMBROKE PINES FL",2,2,0,1,1,2,-80.22357941,26.00384903
222,"PENSACOLA FL",2,2,0,1,1,2,-87.21669006,30.42154694
222,"PERTH AMBOY NJ",2,9,4,2,3,9,-74.26480103,40.5068779
222,"PETERSBURG VA",2,2,1,1,0,2,-77.40148926,37.2280426
222,"PHENIX CITY AL",2,1,0,1,0,1,-85.00059509,32.4714241
222,"PHILADELPHIA PA",2,224,49,90,85,224,-75.16322327,39.95243835
222,"PHOENIX AZ",2,43,10,19,14,43,-112.0752716,33.44825363
222,"PICO RIVERA CA",2,1,1,0,0,1,-118.0985489,33.983284
222,"PINE BLUFF AR",2,2,1,1,0,2,-92.00374603,34.22846222
222,"PINEBLUFF NC",2,2,0,1,1,2,-79.47153473,35.11040115
222,"PISMO BEACH CA",2,8,1,3,4,8,-120.6432953,35.1427269
222,"PITTSBURG CA",2,4,0,0,4,4,-121.8871613,38.02787781
222,"PITTSBURGH PA",2,51,8,22,21,51,-79.99537659,40.44091415
222,"PITTSFIELD MA",2,5,0,5,0,5,-73.24451447,42.45004272
222,"PLACERVILLE CA",2,7,2,1,4,7,-120.8002701,38.72951508
222,"PLAINFIELD IL",2,1,0,1,0,1,-88.20417786,41.62700653
222,"PONTIAC MI",2,2,1,0,1,2,-83.29104614,42.63900757
222,"PORT ANGELES WA",2,1,1,0,0,1,-123.4329224,48.11795044
222,"PORT ARTHUR TX",2,8,4,3,1,8,-93.93045807,29.90067863
222,"PORTAGE MI",2,1,1,0,0,1,-85.57974243,42.20133972
222,"PORTLAND ME",2,8,1,2,5,8,-70.25403595,43.6618576
222,"PORTLAND OR",2,96,21,42,33,96,-122.6786423,45.52309418
222,"PORTSMOUTH VA",2,2,0,2,0,2,-76.29769135,36.83554077
222,"PRICHARD AL",2,1,0,0,1,1,-88.07904053,30.739048
222,"PRINCESS ANNE MD",2,1,0,1,0,1,-75.69158173,38.20330429
222,"PRINCETON NJ",2,2,1,1,0,2,-74.65805817,40.34872055
222,"PROVIDENCE RI",2,17,3,6,8,17,-71.40118408,41.82990265
222,"PROVINCETOWN MA",2,17,4,9,4,17,-70.17770386,42.05849075
222,"PUEBLO CO",2,1,0,1,0,1,-104.6108551,38.25450516
222,"PULLMAN WA",2,11,2,4,5,11,-117.180481,46.73068619
222,"PUNTA GORDA FL",2,1,0,0,1,1,-82.04517365,26.93050766
222,"PUYALLUP WA",2,1,0,1,0,1,-122.2927628,47.19064331
222,"QUINCY IL",2,1,0,1,0,1,-91.41021729,39.9356575
222,"RADFORD VA",2,1,0,1,0,1,-80.57588196,37.13208389
222,"RALEIGH NC",2,73,18,33,22,73,-78.63800049,35.77230835
222,"RANCHO CORDOVA CA",2,1,1,0,0,1,-121.3053742,38.58900452
222,"REDMOND WA",2,15,1,11,3,15,-122.1240006,47.67367172
222,"REDWOOD CITY CA",2,2,0,1,1,2,-122.2364655,37.48601151
222,"RENO NV",2,20,3,11,6,20,-119.8160934,39.5294838
222,"REXBURG ID",2,1,0,1,0,1,-111.7915344,43.82584763
222,"RICHARDSON TX",2,2,0,0,2,2,-96.73020172,32.94840622
222,"RICHLAND WA",2,1,0,1,0,1,-119.2866592,46.28547287
222,"RICHMOND CA",2,6,0,5,1,6,-122.3500443,37.9354744
222,"RICHMOND HEIGHTS MO",2,2,1,0,1,2,-90.31951904,38.62892532
222,"RICHMOND TX",2,1,0,0,1,1,-95.76106262,29.58276558
222,"RICHMOND VA",2,53,12,18,23,53,-77.45962524,37.55412674
222,"RIVERDALE GA",2,2,0,1,1,2,-84.4131012,33.57296371
222,"RIVERSIDE CA",2,3,1,1,1,3,-117.3973999,33.95311737
222,"RIVERTON IL",2,1,0,1,0,1,-89.53983307,39.84453201
222,"ROANOKE VA",2,1,0,1,0,1,-79.94111633,37.27119827
222,"ROBERTA GA",2,2,0,0,2,2,-84.01304626,32.72208023
222,"ROBINSON IL",2,1,0,1,0,1,-87.73912048,39.00521469
222,"ROCHESTER MN",2,5,0,3,2,5,-92.47042084,44.02156448
222,"ROCHESTER NY",2,39,11,18,10,39,-77.61522675,43.15487671
222,"ROCK HILL SC",2,10,2,1,7,10,-81.02463531,34.92498779
222,"ROCKDALE TX",2,3,0,3,0,3,-97.00177765,30.65601349
222,"ROCKFORD IL",2,1,0,1,0,1,-89.09428406,42.27135086
222,"ROCKPORT TX",2,2,0,2,0,2,-97.05498505,28.02133369
222,"ROCKVILLE MD",2,1,1,0,0,1,-77.15235901,39.08402252
222,"ROME GA",2,1,0,1,0,1,-85.16900635,34.24008942
222,"ROSENBERG TX",2,2,0,1,1,2,-95.80905914,29.5575695
222,"ROSEVILLE MN",2,1,0,1,0,1,-93.14508057,45.02290726
222,"ROUND ROCK TX",2,2,0,1,1,2,-97.67939758,30.50861359
222,"ROYAL OAK MI",2,19,4,9,6,19,-83.1442337,42.48933792
222,"RUSSELLVILLE AR",2,1,1,0,0,1,-93.1343689,35.27845383
222,"SACRAMENTO CA",2,38,7,14,17,38,-121.4959793,38.58154297
222,"SADDLE BROOK NJ",2,1,0,0,1,1,-74.09207153,40.89922333
222,"SAHUARITA AZ",2,8,3,3,2,8,-110.9567032,31.95795059
222,"SALEM IL",2,2,0,1,1,2,-88.94590759,38.62715149
222,"SALEM MA",2,1,0,1,0,1,-70.89565277,42.51993179
222,"SALEM OR",2,5,2,0,3,5,-123.0377197,44.94248199
222,"SALEMBURG NC",2,1,0,0,1,1,-78.50263977,35.01582718
222,"SALINAS CA",2,1,0,0,1,1,-121.6571732,36.67780304
222,"SALISBURY MD",2,1,0,1,0,1,-75.5984726,38.36100388
222,"SALT LAKE CITY UT",2,8,1,4,3,8,-111.8912659,40.77029037
222,"SAN ANGELO TX",2,1,1,0,0,1,-100.4379044,31.46401215
222,"SAN ANTONIO TX",2,34,10,13,11,34,-98.49394989,29.42439651
222,"SAN BERNARDINO CA",2,2,0,0,2,2,-117.304596,34.12142563
222,"SAN DIEGO CA",2,92,22,42,28,92,-117.1587296,32.71524429
222,"SAN FRANCISCO CA",2,108,24,37,47,108,-122.4213257,37.77465057
222,"SAN JOSE CA",2,6,1,2,3,6,-121.8973846,37.33491516
222,"SAN LEANDRO CA",2,1,0,0,1,1,-122.155983,37.70180511
222,"SAN MARCOS TX",2,6,1,0,5,6,-97.94176483,29.88363266
222,"SANDY SPRINGS GA",2,2,0,1,1,2,-84.37850952,33.92443848
222,"SANFORD FL",2,1,0,1,0,1,-81.27256012,28.80128288
222,"SANFORD NC",2,1,1,0,0,1,-79.17978668,35.4800415
222,"SANTA ANA CA",2,1,0,1,0,1,-117.8697281,33.74567413
222,"SANTA BARBARA CA",2,7,0,6,1,7,-119.7056656,34.4233017
222,"SANTA CRUZ CA",2,16,4,7,5,16,-122.0333557,36.97389984
222,"SANTA MONICA CA",2,22,6,5,11,22,-118.4925232,34.01921082
222,"SANTA ROSA CA",2,24,5,12,7,24,-122.7165146,38.44017792
222,"SARASOTA FL",2,2,0,2,0,2,-82.53031158,27.33688736
222,"SAVANNAH GA",2,13,4,5,4,13,-81.09463501,32.07280731
222,"SCOTTSDALE AZ",2,3,1,1,1,3,-111.9002533,33.50918579
222,"SEAFORD DE",2,1,0,1,0,1,-75.61972809,38.64723206
222,"SEATTLE WA",2,126,24,55,47,126,-122.3343964,47.60571289
222,"SECAUCUS NJ",2,1,1,0,0,1,-74.05567169,40.78977585
222,"SHAKER HEIGHTS OH",2,27,4,11,12,27,-81.53669739,41.47419357
222,"SHAKOPEE MN",2,1,0,1,0,1,-93.52770233,44.79788971
222,"SHARON PA",2,1,1,0,0,1,-80.49273682,41.2334137
222,"SHEBOYGAN WI",2,14,4,3,7,14,-87.71476746,43.75089264
222,"SHERMAN IL",2,1,0,1,0,1,-89.60519409,39.89391327
222,"SHIVELY KY",2,7,0,3,4,7,-85.82255554,38.20013809
222,"SHREVEPORT LA",2,8,3,5,0,8,-93.7507019,32.52565002
222,"SIOUX FALLS SD",2,1,0,0,1,1,-96.73429108,43.54177475
222,"SLIDELL LA",2,6,4,2,0,6,-89.78143311,30.27558708
222,"SOMERVILLE MA",2,6,1,4,1,6,-71.09860992,42.38757324
222,"SONOMA CA",2,1,0,1,0,1,-122.4600754,38.29153061
222,"SOUTH BEND IN",2,7,1,4,2,7,-86.25171661,41.67295837
222,"SOUTH GATE CA",2,3,0,1,2,3,-118.213707,33.95462799
222,"SOUTH LAKE TAHOE CA",2,1,0,1,0,1,-119.972786,38.94574356
222,"SOUTH PORTLAND ME",2,4,0,2,2,4,-70.23975372,43.6415062
222,"SOUTHAMPTON NY",2,4,0,1,3,4,-72.38861084,40.88444519
222,"SPARTANBURG SC",2,4,1,2,1,4,-81.93160248,34.94982529
222,"SPEARFISH SD",2,1,0,0,1,1,-103.8635941,44.49181366
222,"SPEEDWAY IN",2,2,1,1,0,2,-86.2671051,39.80224609
222,"SPOKANE WA",2,7,1,4,2,7,-117.4281387,47.65847015
222,"SPRINGFIELD IL",2,2,1,0,1,2,-89.6439743,39.80184174
222,"SPRINGFIELD MA",2,1,1,0,0,1,-72.57289124,42.10980606
222,"SPRINGFIELD MO",2,8,0,3,5,8,-93.29862213,37.21548843
222,"ST LOUIS MO",2,1236,317,398,521,1236,-90.19819641,38.62716675
222,"STAMFORD CT",2,1,0,0,1,1,-73.53807068,41.05353165
222,"STATESBORO GA",2,6,1,3,2,6,-81.78266907,32.44914246
222,"STILLWATER MN",2,1,1,0,0,1,-92.80657959,45.05171967
222,"STOCKBRIDGE GA",2,1,0,0,1,1,-84.23356628,33.54455185
222,"STOCKTON CA",2,3,0,2,1,3,-121.293457,37.95776749
222,"STONE MOUNTAIN GA",2,1,0,1,0,1,-84.14538574,33.8065033
222,"STRATFORD CT",2,1,0,0,1,1,-73.13223267,41.18459702
222,"SUFFOLK VA",2,1,0,1,0,1,-76.58317566,36.72846985
222,"SUGAR LAND TX",2,3,0,2,1,3,-95.6352005,29.61997795
222,"SULPHUR SPRINGS TX",2,1,0,1,0,1,-95.60125732,33.13871002
222,"SUMMERDALE AL",2,1,0,1,0,1,-87.69980621,30.48824692
222,"SUMMERVILLE SC",2,1,0,1,0,1,-80.17547607,33.01868439
222,"SUNSET LA",2,1,0,0,1,1,-92.06873322,30.41154289
222,"SURFSIDE FL",2,3,0,2,1,3,-80.12493134,25.87931252
222,"SYRACUSE NY",2,2,0,2,0,2,-76.14653015,43.04846191
222,"TACOMA WA",2,8,3,4,1,8,-122.4466705,47.25242233
222,"TAHLEQUAH OK",2,1,0,0,1,1,-94.9703064,35.91559982
222,"TAKOMA PARK MD",2,3,0,1,2,3,-77.00667572,38.97793198
222,"TALLAHASSEE FL",2,33,11,9,13,33,-84.27896881,30.44669914
222,"TALLULAH LA",2,1,0,1,0,1,-91.18704987,32.40855789
222,"TAMPA FL",2,86,22,28,36,86,-82.4580307,27.94833755
222,"TAOS NM",2,2,0,1,1,2,-105.5769424,36.40658188
222,"TEANECK NJ",2,3,1,1,1,3,-74.01485443,40.89759064
222,"TEMECULA CA",2,4,1,1,2,4,-117.1428146,33.48790741
222,"TEMPE AZ",2,32,5,6,21,32,-111.9108276,33.41504288
222,"TENAFLY NJ",2,1,0,1,0,1,-73.9623642,40.92551041
222,"THOMASTON CT",2,1,0,1,0,1,-73.07209778,41.67415237
222,"THOMASVILLE GA",2,1,0,1,0,1,-83.97835541,30.8371582
222,"THOMASVILLE NC",2,1,0,1,0,1,-80.08161163,35.88302994
222,"THORNTON CO",2,5,0,4,1,5,-104.9727631,39.86811829
222,"THOUSAND OAKS CA",2,2,1,1,0,2,-118.8398514,34.17078018
222,"THREE RIVERS MI",2,8,4,4,0,8,-85.63246918,41.94419861
222,"TIPTON IN",2,1,0,0,1,1,-86.0413208,40.28222275
222,"TOLEDO OH",2,21,3,9,9,21,-83.55497742,41.66411591
222,"TOMBALL TX",2,1,0,1,0,1,-95.6162262,30.09776115
222,"TOMBSTONE AZ",2,3,1,2,0,3,-110.0689316,31.71310997
222,"TONAWANDA NY",2,1,0,1,0,1,-78.88004303,43.02050018
222,"TOPEKA KS",2,1,1,0,0,1,-95.67857361,39.04813766
222,"TRAVERSE CITY MI",2,1,0,1,0,1,-85.6207962,44.76324844
222,"TRENTON NJ",2,2,0,0,2,2,-74.74206543,40.21709442
222,"TROY OH",2,19,7,7,5,19,-84.20330811,40.03966141
222,"TUCSON AZ",2,14,2,9,3,14,-110.9277954,32.22209167
222,"TULSA OK",2,6,1,3,2,6,-95.98488617,36.1603241
222,"TUSCALOOSA AL",2,10,2,4,4,10,-87.56897736,33.21024704
222,"TUSTIN CA",2,4,1,2,1,4,-117.8277283,33.74598312
222,"TWENTYNINE PALMS CA",2,9,2,4,3,9,-116.055397,34.13557053
222,"TYLER TX",2,1,0,0,1,1,-95.3013916,32.35176468
222,"UNION CITY CA",2,1,0,0,1,1,-122.0214462,37.59539032
222,"UNION CITY NJ",2,1,0,0,1,1,-74.02296448,40.77968979
222,"UNIVERSITY CITY MO",2,46,11,12,23,46,-90.33391571,38.66000748
222,"UNIVERSITY PLACE WA",2,1,0,1,0,1,-122.5529404,47.2352562
222,"UPPER MARLBORO MD",2,1,0,1,0,1,-76.74905396,38.81620026
222,"URBANA IL",2,1,0,1,0,1,-88.20746613,40.11079025
222,"URBANDALE IA",2,1,1,0,0,1,-93.71256256,41.62665176
222,"VACAVILLE CA",2,1,0,1,0,1,-121.9900284,38.35633469
222,"VALDOSTA GA",2,4,0,4,0,4,-83.27806854,30.83293533
222,"VALLEJO CA",2,6,1,1,4,6,-122.2594299,38.1039505
222,"VALLEY AL",2,2,1,1,0,2,-85.17531586,32.81519318
222,"VANCOUVER WA",2,2,0,1,1,2,-122.6816559,45.63534164
222,"VENICE FL",2,1,0,1,0,1,-82.45388031,27.10065269
222,"VICKSBURG MS",2,2,0,1,1,2,-90.87818909,32.35280991
222,"VIENNA VA",2,2,0,2,0,2,-77.2645874,38.90164566
222,"VIRGINIA BEACH VA",2,78,26,25,27,78,-75.97751617,36.8533783
222,"VISALIA CA",2,4,0,1,3,4,-119.2938156,36.33000946
222,"VISTA CA",2,1,0,1,0,1,-117.2447052,33.2000885
222,"WACO TX",2,4,0,3,1,4,-97.14704895,31.54987144
222,"WADSWORTH IL",2,1,0,1,0,1,-87.92391968,42.4287262
222,"WALLINGFORD CT",2,1,0,1,0,1,-72.82215118,41.45715332
222,"WALTHAM MA",2,2,2,0,0,2,-71.2346344,42.37656403
222,"WARREN MI",2,52,10,17,25,52,-83.02783203,42.47764969
222,"WARRENTON VA",2,1,0,0,1,1,-77.79475403,38.71380615
222,"WASHINGTON DC",2,800,152,306,342,800,-77.01257324,38.88911819
222,"WASHINGTON MO",2,1,0,0,1,1,-91.01213074,38.55807495
222,"WASILLA AK",2,3,0,0,3,3,-149.4517059,61.58290482
222,"WATERBURY CT",2,2,0,1,1,2,-73.05029297,41.55849075
222,"WAUWATOSA WI",2,1,0,1,0,1,-88.00754547,43.04960632
222,"WAYCROSS GA",2,6,4,1,1,6,-82.35388184,31.21380043
222,"WEATHERFORD TX",2,1,0,0,1,1,-97.79758453,32.7595253
222,"WEED CA",2,19,5,11,3,19,-122.388382,41.42225266
222,"WENDELL NC",2,1,0,1,0,1,-78.36904144,35.78117371
222,"WEST HARTFORD CT",2,1,0,0,1,1,-72.74108887,41.76238251
222,"WEST HOLLYWOOD CA",2,5,1,2,2,5,-118.3634567,34.08982468
222,"WEST ORANGE NJ",2,1,1,0,0,1,-74.23833466,40.7989006
222,"WEST PALM BEACH FL",2,14,2,7,5,14,-80.05298615,26.71585464
222,"WEST PEORIA IL",2,1,0,1,0,1,-89.6051712,40.7019577
222,"WEST PLAINS MO",2,1,1,0,0,1,-91.85284424,36.72810745
222,"WESTERVILLE OH",2,2,0,1,1,2,-82.92906952,40.12620926
222,"WESTFIELD NJ",2,1,0,0,1,1,-74.34671783,40.65938187
222,"WETHERSFIELD CT",2,1,0,1,0,1,-72.6517334,41.71439362
222,"WHITEVILLE NC",2,1,1,0,0,1,-78.70272064,34.3391037
222,"WICHITA FALLS TX",2,1,0,1,0,1,-98.49403381,33.91383743
222,"WICHITA KS",2,6,1,3,2,6,-97.3383255,37.69230652
222,"WILKES-BARRE PA",2,1,0,1,0,1,-75.88058472,41.24601746
222,"WILLIAMSTOWN MA",2,2,1,1,0,2,-73.21173859,42.70910263
222,"WILMINGTON DE",2,1,0,1,0,1,-75.54558563,39.74601364
222,"WILMINGTON NC",2,4,1,1,2,4,-77.94431305,34.22592926
222,"WINCHESTER IN",2,1,0,1,0,1,-84.98105621,40.17190933
222,"WINDSOR MO",2,3,0,3,0,3,-93.5224762,38.53234863
222,"WINOOSKI VT",2,1,0,1,0,1,-73.18509674,44.49157333
222,"WINSTON-SALEM NC",2,10,2,4,4,10,-80.24356842,36.1001091
222,"WINTER HAVEN FL",2,4,1,3,0,4,-81.73223114,28.02276421
222,"WINTER PARK FL",2,4,2,2,0,4,-81.33872223,28.6003685
222,"WISCONSIN DELLS WI",2,4,2,2,0,4,-89.77094269,43.62741089
222,"WOLCOTT CT",2,1,0,0,1,1,-72.97510529,41.60192871
222,"WOODBURY MN",2,1,0,0,1,1,-92.95999908,44.92368698
222,"WOODINVILLE WA",2,2,0,2,0,2,-122.1656876,47.75372314
222,"WOONSOCKET RI",2,1,0,1,0,1,-71.51394653,42.00294876
222,"WORCESTER MA",2,14,5,3,6,14,-71.801651,42.26288986
222,"WYOMING MI",2,3,0,2,1,3,-85.70549011,42.9133873
222,"YARDLEY PA",2,1,1,0,0,1,-74.8451004,40.2459259
222,"YOUNGSTOWN OH",2,5,0,2,3,5,-80.64901733,41.1000061
222,"YPSILANTI MI",2,9,0,4,5,9,-83.61315155,42.24105453
223,"ABILENE TX",3,3,0,0,3,3,-99.73384094,32.44894028
223,"ACWORTH GA",3,1,1,0,0,1,-84.67662811,34.06597519
223,"ADA OK",3,2,0,0,2,2,-96.67899323,34.77481842
223,"ADDISON TX",3,2,0,1,1,2,-96.82976532,32.96215057
223,"AKRON OH",3,33,8,10,15,33,-81.51885223,41.08151627
223,"ALAMEDA CA",3,2,0,1,1,2,-122.2444763,37.76513672
223,"ALBANY LA",3,1,0,0,1,1,-90.58232117,30.50474739
223,"ALBANY NY",3,5,2,2,1,5,-73.75520325,42.6529007
223,"ALBION MI",3,1,0,1,0,1,-84.75305176,42.24326324
223,"ALBUQUERQUE NM",3,77,21,20,36,77,-106.6517639,35.08336639
223,"ALEXANDRIA LA",3,5,4,0,1,5,-92.44517517,31.31143761
223,"ALEXANDRIA MN",3,1,0,0,1,1,-95.37786865,45.88516617
223,"ALEXANDRIA VA",3,25,8,7,10,25,-77.04605103,38.80503082
223,"ALHAMBRA CA",3,1,0,0,1,1,-118.1287003,34.0954628
223,"ALLENTOWN PA",3,6,0,4,2,6,-75.46569824,40.60851288
223,"ALPENA MI",3,8,1,2,5,8,-83.43292999,45.06164551
223,"ALTAMONTE SPRINGS FL",3,1,0,1,0,1,-81.39485931,28.66284752
223,"ALTON IL",3,21,5,6,10,21,-90.18429565,38.89074326
223,"AMARILLO TX",3,9,2,3,4,9,-101.8324051,35.22210312
223,"AMERICAN FORK UT",3,1,0,0,1,1,-111.8032379,40.34251022
223,"AMES IA",3,2,0,1,1,2,-93.61370087,42.02269363
223,"AMHERST OH",3,1,0,1,0,1,-82.22229767,41.39805603
223,"ANAHEIM CA",3,14,5,4,5,14,-117.9165115,33.8354454
223,"ANCHORAGE AK",3,25,4,8,13,25,-149.8811951,61.21649933
223,"ANDERSON IN",3,4,1,1,2,4,-85.68051147,40.1053772
223,"ANDERSON SC",3,9,2,2,5,9,-82.65641785,34.50934219
223,"ANGLETON TX",3,1,1,0,0,1,-95.43254852,29.17015266
223,"ANKENY IA",3,5,1,1,3,5,-93.60646057,41.72983551
223,"ANN ARBOR MI",3,61,19,20,22,61,-83.74536896,42.28347015
223,"ANNAPOLIS MD",3,32,12,11,9,32,-76.49166107,38.97844696
223,"ANNISTON AL",3,1,0,0,1,1,-85.8313446,33.65997314
223,"ANSONIA CT",3,1,0,1,0,1,-73.0779953,41.34640884
223,"ANTIOCH CA",3,1,1,0,0,1,-121.808136,38.0049057
223,"APACHE JUNCTION AZ",3,1,0,1,0,1,-111.5511551,33.41511536
223,"APPLETON WI",3,2,1,0,1,2,-88.41551208,44.2618866
223,"ARKADELPHIA AR",3,2,1,0,1,2,-93.05423737,34.12095642
223,"ARLINGTON HEIGHTS IL",3,3,2,0,1,3,-87.98104858,42.08821106
223,"ARLINGTON MA",3,1,0,0,1,1,-71.15559387,42.41545486
223,"ARLINGTON TN",3,2,1,0,1,2,-89.66139984,35.29637527
223,"ARLINGTON TX",3,64,19,14,31,64,-97.10882568,32.73590469
223,"ARNOLD MO",3,4,0,1,3,4,-90.37690735,38.43906784
223,"ASHEVILLE NC",3,14,4,4,6,14,-82.55367279,35.60134888
223,"ASHLAND AL",3,1,0,0,1,1,-85.83626556,33.27382278
223,"ASHLAND OH",3,1,0,1,0,1,-82.31797028,40.86874771
223,"ASHLAND OR",3,10,4,2,4,10,-122.7111359,42.19425583
223,"ASHLAND VA",3,5,4,1,0,5,-77.47959137,37.75937653
223,"ATHENS AL",3,4,1,2,1,4,-86.97190857,34.80292892
223,"ATHENS OH",3,32,10,7,15,32,-82.10113525,39.32934952
223,"ATHENS TN",3,1,0,1,0,1,-84.59921265,35.44878387
223,"ATLANTA GA",3,1482,348,427,707,1482,-84.38757324,33.74927521
223,"ATLANTIC BEACH FL",3,1,1,0,0,1,-81.39808655,30.33498573
223,"ATLANTIC CITY NJ",3,3,1,1,1,3,-74.42202759,39.36457062
223,"AUBURN AL",3,8,4,0,4,8,-85.48087311,32.61021423
223,"AUBURN CA",3,5,0,4,1,5,-121.0794067,38.89623642
223,"AUBURN NY",3,1,0,0,1,1,-76.56542969,42.93203735
223,"AUBURN WA",3,4,2,2,0,4,-122.2304688,47.30677795
223,"AUGUSTA KS",3,10,3,4,3,10,-96.97721863,37.68652725
223,"AUGUSTA ME",3,1,0,0,1,1,-69.7781601,44.31053925
223,"AURORA CO",3,8,5,2,1,8,-104.8693161,39.73983765
223,"AURORA IL",3,12,2,6,4,12,-88.32048798,41.76070023
223,"AUSTELL GA",3,9,0,1,8,9,-84.63414001,33.81290054
223,"AUSTIN TX",3,372,76,116,180,372,-97.74386597,30.26748466
223,"AVIS PA",3,1,1,0,0,1,-77.31352997,41.1848526
223,"AVON LAKE OH",3,1,0,1,0,1,-82.02809906,41.50548935
223,"AVONDALE AZ",3,1,1,0,0,1,-112.3513947,33.43592072
223,"BABYLON NY",3,1,1,0,0,1,-73.3247757,40.696064
223,"BAKERSFIELD CA",3,9,1,6,2,9,-119.0206375,35.37326813
223,"BALCH SPRINGS TX",3,1,0,0,1,1,-96.62306213,32.72889328
223,"BALLWIN MO",3,32,15,6,11,32,-90.54669189,38.5951004
223,"BALTIMORE MD",3,332,92,92,148,332,-76.6115799,39.29075623
223,"BANGOR ME",3,5,1,1,3,5,-68.77653503,44.80109406
223,"BANNING CA",3,5,1,0,4,5,-116.878746,33.92569351
223,"BARRE MA",3,1,0,1,0,1,-72.09545898,42.40907288
223,"BARTONVILLE IL",3,3,0,1,2,3,-89.65235138,40.6502037
223,"BATAVIA NY",3,1,0,0,1,1,-78.18697357,42.99835587
223,"BATON ROUGE LA",3,58,11,19,28,58,-91.15479279,30.45132256
223,"BAY VILLAGE OH",3,2,0,0,2,2,-81.92155457,41.48464966
223,"BAYTOWN TX",3,2,0,1,1,2,-94.97782135,29.73608589
223,"BEAUMONT TX",3,3,0,1,2,3,-94.10238647,30.08622551
223,"BEAVERTON OR",3,8,3,2,3,8,-122.8055344,45.48670197
223,"BECKLEY WV",3,1,1,0,0,1,-81.18963623,37.77680588
223,"BEDFORD NY",3,2,0,1,1,2,-73.64318085,41.204319
223,"BEDFORD TX",3,1,0,1,0,1,-97.14364624,32.8442955
223,"BEL AIR MD",3,1,1,0,0,1,-76.34788513,39.53611374
223,"BELL CA",3,3,0,2,1,3,-118.1889572,33.97753906
223,"BELLEVILLE IL",3,31,12,6,13,31,-89.98438263,38.52002716
223,"BELLINGHAM WA",3,1,0,0,1,1,-122.4727402,48.76121521
223,"BELOIT WI",3,1,0,1,0,1,-89.03194427,42.50856781
223,"BELTON MO",3,2,1,1,0,2,-94.53222656,38.81176376
223,"BELTON TX",3,1,1,0,0,1,-97.46511841,31.05611229
223,"BEMENT IL",3,1,1,0,0,1,-88.57191467,39.92221832
223,"BEND OR",3,2,0,1,1,2,-121.3171387,44.0577774
223,"BENNETT CO",3,1,0,0,1,1,-104.4285889,39.75864792
223,"BENSENVILLE IL",3,4,1,0,3,4,-87.94012451,41.95510483
223,"BENTON HARBOR MI",3,1,1,0,0,1,-86.45429993,42.11692429
223,"BENTONVILLE AR",3,8,2,2,4,8,-94.20933533,36.3728447
223,"BERKELEY CA",3,29,6,9,14,29,-122.2752533,37.87145615
223,"BERKELEY HEIGHTS NJ",3,1,0,1,0,1,-74.44181824,40.68349838
223,"BERKELEY MO",3,2,2,0,0,2,-90.33169556,38.75470734
223,"BERLIN NJ",3,1,1,0,0,1,-74.9280014,39.79132462
223,"BERWICK PA",3,1,0,0,1,1,-76.23230743,41.05486679
223,"BESSEMER AL",3,3,0,1,2,3,-86.95465851,33.40222549
223,"BETHALTO IL",3,3,1,1,1,3,-90.04077911,38.90911865
223,"BEVERLY HILLS CA",3,18,4,3,11,18,-118.4019775,34.07383347
223,"BEVERLY HILLS MI",3,2,0,1,1,2,-83.22288513,42.52407837
223,"BIG SPRING TX",3,1,1,0,0,1,-101.4811173,32.25181198
223,"BILLINGS MT",3,2,0,1,1,2,-108.504631,45.7833786
223,"BILOXI MS",3,11,1,3,7,11,-88.89369202,30.40021133
223,"BINGHAMTON NY",3,3,1,1,1,3,-75.91755676,42.0986557
223,"BIRMINGHAM AL",3,73,12,24,37,73,-86.80226898,33.52098846
223,"BISBEE AZ",3,1,1,0,0,1,-109.9298477,31.44821548
223,"BISMARCK ND",3,3,1,0,2,3,-100.7789612,46.80673981
223,"BLACKSBURG VA",3,3,1,1,1,3,-80.41369629,37.22999573
223,"BLADENSBURG MD",3,1,1,0,0,1,-76.9335556,38.93954849
223,"BLOOMINGTON IL",3,4,1,1,2,4,-88.99375916,40.48418045
223,"BLOOMINGTON IN",3,12,1,5,6,12,-86.53382874,39.16920471
223,"BLUE ISLAND IL",3,2,0,1,1,2,-87.67993927,41.657444
223,"BLUE RIDGE GA",3,1,1,0,0,1,-84.32199097,34.86791229
223,"BLUE SPRINGS MO",3,3,2,0,1,3,-94.2820816,39.01689148
223,"BLUFF CITY TN",3,2,1,1,0,2,-82.26051331,36.47451019
223,"BLUFFTON SC",3,1,0,1,0,1,-80.86026001,32.23733902
223,"BLYTHEVILLE AR",3,1,0,1,0,1,-89.91928101,35.92730713
223,"BOARDMAN OH",3,10,1,2,7,10,-80.66256714,41.02441788
223,"BOAZ AL",3,1,1,0,0,1,-86.16611481,34.20103073
223,"BOCA RATON FL",3,5,1,0,4,5,-80.08280182,26.35960197
223,"BOLINGBROOK IL",3,11,3,3,5,11,-88.06878662,41.69866562
223,"BONITA SPRINGS FL",3,1,0,0,1,1,-81.77822876,26.34039497
223,"BOOKER TX",3,2,1,1,0,2,-100.5383911,36.4532814
223,"BOONE NC",3,1,1,0,0,1,-81.67436218,36.21696472
223,"BOONVILLE MO",3,6,2,2,2,6,-92.74378967,38.97373962
223,"BORDENTOWN NJ",3,1,0,0,1,1,-74.7159729,40.15003586
223,"BOSSIER CITY LA",3,14,3,5,6,14,-93.73249817,32.51643753
223,"BOSTON MA",3,229,66,68,95,229,-71.05905151,42.35883713
223,"BOTHELL WA",3,1,0,0,1,1,-122.2075424,47.75966263
223,"BOULDER CO",3,19,6,5,8,19,-105.2715302,40.01483917
223,"BOUND BROOK NJ",3,1,0,1,0,1,-74.53753662,40.5687561
223,"BOWIE MD",3,26,5,6,15,26,-76.77848816,39.00718689
223,"BOWLING GREEN KY",3,3,1,1,1,3,-86.4437027,36.99057388
223,"BOWLING GREEN OH",3,4,1,2,1,4,-83.65102386,41.37505341
223,"BOYD TX",3,1,1,0,0,1,-97.56573486,33.0790329
223,"BOYNTON BEACH FL",3,3,1,2,0,3,-80.066185,26.52592087
223,"BOZEMAN MT",3,2,0,2,0,2,-111.0471649,45.6803093
223,"BRADENTON FL",3,4,2,0,2,4,-82.57459259,27.49969101
223,"BRADLEY IL",3,1,0,1,0,1,-87.86099243,41.14196014
223,"BRANSON MO",3,1,1,0,0,1,-93.21912384,36.64381409
223,"BRECKSVILLE OH",3,1,0,0,1,1,-81.62625122,41.32006836
223,"BREESE IL",3,3,1,2,0,3,-89.52734375,38.61071396
223,"BREMERTON WA",3,4,2,2,0,4,-122.6345291,47.56690598
223,"BRENTWOOD TN",3,2,0,1,1,2,-86.78275299,36.03345108
223,"BREVARD NC",3,2,0,1,1,2,-82.73400116,35.23363113
223,"BREWSTER OH",3,1,0,1,0,1,-81.5980072,40.70691681
223,"BRIDGEPORT CT",3,4,2,1,1,4,-73.2040863,41.16743088
223,"BRIDGETON MO",3,1,0,1,0,1,-90.41161346,38.76696396
223,"BRIDGETON NJ",3,2,0,0,2,2,-75.23321533,39.42769623
223,"BRIGHTON IL",3,1,0,0,1,1,-90.14067841,39.03963089
223,"BRISTOL CT",3,4,1,2,1,4,-72.94853973,41.67193222
223,"BRISTOL PA",3,1,1,0,0,1,-74.85106659,40.10090637
223,"BROCKPORT NY",3,3,1,0,2,3,-77.93889618,43.213871
223,"BROCKTON MA",3,2,0,2,0,2,-71.01748657,42.08340454
223,"BROOKLYN PARK MN",3,2,1,0,1,2,-93.35662079,45.09407043
223,"BROOKSVILLE FL",3,1,0,1,0,1,-82.38734436,28.55600739
223,"BROWNFIELD TX",3,1,0,0,1,1,-102.2751923,33.18150711
223,"BRUNSWICK GA",3,1,1,0,0,1,-81.49102783,31.1502285
223,"BRUNSWICK OH",3,1,0,0,1,1,-81.84169769,41.23830795
223,"BRYAN TX",3,4,3,0,1,4,-96.3704071,30.67456818
223,"BRYANT AR",3,1,0,1,0,1,-92.48953247,34.59588242
223,"BUFFALO NY",3,46,16,16,14,46,-78.87787628,42.8867836
223,"BULLHEAD CITY AZ",3,1,0,0,1,1,-114.5695648,35.1478157
223,"BURBANK CA",3,5,1,2,2,5,-118.3104782,34.18065262
223,"BURIEN WA",3,5,2,1,2,5,-122.3500137,47.47027206
223,"BURLINGTON NC",3,1,1,0,0,1,-79.43729401,36.09585953
223,"BURLINGTON NJ",3,2,0,2,0,2,-74.86417389,40.07125092
223,"BURLINGTON VT",3,2,1,1,0,2,-73.20542908,44.47687531
223,"BURNSVILLE MN",3,1,0,0,1,1,-93.27822113,44.76760483
223,"BURTON MI",3,2,1,1,0,2,-83.59590912,43.02775955
223,"BUTLER PA",3,9,1,5,3,9,-79.89468384,40.86117172
223,"CAHOKIA IL",3,4,1,0,3,4,-90.19016266,38.57118225
223,"CALABASAS CA",3,2,0,2,0,2,-118.6473236,34.1558876
223,"CALERA AL",3,1,0,0,1,1,-86.75354004,33.10300064
223,"CALHOUN GA",3,1,0,0,1,1,-84.95102692,34.50297165
223,"CALIFORNIA PA",3,2,1,0,1,2,-79.89154053,40.06599426
223,"CAMARILLO CA",3,5,0,1,4,5,-119.0400391,34.21628952
223,"CAMBRIDGE MA",3,16,3,5,8,16,-71.10369873,42.36532593
223,"CAMDEN AR",3,1,0,1,0,1,-92.83481598,33.58491898
223,"CAMDEN NJ",3,6,2,3,1,6,-75.118927,39.92608261
223,"CAMPBELL CA",3,3,0,1,2,3,-121.951973,37.287117
223,"CANANDAIGUA NY",3,2,0,1,1,2,-77.28107452,42.88830948
223,"CANTON GA",3,1,0,0,1,1,-84.48571014,34.23356628
223,"CANTON OH",3,4,1,1,2,4,-81.37824249,40.79906845
223,"CANYON TX",3,4,1,2,1,4,-101.9192429,34.98051834
223,"CAPE CANAVERAL FL",3,2,0,1,1,2,-80.60503387,28.4044838
223,"CAPE GIRARDEAU MO",3,9,3,1,5,9,-89.51838684,37.30613327
223,"CAPITOL HEIGHTS MD",3,7,2,1,4,7,-76.91506195,38.88552475
223,"CARBONDALE IL",3,14,1,6,7,14,-89.2168808,37.7274704
223,"CARLYLE IL",3,1,1,0,0,1,-89.37243652,38.61019897
223,"CARRBORO NC",3,1,1,0,0,1,-79.07286835,35.91213989
223,"CARROLLTON GA",3,1,1,0,0,1,-85.07631683,33.58019638
223,"CARROLLTON TX",3,1,1,0,0,1,-96.89080811,32.95380783
223,"CARSON CA",3,1,0,0,1,1,-118.2837448,33.8312645
223,"CARTERSVILLE GA",3,1,0,0,1,1,-84.79982758,34.1654892
223,"CARTHAGE IL",3,1,1,0,0,1,-91.13681793,40.41659546
223,"CARTHAGE TX",3,3,0,0,3,3,-94.33757019,32.15785217
223,"CARY NC",3,6,0,0,6,6,-78.78055573,35.79200745
223,"CASA GRANDE AZ",3,7,1,1,5,7,-111.7590179,32.87965393
223,"CASCADE LOCKS OR",3,1,1,0,0,1,-121.8928452,45.66971588
223,"CEDAR PARK TX",3,4,2,1,1,4,-97.82061005,30.50554466
223,"CEDAR RAPIDS IA",3,11,4,3,4,11,-91.66259766,41.98337555
223,"CENTER POINT AL",3,1,0,0,1,1,-86.68362427,33.64584732
223,"CENTRALIA IL",3,2,0,1,1,2,-89.13375092,38.52496719
223,"CHAMPAIGN IL",3,17,4,8,5,17,-88.24346161,40.11659622
223,"CHANDLER AZ",3,13,6,3,4,13,-111.8428345,33.3062439
223,"CHAPEL HILL NC",3,4,0,3,1,4,-79.05697632,35.91110611
223,"CHARLESTON IL",3,1,0,1,0,1,-88.17610931,39.49612045
223,"CHARLESTON SC",3,51,12,12,27,51,-79.93032074,32.77671814
223,"CHARLESTON WV",3,5,0,3,2,5,-81.63149261,38.34872055
223,"CHARLOTTE NC",3,452,98,133,221,452,-80.84257507,35.22746277
223,"CHARLOTTESVILLE VA",3,29,11,6,12,29,-78.49123383,38.03798676
223,"CHATHAM VA",3,1,0,0,1,1,-79.39749146,36.82584
223,"CHATTANOOGA TN",3,10,1,4,5,10,-85.30583954,35.04058456
223,"CHENEY WA",3,1,0,0,1,1,-117.5782547,47.48730087
223,"CHESAPEAKE VA",3,13,2,6,5,13,-76.27422333,36.81948853
223,"CHESTER PA",3,9,2,4,3,9,-75.35475159,39.84973145
223,"CHESTERFIELD MO",3,17,5,4,8,17,-90.5772934,38.6631279
223,"CHICAGO IL",3,915,207,277,431,915,-87.6503067,41.85000992
223,"CHICKASHA OK",3,2,0,1,1,2,-97.93728638,35.05269241
223,"CHICO CA",3,43,15,13,15,43,-121.839447,39.72846222
223,"CHILLICOTHE MO",3,9,4,0,5,9,-93.55298615,39.79542542
223,"CHINO CA",3,1,0,0,1,1,-117.6906662,34.0121727
223,"CHULA VISTA CA",3,18,7,5,6,18,-117.0857468,32.64037704
223,"CINCINNATI OH",3,103,25,27,51,103,-84.51939392,39.10413742
223,"CLAIRTON PA",3,2,0,0,2,2,-79.88103485,40.2925148
223,"CLAREMONT CA",3,1,0,0,1,1,-117.7214508,34.09675217
223,"CLARKS SUMMIT PA",3,2,0,0,2,2,-75.70759583,41.48881531
223,"CLARKSTON GA",3,1,0,1,0,1,-84.2394104,33.80961227
223,"CLARKSVILLE TN",3,1,0,1,0,1,-87.35944366,36.52993011
223,"CLAYCOMO MO",3,1,0,0,1,1,-94.49269867,39.20272827
223,"CLAYTON MO",3,4,1,1,2,4,-90.32382965,38.64260101
223,"CLAYTON NC",3,1,0,1,0,1,-78.45562744,35.6511879
223,"CLEAR LAKE SHORES TX",3,24,9,4,11,24,-95.03226471,29.54773712
223,"CLEARWATER FL",3,5,0,0,5,5,-82.79984283,27.9665451
223,"CLEMSON SC",3,8,0,5,3,8,-82.83683014,34.68382645
223,"CLEVELAND HEIGHTS OH",3,1,0,0,1,1,-81.55568695,41.52017975
223,"CLEVELAND OH",3,179,42,52,85,179,-81.69516754,41.49978256
223,"CLIFTON NJ",3,3,2,1,0,3,-74.16278076,40.85860062
223,"CLINTON IN",3,1,0,1,0,1,-87.39801025,39.65688324
223,"CLIVE IA",3,1,0,1,0,1,-93.72477722,41.60302734
223,"COACHELLA CA",3,1,0,1,0,1,-116.1753616,33.68059158
223,"COATS NC",3,2,0,2,0,2,-78.6716156,35.40827179
223,"COCOA BEACH FL",3,1,1,0,0,1,-80.6068573,28.3203907
223,"COLLEGE PARK GA",3,9,3,2,4,9,-84.44933319,33.65347672
223,"COLLEGE PARK MD",3,8,1,3,4,8,-76.93619537,38.98080444
223,"COLLEGE STATION TX",3,5,0,2,3,5,-96.33758545,30.62316895
223,"COLLEGEVILLE MN",3,3,2,1,0,3,-94.36388397,45.59444427
223,"COLLINSVILLE IL",3,14,6,5,3,14,-89.98478699,38.67050171
223,"COLLINSVILLE OK",3,1,1,0,0,1,-95.83948517,36.36487961
223,"COLORADO SPRINGS CO",3,56,16,13,27,56,-104.8225174,38.83369446
223,"COLUMBIA IL",3,7,3,1,3,7,-90.20130157,38.44375992
223,"COLUMBIA MO",3,182,52,47,83,182,-92.33429718,38.95169067
223,"COLUMBIA PA",3,1,0,1,0,1,-76.50388336,40.03407669
223,"COLUMBIA SC",3,56,15,8,33,56,-81.04045105,34.00138855
223,"COLUMBIA TN",3,2,0,1,1,2,-87.03533173,35.61502457
223,"COLUMBUS GA",3,11,5,2,4,11,-84.98313141,32.46828842
223,"COLUMBUS IN",3,1,0,0,1,1,-85.92284393,39.20959473
223,"COLUMBUS MS",3,1,1,0,0,1,-88.42742157,33.49581909
223,"COLUMBUS OH",3,177,44,55,78,177,-82.99890137,39.96136475
223,"COMMERCE TX",3,1,0,0,1,1,-95.90060425,33.24729538
223,"COMPTON CA",3,14,4,6,4,14,-118.2218704,33.89606857
223,"CONCORD CA",3,2,2,0,0,2,-122.0333328,37.97780228
223,"CONCORD NC",3,7,1,3,3,7,-80.57880402,35.4092598
223,"CONNELL WA",3,3,1,1,1,3,-118.863533,46.66334534
223,"CONROE TX",3,3,1,0,2,3,-95.45646667,30.31249237
223,"CONWAY AR",3,33,10,14,9,33,-92.4426651,35.08877563
223,"CONYERS GA",3,2,0,0,2,2,-84.0175705,33.66764832
223,"COOK MN",3,1,0,0,1,1,-92.69020844,47.85202789
223,"COOKEVILLE TN",3,1,0,0,1,1,-85.50189972,36.16290665
223,"COON RAPIDS MN",3,2,1,1,0,2,-93.32348633,45.16527176
223,"CORAL GABLES FL",3,1,0,0,1,1,-80.26779938,25.72242165
223,"CORDELE GA",3,1,0,0,1,1,-83.78203583,31.96388817
223,"CORONA CA",3,25,6,4,15,25,-117.5688171,33.87516785
223,"CORONADO CA",3,1,0,0,1,1,-117.1846619,32.6861763
223,"CORPUS CHRISTI TX",3,12,3,1,8,12,-97.42076874,27.77859879
223,"CORTLAND NY",3,2,2,0,0,2,-76.17972565,42.60138702
223,"CORTLAND OH",3,1,0,1,0,1,-80.72497559,41.3302803
223,"CORVALLIS OR",3,10,3,3,4,10,-123.2646637,44.56417084
223,"COSTA MESA CA",3,2,1,0,1,2,-117.9204407,33.64131927
223,"COTTONWOOD AZ",3,1,0,0,1,1,-112.0110779,34.739048
223,"COVINGTON LA",3,1,1,0,0,1,-90.10121918,30.475914
223,"CRESTVIEW FL",3,1,0,1,0,1,-86.57064819,30.76231766
223,"CREVE COEUR MO",3,6,1,1,4,6,-90.42288971,38.66108322
223,"CROTON-ON-HUDSON NY",3,39,8,14,17,39,-73.89041901,41.2085762
223,"CROWN POINT IN",3,1,0,0,1,1,-87.36541748,41.41695023
223,"CRYSTAL MN",3,1,0,0,1,1,-93.36638641,45.05664063
223,"CUBA MO",3,1,1,0,0,1,-91.40387726,38.06311035
223,"CUMMING GA",3,11,4,3,4,11,-84.1401825,34.2074852
223,"CUPERTINO CA",3,1,0,1,0,1,-122.0342026,37.32306671
223,"CUYAHOGA FALLS OH",3,8,2,3,3,8,-81.48397064,41.1338768
223,"CYPRESS CA",3,22,9,5,8,22,-118.0384903,33.81704712
223,"DALLAS TX",3,676,163,178,335,676,-96.80088043,32.78369904
223,"DALTON GA",3,3,3,0,0,3,-84.97008514,34.76976776
223,"DALY CITY CA",3,5,1,2,2,5,-122.4645081,37.70376968
223,"DANVILLE IL",3,4,2,0,2,4,-87.62978363,40.12442398
223,"DANVILLE VA",3,3,1,2,0,3,-79.39437866,36.58641434
223,"DARLINGTON SC",3,4,1,2,1,4,-79.86645508,34.30082321
223,"DAVENPORT IA",3,4,2,2,0,4,-90.57814026,41.52380753
223,"DAVIDSON NC",3,3,0,1,2,3,-80.8433075,35.49843216
223,"DAVIE FL",3,3,0,2,1,3,-80.23148346,26.0657177
223,"DAVIS CA",3,1,0,0,1,1,-121.7421722,38.54467773
223,"DAYTON OH",3,37,4,18,15,37,-84.19126892,39.75915146
223,"DAYTONA BEACH FL",3,5,2,1,2,5,-81.02253723,29.21147537
223,"DE SOTO MO",3,7,1,1,5,7,-90.55529022,38.13964462
223,"DEARBORN MI",3,3,0,0,3,3,-83.1758728,42.32239914
223,"DEBARY FL",3,1,0,1,0,1,-81.30838776,28.88345909
223,"DECATUR GA",3,42,6,14,22,42,-84.29631805,33.77489471
223,"DECATUR IL",3,2,0,2,0,2,-88.95516968,39.84060287
223,"DEDHAM MA",3,1,0,0,1,1,-71.16512299,42.24193954
223,"DEER CREEK OK",3,2,1,0,1,2,-97.51993561,36.80317307
223,"DEERFIELD BEACH FL",3,2,2,0,0,2,-80.09928131,26.31905365
223,"DEFIANCE OH",3,2,1,0,1,2,-84.35565948,41.28461838
223,"DEL CITY OK",3,1,0,1,0,1,-97.44128418,35.44212723
223,"DELAWARE OH",3,1,1,0,0,1,-83.06757355,40.29886627
223,"DELRAY BEACH FL",3,5,3,0,2,5,-80.07209778,26.46233368
223,"DENMARK SC",3,1,0,0,1,1,-81.14172363,33.32278824
223,"DENTON TX",3,65,18,12,35,65,-97.13349915,33.21514893
223,"DENVER CO",3,198,43,49,106,198,-104.9853745,39.73901749
223,"DERBY KS",3,1,0,1,0,1,-97.26980591,37.54567719
223,"DES MOINES IA",3,23,5,4,14,23,-93.6210022,41.59817123
223,"DES PERES MO",3,1,0,1,0,1,-90.43345642,38.60096741
223,"DESTIN FL",3,2,1,0,1,2,-86.49551392,30.39405632
223,"DETROIT MI",3,223,62,57,104,223,-83.04567719,42.33172226
223,"DIAMOND BAR CA",3,3,0,1,2,3,-117.8404999,33.97759247
223,"DICKINSON ND",3,3,0,0,3,3,-102.7891007,46.87979889
223,"DILLON SC",3,2,0,0,2,2,-79.37909698,34.41096115
223,"DONALDSONVILLE LA",3,2,0,2,0,2,-90.99317932,30.1011734
223,"DONIPHAN MO",3,8,2,1,5,8,-90.82394409,36.62110138
223,"DOTHAN AL",3,1,0,1,0,1,-85.39019775,31.22351265
223,"DOUGLAS GA",3,2,1,0,1,2,-82.84980011,31.50903511
223,"DOUGLASVILLE GA",3,3,2,0,1,3,-84.74777222,33.75165939
223,"DOVER DE",3,1,0,1,0,1,-75.52090454,39.15853882
223,"DOVER NH",3,1,0,1,0,1,-70.88840485,43.2059021
223,"DOYLESTOWN PA",3,4,0,3,1,4,-75.1292038,40.31054688
223,"DUMAS AR",3,1,0,0,1,1,-91.48313904,33.88414001
223,"DUNEDIN FL",3,5,1,3,1,5,-82.77127838,28.02050591
223,"DUNLAP IL",3,2,1,0,1,2,-89.67893219,40.86199951
223,"DURHAM NC",3,58,17,13,28,58,-78.89787292,35.99412918
223,"EASLEY SC",3,1,0,1,0,1,-82.60394287,34.82990646
223,"EAST GRAND FORKS MN",3,1,0,1,0,1,-97.02550507,47.93012619
223,"EAST LANSING MI",3,15,3,5,7,15,-84.48403931,42.73703384
223,"EAST ORANGE NJ",3,34,9,9,16,34,-74.21418762,40.76618958
223,"EAST POINT GA",3,1,0,0,1,1,-84.43933868,33.67996979
223,"EAST PROVIDENCE RI",3,1,0,1,0,1,-71.36916351,41.81398392
223,"EAST TROY WI",3,6,2,1,3,6,-88.40551758,42.78525925
223,"EASTLAKE OH",3,1,1,0,0,1,-81.45001984,41.65415955
223,"EASTON MD",3,2,0,2,0,2,-76.07592773,38.77448654
223,"EAU CLAIRE WI",3,8,2,1,5,8,-91.49876404,44.81137466
223,"EDGEWATER FL",3,35,10,7,18,35,-80.90637207,28.99158287
223,"EDINBORO PA",3,2,0,0,2,2,-80.13100433,41.87437439
223,"EDMOND OK",3,1,0,1,0,1,-97.48453522,35.65326309
223,"EDWARDSVILLE IL",3,67,21,15,31,67,-89.95322418,38.8115654
223,"EFFINGHAM IL",3,2,0,0,2,2,-88.54359436,39.12008667
223,"EL CAJON CA",3,1,0,1,0,1,-116.9467392,32.83002472
223,"EL CERRITO CA",3,2,0,0,2,2,-122.3142548,37.91544342
223,"EL PASO TX",3,10,6,1,3,10,-106.4620514,31.78388405
223,"ELDRIDGE IA",3,1,0,0,1,1,-90.5848465,41.65792465
223,"ELGIN IL",3,1,1,0,0,1,-88.28123474,42.03733444
223,"ELIZABETH CITY NC",3,2,1,1,0,2,-76.22274017,36.3025322
223,"ELIZABETH NJ",3,1,0,0,1,1,-74.21881866,40.66823578
223,"ELIZABETHTOWN KY",3,1,1,0,0,1,-85.85932159,37.69418716
223,"ELK GROVE CA",3,4,1,0,3,4,-121.3743591,38.40848923
223,"ELKHART IN",3,3,0,1,2,3,-85.97689056,41.68212128
223,"ELKO NV",3,5,1,3,1,5,-115.7643967,40.83226395
223,"ELLENSBURG WA",3,2,1,1,0,2,-120.5507507,46.99611664
223,"ELMIRA NY",3,5,1,3,1,5,-76.80737305,42.08998108
223,"ELYRIA OH",3,1,1,0,0,1,-82.10734558,41.36825562
223,"EMPORIA KS",3,1,1,0,0,1,-96.18218994,38.40393448
223,"ENGLEWOOD CO",3,1,1,0,0,1,-104.9884491,39.6479187
223,"ENNIS TX",3,2,1,1,0,2,-96.6258316,32.32971191
223,"ERIE PA",3,3,0,0,3,3,-80.08492279,42.12926483
223,"EUGENE OR",3,35,8,11,16,35,-123.0898361,44.05194855
223,"EULESS TX",3,1,1,0,0,1,-97.08273315,32.83728409
223,"EUNICE LA",3,2,1,0,1,2,-92.41770172,30.49472046
223,"EUREKA CA",3,1,0,0,1,1,-124.1653366,40.80156708
223,"EUREKA MO",3,2,1,1,0,2,-90.62799835,38.50252533
223,"EVANSTON IL",3,7,3,2,2,7,-87.69037628,42.04132843
223,"EVANSVILLE IN",3,25,7,6,12,25,-87.56850433,37.97795486
223,"EVERETT MA",3,12,2,5,5,12,-71.05252075,42.40878296
223,"EXCELSIOR SPRINGS MO",3,2,0,0,2,2,-94.22633362,39.33908463
223,"FAIR GROVE MO",3,1,0,1,0,1,-93.15155792,37.38409424
223,"FAIRBANKS AK",3,2,0,2,0,2,-147.7185669,64.83367157
223,"FAIRBURN GA",3,2,0,0,2,2,-84.58108521,33.56713867
223,"FAIRFAX VA",3,10,2,7,1,10,-77.30588531,38.84661865
223,"FAIRFIELD CA",3,1,1,0,0,1,-122.0420914,38.24917603
223,"FAIRFIELD OH",3,1,1,0,0,1,-84.56064606,39.34600449
223,"FAIRMONT CITY IL",3,3,0,0,3,3,-90.09365845,38.65008545
223,"FALLON NV",3,1,0,1,0,1,-118.7788696,39.47320557
223,"FALLS CHURCH VA",3,3,0,0,3,3,-77.17056274,38.88268661
223,"FARGO ND",3,5,0,2,3,5,-96.79805756,46.87498474
223,"FARMINGDALE NY",3,1,0,0,1,1,-73.44436646,40.73298645
223,"FARMINGTON MI",3,1,0,0,1,1,-83.37620544,42.46465302
223,"FARMINGTON MO",3,5,1,1,3,5,-90.4220047,37.78110504
223,"FARMINGTON NH",3,1,1,0,0,1,-71.07139587,43.38951111
223,"FARMVILLE VA",3,1,1,0,0,1,-78.39121246,37.30234909
223,"FAYETTEVILLE AR",3,16,2,7,7,16,-94.15759277,36.06256104
223,"FAYETTEVILLE GA",3,9,2,1,6,9,-84.45489502,33.44916916
223,"FAYETTEVILLE NC",3,12,3,3,6,12,-78.87771606,35.05313873
223,"FEDERAL WAY WA",3,11,3,0,8,11,-122.314415,47.32177734
223,"FENTON MO",3,50,15,13,22,50,-90.43593597,38.51305771
223,"FERGUSON MO",3,42,11,17,14,42,-90.306633,38.74429321
223,"FERNDALE WA",3,1,1,0,0,1,-122.5937119,48.84636688
223,"FERRIDAY LA",3,1,0,1,0,1,-91.55467224,31.63029099
223,"FESTUS MO",3,7,1,1,5,7,-90.39609528,38.22088623
223,"FLAGLER BEACH FL",3,1,0,0,1,1,-81.12680054,29.47527695
223,"FLINT MI",3,58,8,14,36,58,-83.68744659,43.01246643
223,"FLORENCE AL",3,1,0,1,0,1,-87.67726898,34.7997818
223,"FLORENCE SC",3,4,0,0,4,4,-79.76351166,34.19935226
223,"FLORISSANT MO",3,75,15,15,45,75,-90.32299042,38.78946304
223,"FOLEY AL",3,1,1,0,0,1,-87.68378448,30.40701675
223,"FONTANA CA",3,1,1,0,0,1,-117.4363785,34.09202576
223,"FOREST PARK OH",3,2,1,0,1,2,-84.50376892,39.2902565
223,"FORT COLLINS CO",3,5,0,2,3,5,-105.0858688,40.58546066
223,"FORT LAUDERDALE FL",3,65,17,22,26,65,-80.14283752,26.12309074
223,"FORT LUPTON CO",3,1,0,1,0,1,-104.8086929,40.07614517
223,"FORT MILL SC",3,3,0,2,1,3,-80.94496155,35.00762558
223,"FORT MYERS FL",3,12,5,2,5,12,-81.87184143,26.64133644
223,"FORT PIERCE FL",3,1,1,0,0,1,-80.32531738,27.44716644
223,"FORT VALLEY GA",3,1,0,1,0,1,-83.88742828,32.5541687
223,"FORT WALTON BEACH FL",3,5,2,2,1,5,-86.61834717,30.40767479
223,"FORT WAYNE IN",3,9,5,2,2,9,-85.13967896,41.07278061
223,"FORT WORTH TX",3,143,39,38,66,143,-97.32135773,32.72562027
223,"FRANKLIN IN",3,1,0,0,1,1,-86.05474854,39.48073578
223,"FRANKLIN TN",3,1,0,0,1,1,-86.87760162,35.92164993
223,"FREDERICKSBURG VA",3,3,1,2,0,3,-77.45996094,38.30348969
223,"FREEHOLD NJ",3,1,0,0,1,1,-74.27283478,40.26020432
223,"FREEPORT IL",3,5,1,1,3,5,-89.62126923,42.29691696
223,"FREMONT CA",3,7,4,1,2,7,-121.9740372,37.55101776
223,"FRESNO CA",3,37,9,14,14,37,-119.7739868,36.74755478
223,"FRIDLEY MN",3,5,1,2,2,5,-93.2636261,45.08617401
223,"FRISCO CO",3,1,0,0,1,1,-106.0990143,39.57444763
223,"FRISCO TX",3,8,2,2,4,8,-96.82434082,33.15098572
223,"FULLERTON CA",3,2,0,2,0,2,-117.9268646,33.87014771
223,"FULTON MO",3,1,0,1,0,1,-91.94814301,38.84679031
223,"FULTS IL",3,1,0,1,0,1,-90.21621704,38.16628647
223,"GAINESVILLE FL",3,23,8,5,10,23,-82.32462311,29.65203285
223,"GAINESVILLE GA",3,5,1,2,2,5,-83.82389832,34.29787827
223,"GAITHERSBURG MD",3,3,2,1,0,3,-77.20072174,39.14352417
223,"GALESBURG IL",3,7,2,1,4,7,-90.37152863,40.9480629
223,"GALVESTON TX",3,2,1,0,1,2,-94.79576111,29.30070114
223,"GARDEN CITY NY",3,1,0,1,0,1,-73.63320923,40.72684097
223,"GARDENA CA",3,2,0,0,2,2,-118.3105164,33.88837814
223,"GARDNER KS",3,2,0,2,0,2,-94.92789459,38.81066132
223,"GARLAND TX",3,13,4,5,4,13,-96.63926697,32.91297531
223,"GARY IN",3,7,1,2,4,7,-87.33873749,41.59325409
223,"GASTON SC",3,1,0,0,1,1,-81.10059357,33.8172226
223,"GENEVA IL",3,2,0,1,1,2,-88.30541992,41.8876915
223,"GENOA CITY WI",3,1,1,0,0,1,-88.32978821,42.49824905
223,"GEORGETOWN TX",3,2,1,1,0,2,-97.67801666,30.6329689
223,"GIDDINGS TX",3,1,1,0,0,1,-96.93708801,30.18294907
223,"GIG HARBOR WA",3,6,3,1,2,6,-122.590683,47.32983398
223,"GILBERT AZ",3,8,0,4,4,8,-111.7899933,33.35302353
223,"GLADSTONE MO",3,7,2,1,4,7,-94.55509186,39.20398331
223,"GLENDALE AZ",3,6,0,4,2,6,-112.1871796,33.5386467
223,"GLENDALE CA",3,10,2,4,4,10,-118.2566681,34.1423645
223,"GODFREY IL",3,4,2,0,2,4,-90.18669891,38.95780182
223,"GOLDEN VALLEY MN",3,1,0,0,1,1,-93.33234406,44.98583603
223,"GOLDSBORO NC",3,1,0,0,1,1,-77.99216461,35.38506317
223,"GOODRICH TX",3,1,1,0,0,1,-94.9467926,30.60574341
223,"GRAHAM NC",3,1,0,0,1,1,-79.39993286,36.06936646
223,"GRAND BLANC MI",3,1,0,1,0,1,-83.62955475,42.92750168
223,"GRAND FORKS ND",3,15,0,15,0,15,-97.03855133,47.92044067
223,"GRAND HAVEN MI",3,3,1,0,2,3,-86.22866058,43.06328964
223,"GRAND PRAIRIE TX",3,2,0,0,2,2,-96.99823761,32.74625015
223,"GRAND RAPIDS MI",3,20,9,3,8,20,-85.66797638,42.96317291
223,"GRANDVIEW MO",3,2,0,2,0,2,-94.53369904,38.88563538
223,"GRANITE CITY IL",3,17,3,3,11,17,-90.14891815,38.70147705
223,"GRAPEVINE TX",3,2,0,0,2,2,-97.07859802,32.93464279
223,"GRAY COURT SC",3,3,0,1,2,3,-82.11286926,34.60851669
223,"GREAT FALLS MT",3,2,1,1,0,2,-111.2823257,47.50692368
223,"GREELEY CO",3,3,0,1,2,3,-104.7104645,40.42345047
223,"GREEN BAY WI",3,4,0,1,3,4,-88.01370239,44.51335907
223,"GREENBELT MD",3,13,4,4,5,13,-76.87561035,39.00544357
223,"GREENFIELD WI",3,1,0,0,1,1,-88.01258087,42.96144104
223,"GREENSBORO NC",3,87,20,23,44,87,-79.79152679,36.0729599
223,"GREENVILLE AL",3,1,0,0,1,1,-86.61798096,31.82992363
223,"GREENVILLE NC",3,3,2,0,1,3,-77.37215424,35.61170959
223,"GREENVILLE SC",3,29,3,14,12,29,-82.39870453,34.84753418
223,"GREENWOOD IN",3,8,3,3,2,8,-86.10647583,39.61371994
223,"GRESHAM OR",3,3,1,1,1,3,-122.4333954,45.4980278
223,"GRIFFITH IN",3,1,0,0,1,1,-87.42803955,41.52181625
223,"GRINNELL IA",3,3,0,2,1,3,-92.72964478,41.7466507
223,"GROTON CT",3,4,0,3,1,4,-72.07763672,41.3502121
223,"GROVETOWN GA",3,1,1,0,0,1,-82.19797516,33.45065308
223,"GULF BREEZE FL",3,1,0,0,1,1,-87.16386414,30.35763931
223,"GULF SHORES AL",3,2,0,0,2,2,-87.70103455,30.24625969
223,"GULFPORT MS",3,3,1,2,0,3,-89.09369659,30.37276649
223,"GUSTINE CA",3,1,0,1,0,1,-121.001297,37.25769043
223,"GYPSUM CO",3,1,1,0,0,1,-106.9528198,39.64703369
223,"HACKENSACK NJ",3,1,1,0,0,1,-74.04291534,40.88635254
223,"HADDONFIELD NJ",3,1,0,1,0,1,-75.03710937,39.89155197
223,"HAINES CITY FL",3,4,0,1,3,4,-81.61740875,28.1145668
223,"HALF MOON BAY CA",3,1,1,0,0,1,-122.4299774,37.46336365
223,"HALLSTEAD PA",3,6,2,4,0,6,-75.74239349,41.96153259
223,"HAMDEN CT",3,3,1,0,2,3,-72.89596558,41.39611816
223,"HAMILTON TX",3,1,0,1,0,1,-98.12471008,31.704216
223,"HAMMOND LA",3,8,2,1,5,8,-90.46140289,30.50458908
223,"HAMPTON VA",3,49,8,19,22,49,-76.34473419,37.03002548
223,"HANNIBAL MO",3,1,0,1,0,1,-91.35847473,39.70859146
223,"HARKER HEIGHTS TX",3,9,5,1,3,9,-97.66394806,31.08788109
223,"HARLINGEN TX",3,11,2,2,7,11,-97.69669342,26.19152069
223,"HARRISBURG MO",3,2,0,0,2,2,-92.46318054,39.14170837
223,"HARRISBURG PA",3,12,1,3,8,12,-76.88382721,40.27407455
223,"HARTFORD CT",3,23,3,8,12,23,-72.68445587,41.76383591
223,"HARVEY IL",3,1,0,1,0,1,-87.64677429,41.61020279
223,"HASTINGS NE",3,1,1,0,0,1,-98.38917542,40.58628845
223,"HATTIESBURG MS",3,22,2,10,10,22,-89.29040527,31.32738686
223,"HAVELOCK NC",3,1,0,0,1,1,-76.90039825,34.87951279
223,"HAVERHILL MA",3,1,1,0,0,1,-71.07640076,42.77653122
223,"HAWTHORNE CA",3,4,1,2,1,4,-118.3549194,33.91656113
223,"HAYS KS",3,2,0,2,0,2,-99.32746887,38.87940598
223,"HAYWARD CA",3,8,4,3,1,8,-122.0832672,37.66890335
223,"HAZELWOOD MO",3,8,3,3,2,8,-90.37133789,38.77171707
223,"HELENA MT",3,2,0,1,1,2,-112.0374527,46.59269333
223,"HEMPSTEAD NY",3,1,1,0,0,1,-73.61798096,40.70619965
223,"HENDERSON KY",3,2,0,0,2,2,-87.58986664,37.8363266
223,"HENDERSON NV",3,9,1,2,6,9,-114.9741058,36.03540421
223,"HENDERSONVILLE TN",3,1,0,0,1,1,-86.61997986,36.30472565
223,"HERMANN MO",3,2,0,1,1,2,-91.43791199,38.70432281
223,"HERNANDO MS",3,2,1,1,0,2,-89.99411774,34.82405853
223,"HERNDON VA",3,4,1,2,1,4,-77.38563538,38.96995544
223,"HIALEAH FL",3,4,1,1,2,4,-80.27757263,25.85853386
223,"HICKORY NC",3,1,1,0,0,1,-81.34054565,35.72800827
223,"HIGH POINT NC",3,2,1,1,0,2,-80.00497437,35.95609665
223,"HIGHLAND CA",3,8,1,1,6,8,-117.2105789,34.12824631
223,"HIGHLAND IL",3,2,0,0,2,2,-89.6713562,38.73976135
223,"HIGHLAND KS",3,1,0,0,1,1,-95.27024841,39.85958481
223,"HIGHLAND PARK TX",3,6,3,2,1,6,-96.80493164,32.8320961
223,"HILLSBORO IL",3,3,0,2,1,3,-89.4937439,39.16139603
223,"HILLSBORO MO",3,1,0,1,0,1,-90.56336975,38.23225021
223,"HILLSBORO OR",3,5,1,2,2,5,-122.9927826,45.52270508
223,"HILLSIDE IL",3,1,1,0,0,1,-87.90297699,41.87789917
223,"HINESVILLE GA",3,1,1,0,0,1,-81.59757996,31.85308266
223,"HOBART IN",3,5,1,1,3,5,-87.24478912,41.53391266
223,"HOBOKEN NJ",3,1,1,0,0,1,-74.0316925,40.7443428
223,"HOLLAND MI",3,9,3,1,5,9,-86.10916138,42.78744507
223,"HOLLY SPRINGS GA",3,2,0,2,0,2,-84.50123596,34.17427826
223,"HOLLY SPRINGS MS",3,1,0,1,0,1,-89.44177246,34.77593994
223,"HOLLYWOOD FL",3,18,4,6,8,18,-80.14926147,26.01175499
223,"HOLYOKE MA",3,2,0,1,1,2,-72.61522675,42.20437241
223,"HONDO TX",3,1,0,0,1,1,-99.14228821,29.34803009
223,"HOPE MILLS NC",3,2,1,1,0,2,-78.94456482,34.97066498
223,"HOQUIAM WA",3,1,1,0,0,1,-123.8915939,46.98048782
223,"HORN LAKE MS",3,3,1,0,2,3,-90.03000641,34.96072769
223,"HOT SPRINGS AR",3,2,1,0,1,2,-93.05556488,34.5039978
223,"HOUGHTON MI",3,2,0,1,1,2,-88.56951141,47.12665558
223,"HOUMA LA",3,7,4,0,3,7,-90.71982574,29.59630585
223,"HOUSTON MO",3,1,0,0,1,1,-91.95644379,37.3261528
223,"HOUSTON TX",3,965,246,294,425,965,-95.36399841,29.76376343
223,"HUDSON NY",3,1,1,0,0,1,-73.7900238,42.25299454
223,"HUNTINGTON BEACH CA",3,6,1,3,2,6,-118.0006027,33.66012955
223,"HUNTINGTON WV",3,17,3,4,10,17,-82.44620514,38.4181366
223,"HUNTSVILLE AL",3,26,5,10,11,26,-86.58609772,34.73073959
223,"HUNTSVILLE TX",3,1,0,1,0,1,-95.55122375,30.72374153
223,"HUTTO TX",3,1,0,1,0,1,-97.54733276,30.54326057
223,"IDAHO SPRINGS CO",3,1,0,0,1,1,-105.5237274,39.7417717
223,"IMPERIAL CA",3,2,0,1,1,2,-115.5716705,32.84782791
223,"INDEPENDENCE KY",3,7,2,3,2,7,-84.54380035,38.94332886
223,"INDEPENDENCE MO",3,11,4,2,5,11,-94.41611481,39.09104538
223,"INDIANA PA",3,3,0,0,3,3,-79.15187073,40.6216507
223,"INDIANAPOLIS IN",3,111,36,31,44,111,-86.15828705,39.76844788
223,"INDIO CA",3,3,2,1,0,3,-116.2173004,33.72047043
223,"INGLEWOOD CA",3,22,6,7,9,22,-118.354805,33.96157074
223,"INKSTER MI",3,13,4,4,5,13,-83.31001282,42.29439926
223,"INTERNATIONAL FALLS MN",3,1,0,0,1,1,-93.41119385,48.60089493
223,"IOWA CITY IA",3,16,1,5,10,16,-91.53023529,41.66130066
223,"IRMO SC",3,1,0,0,1,1,-81.18247223,34.08623123
223,"IRVINE CA",3,2,0,0,2,2,-117.8243942,33.66952515
223,"IRVING TX",3,14,4,5,5,14,-96.94924927,32.81419754
223,"ISSAQUAH WA",3,1,1,0,0,1,-122.0345993,47.52977753
223,"ITHACA NY",3,3,2,0,1,3,-76.49575043,42.44075775
223,"JACKSON AL",3,1,0,0,1,1,-87.89234924,31.51841354
223,"JACKSON MI",3,2,0,2,0,2,-84.40149689,42.24575043
223,"JACKSON MS",3,76,16,16,44,76,-90.19654846,32.298172
223,"JACKSON TN",3,16,4,4,8,16,-88.81397247,35.61472321
223,"JACKSON WY",3,2,0,1,1,2,-110.7644806,43.4798851
223,"JACKSONVILLE BEACH FL",3,11,3,4,4,11,-81.39300537,30.29505539
223,"JACKSONVILLE FL",3,84,23,32,29,84,-81.65545654,30.33253288
223,"JANESVILLE WI",3,4,1,1,2,4,-89.01893616,42.68303299
223,"JAY FL",3,1,1,0,0,1,-87.15126801,30.95347977
223,"JEFFERSON CITY MO",3,44,11,17,16,44,-92.17385864,38.57698441
223,"JERSEY CITY NJ",3,17,5,5,7,17,-74.07667542,40.72816849
223,"JERSEYVILLE IL",3,6,1,1,4,6,-90.32881165,39.12010956
223,"JOHNSON CITY TN",3,6,3,2,1,6,-82.35308075,36.31352615
223,"JONESBORO AR",3,7,4,0,3,7,-90.70430756,35.84226608
223,"JONESBORO GA",3,7,1,3,3,7,-84.35381317,33.52181625
223,"JOPLIN MO",3,23,7,5,11,23,-94.5140686,37.08442688
223,"JUNCTION CITY OR",3,1,1,0,0,1,-123.2078552,44.21871567
223,"JUPITER FL",3,7,2,4,1,7,-80.09382629,26.9349556
223,"KALAMAZOO MI",3,21,5,4,12,21,-85.58725739,42.29179764
223,"KALISPELL MT",3,1,0,1,0,1,-114.3166199,48.20161438
223,"KANKAKEE IL",3,1,0,0,1,1,-87.86149597,41.12018204
223,"KANSAS CITY KS",3,22,5,5,12,22,-94.62808228,39.1141777
223,"KANSAS CITY MO",3,472,119,135,218,472,-94.57884979,39.09976578
223,"KATY TX",3,20,8,8,4,20,-95.82484436,29.78606224
223,"KEARNEY NE",3,1,0,1,0,1,-99.08208466,40.69932938
223,"KELLER TX",3,1,1,0,0,1,-97.25247192,32.93486786
223,"KENDALLVILLE IN",3,1,1,0,0,1,-85.27036285,41.44488525
223,"KENNESAW GA",3,8,0,5,3,8,-84.61528015,34.02365875
223,"KENNEWICK WA",3,1,1,0,0,1,-119.1395264,46.2107811
223,"KENOSHA WI",3,1,1,0,0,1,-87.82134247,42.58494949
223,"KENSINGTON MD",3,1,0,1,0,1,-77.07564545,39.02577972
223,"KENT OH",3,1,1,0,0,1,-81.35736084,41.15368271
223,"KENT WA",3,8,2,3,3,8,-122.2377701,47.38068008
223,"KERNERSVILLE NC",3,1,0,1,0,1,-80.07332611,36.12029266
223,"KEY WEST FL",3,24,5,9,10,24,-81.78218079,24.556427
223,"KILLEEN TX",3,2,1,0,1,2,-97.72832489,31.11753464
223,"KIMBALL NE",3,12,6,1,5,12,-103.6635971,41.23585892
223,"KIMBERLING CITY MO",3,2,0,1,1,2,-93.41742706,36.63339233
223,"KINGMAN AZ",3,1,1,0,0,1,-114.0542908,35.18925858
223,"KINLOCH MO",3,4,1,2,1,4,-90.32682037,38.74011612
223,"KIRKLAND WA",3,1,1,0,0,1,-122.2108688,47.6813736
223,"KIRKSVILLE MO",3,3,1,1,1,3,-92.58364105,40.19476318
223,"KIRKWOOD MO",3,14,2,3,9,14,-90.40686798,38.5832901
223,"KISSIMMEE FL",3,9,3,4,2,9,-81.40729523,28.29271317
223,"KLAMATH FALLS OR",3,2,1,1,0,2,-121.7844772,42.2244873
223,"KNIGHTDALE NC",3,1,0,0,1,1,-78.48007202,35.78808975
223,"KNOXVILLE TN",3,55,11,22,22,55,-83.92067719,35.96077728
223,"LA CROSSE WI",3,1,0,0,1,1,-91.23967743,43.80151367
223,"LA HABRA CA",3,1,1,0,0,1,-117.9494629,33.93001556
223,"LA VERNE CA",3,5,2,1,2,5,-117.7696304,34.1006546
223,"LAFAYETTE IN",3,1,0,1,0,1,-86.88406372,40.42077255
223,"LAFAYETTE LA",3,51,13,13,25,51,-92.01987457,30.22468185
223,"LAGUNA BEACH CA",3,2,1,0,1,2,-117.7847061,33.54205322
223,"LAKE CHARLES LA",3,4,3,0,1,4,-93.21766663,30.22713852
223,"LAKE MARY FL",3,1,0,0,1,1,-81.31755829,28.75924492
223,"LAKE WORTH FL",3,3,0,1,2,3,-80.05649567,26.61662102
223,"LAKE WORTH TX",3,1,1,0,0,1,-97.44586182,32.80501556
223,"LAKELAND FL",3,9,4,3,2,9,-81.95620728,28.04432487
223,"LAKEWOOD WA",3,2,1,0,0,1,-122.3653679,47.661533355
223,"LANCASTER CA",3,4,0,1,3,4,-118.1386871,34.69804001
223,"LANCASTER OH",3,1,0,1,0,1,-82.59890747,39.71387482
223,"LANCASTER PA",3,19,2,7,10,19,-76.30498505,40.03824234
223,"LANDOVER HILLS MD",3,1,0,0,1,1,-76.89152527,38.94342804
223,"LANSDOWNE PA",3,3,0,1,2,3,-75.27108765,39.93852234
223,"LANSING IL",3,1,1,0,0,1,-87.5393219,41.56502151
223,"LANSING MI",3,9,5,2,2,9,-84.55532074,42.73265839
223,"LARAMIE WY",3,1,0,0,1,1,-105.592804,41.3115387
223,"LARGO FL",3,10,2,3,5,10,-82.78675079,27.91026115
223,"LAS CRUCES NM",3,2,0,1,1,2,-106.7798538,32.31209564
223,"LAS VEGAS NM",3,1,0,1,0,1,-105.2182999,35.6000061
223,"LAS VEGAS NV",3,263,65,78,120,263,-115.1382141,36.17488098
223,"LAWRENCE KS",3,85,22,27,36,85,-95.23565674,38.97153091
223,"LAWRENCE MA",3,2,1,0,1,2,-71.15792084,42.70630646
223,"LAWRENCEVILLE GA",3,1,1,0,0,1,-83.98753357,33.95662308
223,"LAWTON OK",3,1,0,0,1,1,-98.39124298,34.60861969
223,"LEAGUE CITY TX",3,3,0,2,1,3,-95.09550476,29.50793457
223,"LEANDER TX",3,2,0,2,0,2,-97.85368347,30.57936287
223,"LEBANON PA",3,1,0,1,0,1,-76.41091156,40.34118652
223,"LEBANON TN",3,4,2,0,2,4,-86.29133606,36.20846939
223,"LEESBURG FL",3,7,0,3,4,7,-81.87727356,28.81123161
223,"LEHI UT",3,2,0,1,1,2,-111.8519974,40.39155197
223,"LEIPSIC OH",3,2,0,2,0,2,-83.98432922,41.09840775
223,"LELAND NC",3,1,0,0,1,1,-78.04415131,34.25672913
223,"LENEXA KS",3,2,2,0,0,2,-94.73374176,38.95368576
223,"LEXINGTON MA",3,2,0,1,1,2,-71.22381592,42.44742584
223,"LEXINGTON SC",3,2,1,0,1,2,-81.23597717,33.98204041
223,"LILBURN GA",3,2,0,0,2,2,-84.14273834,33.89017868
223,"LIMA OH",3,1,1,0,0,1,-84.10490417,40.74259186
223,"LINCOLN NE",3,8,2,5,1,8,-96.6674118,40.80001068
223,"LINDALE TX",3,1,0,0,1,1,-95.40984344,32.51585007
223,"LINDEN NJ",3,1,0,1,0,1,-74.24382782,40.62202454
223,"LINDSAY CA",3,1,1,0,0,1,-119.0900345,36.20293427
223,"LITCHFIELD IL",3,2,0,0,2,2,-89.65457916,39.17536163
223,"LITTLE ROCK AR",3,26,6,4,16,26,-92.28178406,34.7369194
223,"LITTLESTOWN PA",3,2,1,1,0,2,-77.08756256,39.74491119
223,"LITTLETON CO",3,5,3,2,0,5,-105.0176163,39.6132431
223,"LIVINGSTON TX",3,1,0,1,0,1,-94.93333435,30.71132088
223,"LIVONIA MI",3,1,0,0,1,1,-83.35256958,42.36862564
223,"LODI CA",3,4,1,0,3,4,-121.2742386,38.12984467
223,"LOGAN UT",3,11,3,7,1,11,-111.8171616,41.73900604
223,"LOGANVILLE GA",3,2,0,1,1,2,-83.90035248,33.83914948
223,"LOMIRA WI",3,14,2,8,4,14,-88.44380188,43.59117126
223,"LONG BEACH CA",3,35,12,9,14,35,-118.1908112,33.7670517
223,"LONGMONT CO",3,3,1,1,1,3,-105.1026764,40.16700745
223,"LOOMIS NE",3,1,0,0,1,1,-99.50801086,40.47853851
223,"LORAIN OH",3,1,0,1,0,1,-82.17118073,41.45874023
223,"LOS ANGELES CA",3,828,195,254,379,828,-118.2459106,34.05225754
223,"LOS GATOS CA",3,1,0,1,0,1,-121.9771652,37.22674561
223,"LOUISVILLE OH",3,3,2,1,0,3,-81.25919342,40.83742905
223,"LOVELAND OH",3,4,0,3,1,4,-84.25993347,39.26356506
223,"LOWELL MA",3,1,1,0,0,1,-71.31530762,42.63344574
223,"LUBBOCK TX",3,9,0,3,6,9,-101.8544312,33.59677505
223,"LUFKIN TX",3,2,1,0,1,2,-94.72932434,31.33858681
223,"LUMBERTON NC",3,1,0,0,1,1,-79.00803375,34.61832428
223,"LUMBERTON TX",3,1,1,0,0,1,-94.19047546,30.25369263
223,"LYNCHBURG VA",3,1,0,1,0,1,-79.14174652,37.41383362
223,"LYNDEN WA",3,11,0,7,4,11,-122.455101,48.94639969
223,"LYNN MA",3,1,1,0,0,1,-70.94833374,42.46699905
223,"LYNNWOOD WA",3,1,0,1,0,1,-122.3175736,47.82042313
223,"LYNWOOD CA",3,8,2,1,5,8,-118.2135544,33.93053055
223,"MADISON AL",3,2,1,0,0,1,-86.487213135,33.561834335
223,"MADISON IL",3,3,1,0,2,3,-90.15700531,38.68284988
223,"MADISON MS",3,1,0,0,1,1,-90.11543274,32.46231079
223,"MADISON WI",3,52,8,13,31,52,-89.40128326,43.07303619
223,"MADISONVILLE LA",3,1,0,0,1,1,-90.15699005,30.40480232
223,"MALDEN MO",3,4,0,3,1,4,-89.96641541,36.55708313
223,"MANASSAS VA",3,1,0,1,0,1,-77.47459412,38.75112534
223,"MANCHESTER MO",3,1,0,0,1,1,-90.50953674,38.597229
223,"MANCHESTER NH",3,4,1,2,1,4,-71.45406342,42.99581528
223,"MANDEVILLE LA",3,7,1,1,5,7,-90.06562805,30.35881805
223,"MANHATTAN KS",3,17,4,2,11,17,-96.57228851,39.18354034
223,"MANKATO MN",3,5,0,1,4,5,-94.02125549,44.15895462
223,"MANNING SC",3,1,0,0,1,1,-80.21025085,33.69546509
223,"MANSFIELD TX",3,5,1,2,2,5,-97.14230347,32.56362152
223,"MAPLE SHADE NJ",3,9,1,4,4,9,-74.9913559,39.95294571
223,"MAPLEWOOD MN",3,1,0,0,1,1,-93.05480194,45.01259232
223,"MAPLEWOOD MO",3,14,6,3,5,14,-90.32471466,38.6126976
223,"MAPLEWOOD NJ",3,1,0,0,1,1,-74.27243805,40.77401733
223,"MARANA AZ",3,2,0,0,2,2,-111.2269363,32.43688965
223,"MARATHON FL",3,1,0,1,0,1,-81.09011841,24.71463966
223,"MARICOPA AZ",3,1,0,1,0,1,-112.0491562,33.05832672
223,"MARIETTA GA",3,21,2,7,12,21,-84.54958344,33.9527359
223,"MARION IL",3,1,0,1,0,1,-88.93344116,37.73056412
223,"MARION OH",3,1,0,0,1,1,-83.12861633,40.58881378
223,"MARKS MS",3,3,1,0,2,3,-90.27207947,34.25684357
223,"MARLBOROUGH MA",3,1,1,0,0,1,-71.55128479,42.34592819
223,"MARSHALL MN",3,1,0,0,1,1,-95.78921509,44.4466362
223,"MARSHFIELD MO",3,2,0,2,0,2,-92.90744781,37.33891678
223,"MARTINEZ CA",3,1,0,0,1,1,-122.1364365,38.01914597
223,"MARTINSBURG WV",3,1,0,0,1,1,-77.96557617,39.45707703
223,"MARYLAND HEIGHTS MO",3,3,1,0,2,3,-90.43025208,38.71334076
223,"MARYSVILLE OH",3,2,2,0,0,2,-83.36706543,40.2364006
223,"MARYSVILLE PA",3,1,0,0,1,1,-76.92907715,40.34276199
223,"MARYSVILLE WA",3,7,3,1,3,7,-122.179451,48.05155182
223,"MARYVILLE IL",3,1,0,0,1,1,-89.95622253,38.72364044
223,"MARYVILLE MO",3,2,1,1,0,2,-94.87281036,40.34609604
223,"MARYVILLE TN",3,3,0,1,2,3,-83.96243286,35.76000977
223,"MASCOUTAH IL",3,4,0,0,4,4,-89.79308319,38.49026489
223,"MASON CITY IA",3,2,0,0,2,2,-93.20175934,43.15355301
223,"MATTHEWS NC",3,1,1,0,0,1,-80.72332001,35.11704254
223,"MAUMEE OH",3,1,0,1,0,1,-83.65665436,41.56746292
223,"MAYETTA KS",3,6,1,3,2,6,-95.72317505,39.33889008
223,"MAYSVILLE NC",3,1,1,0,0,1,-77.23084259,34.90504074
223,"MAYWOOD IL",3,2,0,2,0,2,-87.84314728,41.87941742
223,"MCALLEN TX",3,3,2,1,0,3,-98.23077393,26.20433426
223,"MCDONOUGH GA",3,12,3,3,6,12,-84.1467514,33.44765472
223,"MCKINNEY TX",3,41,12,12,17,41,-96.6155777,33.19782257
223,"MCPHERSON KS",3,1,0,0,1,1,-97.66510773,38.37078094
223,"MECHANICVILLE NY",3,1,1,0,0,1,-73.68631744,42.90293121
223,"MEDFORD OR",3,3,0,2,1,3,-122.8773193,42.32625961
223,"MEDICAL LAKE WA",3,1,0,0,1,1,-117.682518,47.57226944
223,"MELBOURNE FL",3,6,1,3,2,6,-80.60625458,28.07838249
223,"MEMPHIS TN",3,211,61,58,92,211,-90.01696014,35.1194191
223,"MENLO PARK CA",3,2,0,1,1,2,-122.1842423,37.45361328
223,"MENTOR OH",3,3,1,1,1,3,-81.33918762,41.66637421
223,"MERIDEN CT",3,1,0,1,0,1,-72.80596161,41.5384407
223,"MERIDIAN MS",3,4,0,2,2,4,-88.70374298,32.36473846
223,"MERRILLVILLE IN",3,1,1,0,0,1,-87.33312988,41.48298645
223,"MESA AZ",3,32,8,15,9,32,-111.8239059,33.42222214
223,"MESQUITE TX",3,6,2,2,2,6,-96.59959412,32.76692581
223,"METUCHEN NJ",3,1,0,0,1,1,-74.36269379,40.543293
223,"MEXICO MO",3,1,0,0,1,1,-91.8833313,39.16965866
223,"MIAMI BEACH FL",3,9,4,4,1,9,-80.12982178,25.79146576
223,"MIAMI FL",3,299,75,82,142,299,-80.19329071,25.77483749
223,"MIAMISBURG OH",3,1,0,0,1,1,-84.28652191,39.643116
223,"MIDDLEBURY VT",3,13,6,4,3,13,-73.16629028,44.01540756
223,"MIDDLETOWN NJ",3,2,0,2,0,2,-74.11607361,40.39449692
223,"MIDLAND MI",3,1,0,0,1,1,-84.24700928,43.61585236
223,"MIDWAY FL",3,1,1,0,0,1,-84.45413971,30.49596024
223,"MIDWEST CITY OK",3,1,0,0,1,1,-97.39709473,35.44970703
223,"MILAN TN",3,2,1,0,1,2,-88.75936127,35.91966248
223,"MILFORD MA",3,1,0,0,1,1,-71.51522064,42.14015198
223,"MILLEDGEVILLE GA",3,3,0,2,1,3,-83.23179626,33.08055878
223,"MILLERSVILLE PA",3,1,0,1,0,1,-76.35368347,39.99788666
223,"MILLSTADT IL",3,2,0,1,1,2,-90.09213257,38.46154404
223,"MILWAUKEE WI",3,77,29,23,25,77,-87.90684509,43.03887939
223,"MINDEN LA",3,14,3,3,8,14,-93.28716278,32.61589432
223,"MINNEAPOLIS MN",3,95,24,34,37,95,-93.26397705,44.97980118
223,"MINNESOTA CITY MN",3,1,0,0,1,1,-91.74989319,44.09374237
223,"MINNETONKA MN",3,2,0,0,2,2,-93.43367004,44.92795181
223,"MIRAMAR FL",3,3,0,1,2,3,-80.23181915,25.98794746
223,"MISHAWAKA IN",3,1,0,1,0,1,-86.18048859,41.65872574
223,"MISSION KS",3,2,0,0,2,2,-94.65638733,39.02796173
223,"MISSION TX",3,1,1,0,0,1,-98.32580566,26.21655273
223,"MISSION VIEJO CA",3,2,1,0,1,2,-117.6737366,33.59992218
223,"MISSOULA MT",3,6,0,4,2,6,-113.9832687,46.87278366
223,"MISSOURI CITY TX",3,2,0,1,1,2,-95.5381012,29.61878204
223,"MOBERLY MO",3,1,0,1,0,1,-92.43862152,39.41818619
223,"MOBILE AL",3,20,8,5,7,20,-88.04309845,30.69476128
223,"MONCKS CORNER SC",3,1,0,0,1,1,-80.01290131,33.19626236
223,"MONETT MO",3,1,0,0,1,1,-93.92830658,36.92906952
223,"MONMOUTH OR",3,1,0,0,1,1,-123.2363892,44.84816742
223,"MONROE GA",3,1,0,0,1,1,-83.71302795,33.79499817
223,"MONROE LA",3,5,1,2,2,5,-92.11960602,32.50980759
223,"MONROE MI",3,2,1,0,1,2,-83.39758301,41.91663742
223,"MONROVIA CA",3,6,1,3,2,6,-118.0006485,34.14796829
223,"MONTAGUE MI",3,1,0,1,0,1,-86.35713959,43.41694641
223,"MONTCLAIR NJ",3,2,0,1,1,2,-74.20848083,40.82605362
223,"MONTGOMERY AL",3,19,4,5,10,19,-86.29966736,32.36724472
223,"MONTGOMERY TX",3,1,0,0,1,1,-95.69664001,30.38855171
223,"MONTPELIER VT",3,1,0,0,1,1,-72.57458496,44.26039124
223,"MOORE OK",3,3,1,0,2,3,-97.48735046,35.33969498
223,"MOORESVILLE NC",3,2,2,0,0,2,-80.80976868,35.58535004
223,"MOORPARK CA",3,5,1,2,2,5,-118.8839111,34.28554535
223,"MOREHEAD KY",3,1,0,0,1,1,-83.43223572,38.18409348
223,"MORGANTON NC",3,3,1,0,2,3,-81.68434906,35.74584961
223,"MORGANTOWN WV",3,2,0,1,1,2,-79.95038605,39.63131714
223,"MORRO BAY CA",3,1,0,0,1,1,-120.8519135,35.36568451
223,"MORROW GA",3,5,0,3,2,5,-84.33943939,33.58339691
223,"MOSCOW MILLS MO",3,3,2,0,1,3,-90.91833496,38.94809341
223,"MOSES LAKE WA",3,2,0,1,1,2,-119.2802811,47.12987137
223,"MOUND VALLEY KS",3,1,0,1,0,1,-95.40553284,37.20561218
223,"MOUNT POCONO PA",3,2,1,1,0,2,-75.36369324,41.12226868
223,"MOUNT VERNON IN",3,4,0,2,2,4,-87.89586639,37.93523407
223,"MOUNT VERNON NY",3,4,1,0,1,2,-76.36322403,41.83351135
223,"MOUNTAIN VIEW AR",3,1,0,1,0,1,-92.11795807,35.86831665
223,"MOUNTAIN VIEW CA",3,6,0,2,4,6,-122.0861969,37.3859024
223,"MUNCIE IN",3,2,1,1,0,2,-85.38398743,40.18970871
223,"MURFREESBORO TN",3,3,1,1,1,3,-86.39038086,35.84575653
223,"MUSCLE SHOALS AL",3,1,0,0,1,1,-87.6674881,34.74491882
223,"MUSKOGEE OK",3,2,0,0,2,2,-95.36999512,35.74824142
223,"MYRTLE BEACH SC",3,7,3,3,1,7,-78.88601685,33.69656372
223,"NAMPA ID",3,1,0,0,1,1,-116.5658188,43.54054642
223,"NAPA CA",3,3,0,2,1,3,-122.2872086,38.29692841
223,"NAPERVILLE IL",3,1,0,0,1,1,-88.14768219,41.78578949
223,"NAPLES FL",3,3,1,1,1,3,-81.79434204,26.14280128
223,"NASHUA NH",3,1,0,0,1,1,-71.46669769,42.76576996
223,"NASHVILLE IL",3,1,0,0,1,1,-89.3805542,38.34370804
223,"NATCHITOCHES LA",3,11,3,4,4,11,-93.08662415,31.76096535
223,"NATICK MA",3,5,1,2,2,5,-71.3484726,42.2836113
223,"NAUGATUCK CT",3,5,1,1,3,5,-73.04972076,41.4863205
223,"NAZARETH PA",3,12,2,4,6,12,-75.30902863,40.74064255
223,"NEOSHO MO",3,4,1,1,2,4,-94.36846161,36.86910629
223,"NEW BERN NC",3,1,0,1,0,1,-77.04354095,35.10897827
223,"NEW BRUNSWICK NJ",3,3,3,0,0,3,-74.45104218,40.48620987
223,"NEW CARROLLTON MD",3,3,0,2,1,3,-76.8794632,38.97011185
223,"NEW CASTLE DE",3,21,4,7,10,21,-75.56227875,39.66440964
223,"NEW CASTLE IN",3,1,1,0,0,1,-85.36640167,39.9315567
223,"NEW HAVEN CT",3,27,10,6,11,27,-72.92726898,41.3084259
223,"NEW LONDON CT",3,1,0,0,1,1,-72.09841156,41.35572815
223,"NEW ORLEANS LA",3,267,69,87,111,267,-90.07525635,29.95483589
223,"NEW ROCHELLE NY",3,2,0,1,1,2,-73.78160858,40.91175842
223,"NEW YORK NY",3,800,192,252,356,800,-74.00528717,40.7145195
223,"NEWARK DE",3,6,2,2,2,6,-75.74462128,39.68774414
223,"NEWARK NJ",3,42,11,13,18,42,-74.17185211,40.73570633
223,"NEWCASTLE OK",3,1,0,0,1,1,-97.60009766,35.24757004
223,"NEWPORT NEWS VA",3,11,1,3,7,11,-76.42758942,36.97909927
223,"NEWPORT RI",3,2,0,1,1,2,-71.31213379,41.49024963
223,"NIAGARA FALLS NY",3,3,1,1,1,3,-79.05632019,43.09456253
223,"NOLENSVILLE TN",3,2,1,0,1,2,-86.66940308,35.95249557
223,"NORCROSS GA",3,1,0,0,1,1,-84.21324158,33.94129181
223,"NORFOLK VA",3,66,16,15,35,66,-76.28334045,36.84831619
223,"NORMAL IL",3,2,1,0,1,2,-88.99052429,40.51409912
223,"NORMAN OK",3,12,3,6,3,12,-97.44689178,35.22203827
223,"NORTH AUGUSTA SC",3,5,1,2,2,5,-81.96509552,33.5021019
223,"NORTH BEND WA",3,2,1,0,1,2,-121.7899017,47.49547195
223,"NORTH BERGEN NJ",3,3,1,1,1,3,-74.0112381,40.8045845
223,"NORTH BRANCH MI",3,3,0,3,0,3,-83.19683838,43.22947311
223,"NORTH CHARLESTON SC",3,5,0,2,3,5,-79.97457886,32.85499191
223,"NORTH CHICAGO IL",3,1,0,1,0,1,-87.8412323,42.3254509
223,"NORTH EAST MD",3,1,0,1,0,1,-75.94083405,39.60018539
223,"NORTH LAS VEGAS NV",3,4,1,0,3,4,-115.1192093,36.19900131
223,"NORTH LITTLE ROCK AR",3,12,3,2,7,12,-92.26677704,34.76465988
223,"NORTH MIAMI BEACH FL",3,2,1,0,1,2,-80.16223907,25.93397713
223,"NORTH MIAMI FL",3,2,1,0,1,2,-80.18624115,25.8908596
223,"NORTH PLATTE NE",3,2,0,2,0,2,-100.7660141,41.12404633
223,"NORTH RICHLAND HILLS TX",3,1,1,0,0,1,-97.22973633,32.83457947
223,"NORTH RIVERSIDE IL",3,3,1,0,2,3,-87.82305908,41.84282684
223,"NORTHAMPTON MA",3,3,0,2,1,3,-72.64012146,42.32544708
223,"NORTHPORT AL",3,1,0,1,0,1,-87.57746124,33.22927856
223,"NORWALK OH",3,2,0,0,2,2,-82.61576843,41.24267197
223,"NOVATO CA",3,1,1,0,0,1,-122.576561,38.11727142
223,"O'FALLON MO",3,66,18,21,27,66,-90.69979095,38.8109436
223,"OAK BLUFFS MA",3,1,0,0,1,1,-70.56096649,41.45436859
223,"OAK CREEK WI",3,2,0,1,1,2,-87.86346436,42.88599014
223,"OAK LAWN IL",3,4,0,2,2,4,-87.7545929,41.721138
223,"OAKDALE LA",3,2,1,1,0,2,-92.66092682,30.8165493
223,"OAKLAND CA",3,182,46,64,72,182,-122.2733154,37.80438614
223,"OCALA FL",3,1,0,0,1,1,-82.13973236,29.18780708
223,"OCEANSIDE CA",3,8,2,1,5,8,-117.3814011,33.19587326
223,"ODESSA TX",3,2,0,1,1,2,-102.3682938,31.84587097
223,"OGALLALA NE",3,8,0,4,4,8,-101.7200775,41.1279068
223,"OGDEN AR",3,6,1,1,4,6,-94.04294586,33.58304214
223,"OGDEN UT",3,2,0,1,1,2,-111.9730225,41.22582626
223,"OHIO IL",3,1,0,0,1,1,-89.46100616,41.55773544
223,"OKLAHOMA CITY OK",3,53,14,17,22,53,-97.51699829,35.46761322
223,"OLANTA SC",3,1,1,0,0,1,-79.93212128,33.93557358
223,"OLATHE KS",3,55,11,14,30,55,-94.81970215,38.88142395
223,"OLD MONROE MO",3,1,1,0,0,1,-90.74708557,38.93173981
223,"OLIVE BRANCH MS",3,4,0,1,3,4,-89.82355499,34.96377563
223,"OLYMPIA FIELDS IL",3,2,0,1,1,2,-87.67446899,41.51344299
223,"OLYMPIA WA",3,5,2,0,3,5,-122.8909378,47.04053497
223,"OMAHA NE",3,41,18,10,13,41,-95.93825531,41.25878906
223,"ONTARIO CA",3,4,1,2,1,4,-117.6528702,34.06340408
223,"OPELIKA AL",3,1,0,1,0,1,-85.3780365,32.64568329
223,"ORANGE CA",3,19,5,5,9,19,-117.8544846,33.7877388
223,"ORANGE GROVE TX",3,1,0,0,1,1,-97.93759155,27.95745277
223,"ORANGEBURG SC",3,9,4,4,1,9,-80.86129761,33.48974228
223,"OREGON CITY OR",3,1,0,1,0,1,-122.6096726,45.35689163
223,"ORLANDO FL",3,195,49,61,85,195,-81.3789978,28.53886795
223,"ORMOND BEACH FL",3,1,0,0,1,1,-81.05541992,29.28623772
223,"OSHKOSH WI",3,1,1,0,0,1,-88.54268646,44.02453613
223,"OSSINING NY",3,5,4,0,1,5,-73.86093903,41.16327286
223,"OVERLAND MO",3,5,1,2,2,5,-90.36277008,38.70130157
223,"OVERLAND PARK KS",3,14,3,1,10,14,-94.67124939,38.98216248
223,"OVIEDO FL",3,1,1,0,0,1,-81.20778656,28.67054749
223,"OWENSBORO KY",3,2,0,0,2,2,-87.11345673,37.77421188
223,"OWINGSVILLE KY",3,1,0,0,1,1,-83.76404572,38.14480591
223,"OWOSSO MI",3,1,0,0,1,1,-84.17687988,42.99795914
223,"OXFORD AL",3,9,2,2,5,9,-85.83503723,33.6145134
223,"OXFORD MS",3,8,3,1,4,8,-89.52319336,34.37203979
223,"OXNARD CA",3,7,2,2,3,7,-119.1790085,34.19766998
223,"OZARK MO",3,7,0,1,6,7,-93.20661163,37.02112198
223,"PAGEDALE MO",3,2,1,0,1,2,-90.30786133,38.68356323
223,"PALISADES PARK NJ",3,2,1,1,0,2,-73.9969635,40.84852982
223,"PALM BAY FL",3,3,2,0,1,3,-80.58313751,28.03806496
223,"PALM BEACH FL",3,12,3,4,5,12,-80.03616333,26.70643616
223,"PALM BEACH GARDENS FL",3,1,0,0,1,1,-80.07454681,26.8109169
223,"PALM DESERT CA",3,3,1,1,1,3,-116.3907166,33.72164154
223,"PALM SPRINGS CA",3,11,2,3,6,11,-116.5467758,33.83036423
223,"PALO ALTO CA",3,4,1,3,0,4,-122.1449661,37.44177628
223,"PANAMA CITY BEACH FL",3,12,2,5,5,12,-85.80211639,30.1792717
223,"PARIS IL",3,1,0,1,0,1,-87.69623566,39.61117172
223,"PARIS TX",3,5,0,3,2,5,-95.55589294,33.66113663
223,"PARK RAPIDS MN",3,1,0,0,1,1,-95.05949402,46.92217636
223,"PARKER CO",3,6,2,1,3,6,-104.7624359,39.51849365
223,"PARKERSBURG WV",3,1,0,0,1,1,-81.54850006,39.28261948
223,"PARKVILLE MO",3,1,0,0,1,1,-94.68252563,39.19501114
223,"PARMA OH",3,1,0,0,1,1,-81.72257996,41.40510178
223,"PASADENA CA",3,15,5,3,7,15,-118.1466675,34.14794922
223,"PASCO WA",3,7,1,1,5,7,-119.1023636,46.2282753
223,"PASSAIC NJ",3,2,1,0,1,2,-74.12754822,40.8571434
223,"PATERSON NJ",3,2,1,1,0,2,-74.17102051,40.91714478
223,"PATTERSON LA",3,1,1,0,0,1,-91.30235291,29.69374847
223,"PAVILION NY",3,1,0,1,0,1,-78.02204895,42.87609482
223,"PAWTUCKET RI",3,1,0,0,1,1,-71.38137054,41.87892532
223,"PEARLAND TX",3,1,0,0,1,1,-95.28644562,29.56411743
223,"PEMBROKE PINES FL",3,2,0,0,2,2,-80.22357941,26.00384903
223,"PENSACOLA FL",3,12,3,5,4,12,-87.21669006,30.42154694
223,"PEORIA IL",3,6,1,3,2,6,-89.59487152,40.70241928
223,"PERRIS CA",3,1,0,0,1,1,-117.2306519,33.78261948
223,"PERRY IA",3,1,0,1,0,1,-94.10754395,41.83876801
223,"PERRYSBURG OH",3,1,0,0,1,1,-83.62700653,41.55728531
223,"PERRYVILLE MO",3,2,2,0,0,2,-89.86131287,37.72448349
223,"PERTH AMBOY NJ",3,9,4,1,4,9,-74.26480103,40.5068779
223,"PETERSBURG VA",3,4,0,2,2,4,-77.40148926,37.2280426
223,"PFLUGERVILLE TX",3,2,1,1,0,2,-97.62039948,30.4396553
223,"PHILADELPHIA PA",3,416,89,125,202,416,-75.16322327,39.95243835
223,"PHOENIX AZ",3,115,32,43,40,115,-112.0752716,33.44825363
223,"PINE BLUFF AR",3,8,1,2,5,8,-92.00374603,34.22846222
223,"PINELLAS PARK FL",3,1,0,0,1,1,-82.69934845,27.84342194
223,"PISMO BEACH CA",3,3,1,1,1,3,-120.6432953,35.1427269
223,"PITTSBORO IN",3,1,0,1,0,1,-86.46704865,39.8641243
223,"PITTSBURG CA",3,17,1,9,7,17,-121.8871613,38.02787781
223,"PITTSBURG KS",3,1,0,0,1,1,-94.70526123,37.41111374
223,"PITTSBURG TX",3,2,1,0,1,2,-94.96621704,32.99585342
223,"PITTSBURGH PA",3,365,103,117,145,365,-79.99537659,40.44091415
223,"PITTSFIELD MA",3,1,0,0,1,1,-73.24451447,42.45004272
223,"PLACERVILLE CA",3,4,2,2,0,4,-120.8002701,38.72951508
223,"PLAINFIELD IL",3,12,1,6,5,12,-88.20417786,41.62700653
223,"PLAINFIELD IN",3,14,3,4,7,14,-86.39954376,39.70450974
223,"PLAINFIELD NJ",3,1,0,0,1,1,-74.40673065,40.63404083
223,"PLANO TX",3,7,1,5,1,7,-96.69931793,33.01993942
223,"PLANT CITY FL",3,1,1,0,0,1,-82.11231232,28.01914597
223,"PLANTATION FL",3,5,1,1,3,5,-80.23281097,26.12825966
223,"PLAQUEMINE LA",3,2,0,1,1,2,-91.23427582,30.28962708
223,"POMONA CA",3,1,1,0,0,1,-117.7534485,34.05541611
223,"POMPANO BEACH FL",3,5,0,1,4,5,-80.12407684,26.23855591
223,"PONTIAC MI",3,6,1,2,3,6,-83.29104614,42.63900757
223,"PORT ARTHUR TX",3,38,8,8,22,38,-93.93045807,29.90067863
223,"PORT HURON MI",3,1,1,0,0,1,-82.42453766,42.97105026
223,"PORT JERVIS NY",3,1,1,0,0,1,-74.69218445,41.37543488
223,"PORTLAND ME",3,4,1,2,1,4,-70.25403595,43.6618576
223,"PORTLAND OR",3,184,57,65,62,184,-122.6786423,45.52309418
223,"PORTSMOUTH VA",3,9,3,3,3,9,-76.29769135,36.83554077
223,"POTOSI MO",3,1,0,1,0,1,-90.78826141,37.93638992
223,"POUGHKEEPSIE NY",3,1,0,0,1,1,-73.92034149,41.70055771
223,"PRAIRIE VIEW TX",3,1,0,0,1,1,-95.9883194,30.09370232
223,"PRAIRIE VILLAGE KS",3,1,0,0,1,1,-94.63400269,38.99189377
223,"PRATTVILLE AL",3,7,4,2,1,7,-86.45972443,32.46446228
223,"PRICHARD AL",3,4,0,1,3,4,-88.07904053,30.739048
223,"PRINCETON NJ",3,3,1,0,2,3,-74.65805817,40.34872055
223,"PROVIDENCE RI",3,21,5,6,10,21,-71.40118408,41.82990265
223,"PROVINCETOWN MA",3,30,5,11,14,30,-70.17770386,42.05849075
223,"PROVO UT",3,5,1,2,2,5,-111.6589813,40.23337936
223,"PUEBLO CO",3,1,0,1,0,1,-104.6108551,38.25450516
223,"PULLMAN WA",3,79,16,26,37,79,-117.180481,46.73068619
223,"PUYALLUP WA",3,1,0,0,1,1,-122.2927628,47.19064331
223,"QUINCY IL",3,4,3,0,1,4,-91.41021729,39.9356575
223,"RACINE WI",3,2,0,1,1,2,-87.78296661,42.72628021
223,"RALEIGH NC",3,118,26,34,58,118,-78.63800049,35.77230835
223,"RANCHO CORDOVA CA",3,15,4,2,9,15,-121.3053742,38.58900452
223,"RANDOLPH MA",3,1,0,1,0,1,-71.03983307,42.1629715
223,"RAYTOWN MO",3,1,0,0,1,1,-94.46369934,39.00871277
223,"READING MA",3,1,1,0,0,1,-71.0990448,42.52708054
223,"READING PA",3,6,3,0,3,6,-75.9259491,40.33562851
223,"RED BLUFF CA",3,3,1,0,2,3,-122.2382431,40.17803574
223,"RED LAKE FALLS MN",3,1,1,0,0,1,-96.27508545,47.88212967
223,"REDDING CA",3,2,1,1,0,2,-122.3944626,40.58649826
223,"REDMOND OR",3,1,1,0,0,1,-121.1761093,44.27230453
223,"REDMOND WA",3,9,2,2,5,9,-122.1240006,47.67367172
223,"REDONDO BEACH CA",3,4,0,1,3,4,-118.3907471,33.84916687
223,"REDWOOD CITY CA",3,2,1,1,0,2,-122.2364655,37.48601151
223,"REIDSVILLE NC",3,1,0,0,1,1,-79.66392517,36.35525513
223,"RENO NV",3,10,4,3,3,10,-119.8160934,39.5294838
223,"REPUBLIC MO",3,2,0,1,1,2,-93.48056793,37.12031555
223,"REVERE MA",3,2,0,0,2,2,-71.01091003,42.40863037
223,"REYNOLDSBURG OH",3,2,1,0,1,2,-82.81163788,39.95471191
223,"RIALTO CA",3,5,4,0,1,5,-117.3716126,34.1063118
223,"RICHARDSON TX",3,2,0,2,0,2,-96.73020172,32.94840622
223,"RICHLAND GA",3,1,0,0,1,1,-84.66703033,32.08826828
223,"RICHLAND WA",3,1,0,0,1,1,-119.2866592,46.28547287
223,"RICHMOND CA",3,3,2,1,0,3,-122.3500443,37.9354744
223,"RICHMOND HEIGHTS MO",3,26,11,6,9,26,-90.31951904,38.62892532
223,"RICHMOND IN",3,1,0,1,0,1,-84.8900528,39.82888412
223,"RICHMOND MO",3,1,0,0,1,1,-93.97762299,39.2788353
223,"RICHMOND VA",3,64,17,19,28,64,-77.45962524,37.55412674
223,"RICHTON PARK IL",3,1,0,0,1,1,-87.70342255,41.48434448
223,"RIDGELAND MS",3,1,1,0,0,1,-90.13221741,32.42857742
223,"RIDGWAY PA",3,15,4,7,4,15,-78.72838593,41.42049026
223,"RIO RANCHO NM",3,2,1,0,1,2,-106.6682816,35.23852539
223,"RIO VISTA TX",3,1,0,0,1,1,-97.37525177,32.23380661
223,"RIPON WI",3,1,0,1,0,1,-88.83634186,43.8422966
223,"RIVERDALE GA",3,6,1,3,2,6,-84.4131012,33.57296371
223,"RIVERDALE IL",3,3,0,1,2,3,-87.633255,41.6336174
223,"RIVERSIDE CA",3,25,6,11,8,25,-117.3973999,33.95311737
223,"RIVERSIDE NJ",3,3,1,2,0,3,-74.95646667,40.03240967
223,"RIVERTON IL",3,1,0,0,1,1,-89.53983307,39.84453201
223,"RIVERTON UT",3,1,1,0,0,1,-111.940033,40.52087402
223,"ROANOKE VA",3,3,0,1,2,3,-79.94111633,37.27119827
223,"ROBINSON IL",3,8,2,2,4,8,-87.73912048,39.00521469
223,"ROCHESTER MI",3,3,1,0,2,3,-83.13374329,42.68050766
223,"ROCHESTER MN",3,3,1,1,1,3,-92.47042084,44.02156448
223,"ROCHESTER NY",3,64,22,16,26,64,-77.61522675,43.15487671
223,"ROCK HILL SC",3,10,1,3,6,10,-81.02463531,34.92498779
223,"ROCKDALE TX",3,3,2,1,0,3,-97.00177765,30.65601349
223,"ROCKFORD IL",3,15,4,6,5,15,-89.09428406,42.27135086
223,"ROCKLEDGE FL",3,1,1,0,0,1,-80.72518921,28.33512306
223,"ROCKLIN CA",3,1,0,0,1,1,-121.2383118,38.79031754
223,"ROCKVILLE MD",3,2,0,1,1,2,-77.15235901,39.08402252
223,"ROCKWALL TX",3,1,0,0,1,1,-96.46016693,32.93169022
223,"ROCKY HILL CT",3,1,0,1,0,1,-72.64056396,41.66537857
223,"ROCKY MOUNT NC",3,2,1,1,0,2,-77.78997803,35.93837738
223,"ROME GA",3,2,0,1,1,2,-85.16900635,34.24008942
223,"ROMEOVILLE IL",3,1,1,0,0,1,-88.08948517,41.64759064
223,"ROSELLE NJ",3,9,3,2,4,9,-74.2624588,40.66469574
223,"ROSEVILLE CA",3,1,0,0,1,1,-121.2899246,38.75195694
223,"ROSEVILLE MI",3,1,1,0,0,1,-82.93720245,42.49747086
223,"ROSEVILLE MN",3,1,0,0,1,1,-93.14508057,45.02290726
223,"ROSWELL NM",3,1,0,1,0,1,-104.5282135,33.39533997
223,"ROUND LAKE BEACH IL",3,1,1,0,0,1,-88.09038544,42.37156677
223,"ROUND ROCK TX",3,3,0,1,2,3,-97.67939758,30.50861359
223,"ROXANA IL",3,4,1,2,1,4,-90.07637024,38.84868622
223,"ROYSE CITY TX",3,1,0,1,0,1,-96.33287048,32.97550201
223,"RUSHVILLE IL",3,1,0,1,0,1,-90.56352997,40.12114334
223,"RUSHVILLE IN",3,2,1,0,1,2,-85.45323944,39.6113205
223,"RUSSELLVILLE AR",3,1,1,0,0,1,-93.1343689,35.27845383
223,"RUSTON LA",3,2,1,1,0,2,-92.63848877,32.52357101
223,"RUTLAND VT",3,1,1,0,0,1,-72.97142029,43.61096954
223,"RYE CO",3,2,0,1,1,2,-104.9316177,37.92366791
223,"SACRAMENTO CA",3,140,33,38,69,140,-121.4959793,38.58154297
223,"SAGINAW MI",3,4,2,2,0,4,-83.95076752,43.41968918
223,"SAHUARITA AZ",3,54,10,15,29,54,-110.9567032,31.95795059
223,"SALEM IL",3,1,1,0,0,1,-88.94590759,38.62715149
223,"SALEM OR",3,6,0,4,2,6,-123.0377197,44.94248199
223,"SALINA KS",3,3,1,1,1,3,-97.61184692,38.84041977
223,"SALINAS CA",3,6,2,3,1,6,-121.6571732,36.67780304
223,"SALISBURY MD",3,3,2,1,0,3,-75.5984726,38.36100388
223,"SALT LAKE CITY UT",3,5,0,2,3,5,-111.8912659,40.77029037
223,"SALUDA SC",3,1,1,0,0,1,-81.77184296,34.00602722
223,"SAN ANGELO TX",3,1,0,0,1,1,-100.4379044,31.46401215
223,"SAN ANTONIO TX",3,218,57,73,88,218,-98.49394989,29.42439651
223,"SAN BERNARDINO CA",3,8,4,1,3,8,-117.304596,34.12142563
223,"SAN DIEGO CA",3,201,56,66,79,201,-117.1587296,32.71524429
223,"SAN FRANCISCO CA",3,205,53,66,86,205,-122.4213257,37.77465057
223,"SAN JOSE CA",3,31,13,8,10,31,-121.8973846,37.33491516
223,"SAN LEANDRO CA",3,5,3,0,2,5,-122.155983,37.70180511
223,"SAN LUIS OBISPO CA",3,7,1,3,3,7,-120.6622849,35.28281021
223,"SAN MARCOS CA",3,4,1,2,1,4,-117.1673966,33.14345551
223,"SAN MARCOS TX",3,29,9,11,9,29,-97.94176483,29.88363266
223,"SAN MATEO CA",3,1,0,0,1,1,-122.3270264,37.56283569
223,"SAN RAMON CA",3,1,0,0,1,1,-121.9799347,37.77985764
223,"SANDY SPRINGS GA",3,1,0,1,0,1,-84.37850952,33.92443848
223,"SANFORD FL",3,1,0,0,1,1,-81.27256012,28.80128288
223,"SANTA ANA CA",3,4,1,2,1,4,-117.8697281,33.74567413
223,"SANTA BARBARA CA",3,15,5,4,6,15,-119.7056656,34.4233017
223,"SANTA CLARA CA",3,2,0,0,2,2,-121.946434,37.34754181
223,"SANTA CRUZ CA",3,5,0,4,1,5,-122.0333557,36.97389984
223,"SANTA FE NM",3,3,0,2,1,3,-105.9468155,35.68014526
223,"SANTA MARIA CA",3,2,1,1,0,2,-120.437973,34.95292664
223,"SANTA MONICA CA",3,9,3,4,2,9,-118.4925232,34.01921082
223,"SANTA ROSA CA",3,33,4,13,16,33,-122.7165146,38.44017792
223,"SAPULPA OK",3,1,0,0,1,1,-96.11476135,35.99878311
223,"SARATOGA WY",3,1,1,0,0,1,-106.807579,41.45475769
223,"SATELLITE BEACH FL",3,3,1,2,0,3,-80.58939362,28.17677498
223,"SAVANNAH GA",3,30,11,7,12,30,-81.09463501,32.07280731
223,"SAXONBURG PA",3,1,0,0,1,1,-79.80976105,40.75429535
223,"SCHENECTADY NY",3,1,1,0,0,1,-73.938591,42.81433487
223,"SCHUYLKILL HAVEN PA",3,1,0,1,0,1,-76.17021942,40.63098145
223,"SCOTTSDALE AZ",3,24,7,5,12,24,-111.9002533,33.50918579
223,"SCRANTON PA",3,1,0,1,0,1,-75.66184998,41.40919113
223,"SEASIDE CA",3,1,0,0,1,1,-121.8542252,36.6110611
223,"SEATTLE WA",3,309,86,82,141,309,-122.3343964,47.60571289
223,"SEBRING FL",3,1,0,1,0,1,-81.4406662,27.49625397
223,"SEDALIA MO",3,4,2,1,1,4,-93.22884369,38.70438766
223,"SEGUIN TX",3,2,1,0,1,2,-97.96529388,29.56933594
223,"SELMA AL",3,3,2,0,1,3,-87.02119446,32.40768433
223,"SHAKER HEIGHTS OH",3,28,6,8,14,28,-81.53669739,41.47419357
223,"SHAKOPEE MN",3,6,2,2,2,6,-93.52770233,44.79788971
223,"SHAWNEE KS",3,2,2,0,0,2,-94.7208786,39.0417366
223,"SHEBOYGAN WI",3,1,0,0,1,1,-87.71476746,43.75089264
223,"SHELBY NC",3,1,0,1,0,1,-81.53518677,35.29262543
223,"SHELBYVILLE IL",3,1,0,1,0,1,-88.78992462,39.40638733
223,"SHELBYVILLE KY",3,1,0,0,1,1,-85.22341156,38.21203232
223,"SHERMAN TX",3,2,0,2,0,2,-96.60933685,33.63597488
223,"SHERWOOD AR",3,3,2,1,0,3,-92.22438049,34.81515884
223,"SHIPPENSBURG PA",3,1,1,0,0,1,-77.51955414,40.05068207
223,"SHIVELY KY",3,1,1,0,0,1,-85.82255554,38.20013809
223,"SHREVEPORT LA",3,8,1,4,3,8,-93.7507019,32.52565002
223,"SHREWSBURY MO",3,1,0,0,1,1,-90.3371582,38.59024811
223,"SIDNEY OH",3,1,0,1,0,1,-84.15549469,40.28426743
223,"SIERRA MADRE CA",3,1,1,0,0,1,-118.0547943,34.16183853
223,"SIKESTON MO",3,1,1,0,0,1,-89.5878067,36.87693024
223,"SIMI VALLEY CA",3,1,0,0,1,1,-118.7839508,34.26951981
223,"SIOUX CITY IA",3,1,0,0,1,1,-96.40085602,42.5001564
223,"SIOUX FALLS SD",3,16,2,6,8,16,-96.73429108,43.54177475
223,"SLIDELL LA",3,5,4,0,1,5,-89.78143311,30.27558708
223,"SLIPPERY ROCK PA",3,1,0,1,0,1,-80.05516052,41.06407928
223,"SMYRNA GA",3,6,2,2,2,6,-84.51447296,33.88409042
223,"SMYRNA TN",3,2,0,1,1,2,-86.51843262,35.98318863
223,"SOLANA BEACH CA",3,2,2,0,0,2,-117.2725525,32.99123383
223,"SOLEDAD CA",3,2,0,2,0,2,-121.3278732,36.42473984
223,"SOMERVILLE MA",3,13,8,4,1,13,-71.09860992,42.38757324
223,"SONOMA CA",3,2,1,1,0,2,-122.4600754,38.29153061
223,"SONORA CA",3,1,0,0,1,1,-120.3842011,37.98400497
223,"SOUTH BEND IN",3,4,2,1,1,4,-86.25171661,41.67295837
223,"SOUTH CHARLESTON WV",3,2,0,0,2,2,-81.69944763,38.36863708
223,"SOUTH LAKE TAHOE CA",3,6,1,2,3,6,-119.972786,38.94574356
223,"SOUTH LYON MI",3,1,0,0,1,1,-83.65129089,42.46051788
223,"SOUTH PASADENA CA",3,1,1,0,0,1,-118.1516647,34.11618805
223,"SOUTH SAN FRANCISCO CA",3,1,0,0,1,1,-122.4101868,37.65430069
223,"SOUTHAMPTON NY",3,1,0,1,0,1,-72.38861084,40.88444519
223,"SOUTHFIELD MI",3,1,0,1,0,1,-83.22153473,42.47357559
223,"SOUTHPORT NC",3,1,1,0,0,1,-78.01985931,33.9217453
223,"SPARTANBURG SC",3,6,1,3,2,6,-81.93160248,34.94982529
223,"SPEARFISH SD",3,1,0,0,1,1,-103.8635941,44.49181366
223,"SPEEDWAY IN",3,9,3,2,4,9,-86.2671051,39.80224609
223,"SPOKANE WA",3,21,4,8,9,21,-117.4281387,47.65847015
223,"SPRING LAKE NC",3,2,0,0,2,2,-78.97221375,35.16840744
223,"SPRINGFIELD IL",3,30,8,8,14,30,-89.6439743,39.80184174
223,"SPRINGFIELD MA",3,1,0,1,0,1,-72.57289124,42.10980606
223,"SPRINGFIELD MO",3,126,30,34,62,126,-93.29862213,37.21548843
223,"ST LOUIS MO",3,4851,1298,1173,2380,4851,-90.19819641,38.62716675
223,"STAMFORD CT",3,6,0,2,4,6,-73.53807068,41.05353165
223,"STARKVILLE MS",3,4,2,2,0,4,-88.81492615,33.46545029
223,"STATE COLLEGE PA",3,4,1,1,2,4,-77.85973358,40.79336929
223,"STATESBORO GA",3,4,1,2,1,4,-81.78266907,32.44914246
223,"STAUNTON VA",3,2,0,0,2,2,-79.07145691,38.14970016
223,"STEAMBOAT SPRINGS CO",3,1,0,1,0,1,-106.8292313,40.48627853
223,"STEILACOOM WA",3,22,8,3,11,22,-122.6048813,47.16923141
223,"STERLING HEIGHTS MI",3,1,0,1,0,1,-83.03016663,42.58047485
223,"STEVENS POINT WI",3,4,2,2,0,4,-89.57467651,44.52337265
223,"STILLWATER MN",3,1,0,0,1,1,-92.80657959,45.05171967
223,"STILLWATER OK",3,1,1,0,0,1,-97.0588913,36.11580658
223,"STOCKBRIDGE GA",3,4,2,0,2,4,-84.23356628,33.54455185
223,"STOCKTON CA",3,11,5,2,4,11,-121.293457,37.95776749
223,"STONE MOUNTAIN GA",3,27,6,6,15,27,-84.14538574,33.8065033
223,"STROUDSBURG PA",3,1,0,0,1,1,-75.19365692,40.98681259
223,"SUFFERN NY",3,1,1,0,0,1,-74.14870453,41.11490631
223,"SUFFOLK VA",3,2,1,0,1,2,-76.58317566,36.72846985
223,"SUGAR LAND TX",3,4,0,1,3,4,-95.6352005,29.61997795
223,"SULLIVAN MO",3,3,1,1,1,3,-91.16096497,38.20802689
223,"SULPHUR SPRINGS TX",3,1,0,0,1,1,-95.60125732,33.13871002
223,"SUMTER SC",3,2,0,2,0,2,-80.34135437,33.92088318
223,"SUNNYVALE CA",3,1,0,1,0,1,-122.0380707,37.36878967
223,"SUNRISE FL",3,1,1,0,0,1,-80.2282486,26.14059067
223,"SURFSIDE FL",3,3,0,2,1,3,-80.12493134,25.87931252
223,"SUWANEE GA",3,3,1,1,1,3,-84.0713501,34.05178452
223,"SWANSEA IL",3,8,2,3,3,8,-89.98918152,38.53406143
223,"SYLVANIA OH",3,15,4,6,5,15,-83.71266174,41.71902466
223,"SYRACUSE NY",3,17,3,4,10,17,-76.14653015,43.04846191
223,"TACOMA WA",3,21,6,7,8,21,-122.4466705,47.25242233
223,"TAHLEQUAH OK",3,4,1,0,3,4,-94.9703064,35.91559982
223,"TAKOMA PARK MD",3,3,1,1,1,3,-77.00667572,38.97793198
223,"TALLAHASSEE FL",3,72,16,15,41,72,-84.27896881,30.44669914
223,"TALLULAH LA",3,2,1,1,0,2,-91.18704987,32.40855789
223,"TAMARAC FL",3,1,0,0,1,1,-80.22389984,26.19458199
223,"TAMPA FL",3,284,88,90,106,284,-82.4580307,27.94833755
223,"TARPON SPRINGS FL",3,1,0,0,1,1,-82.75656128,28.14682198
223,"TAYLORVILLE IL",3,32,9,8,15,32,-89.29446411,39.5492363
223,"TEANECK NJ",3,3,1,1,1,3,-74.01485443,40.89759064
223,"TECUMSEH MI",3,1,0,1,0,1,-83.94480133,42.00404358
223,"TELL CITY IN",3,1,0,0,1,1,-86.76784515,37.95154953
223,"TEMECULA CA",3,1,0,0,1,1,-117.1428146,33.48790741
223,"TEMPE AZ",3,50,15,9,26,50,-111.9108276,33.41504288
223,"TEMPLE TX",3,1,0,0,1,1,-97.34354401,31.09850502
223,"TERRE HAUTE IN",3,3,2,1,0,3,-87.41414642,39.46681976
223,"TEWKSBURY MA",3,1,0,0,1,1,-71.23313904,42.61103439
223,"TEXARKANA TX",3,4,1,3,0,4,-94.04785156,33.42536545
223,"TEXHOMA OK",3,5,1,0,4,5,-101.7831192,36.50521851
223,"THAYER MO",3,1,0,0,1,1,-91.53848267,36.52465439
223,"THOMASTON GA",3,1,0,0,1,1,-84.32656097,32.888237
223,"THOMASVILLE AL",3,1,0,0,1,1,-87.73569489,31.91395187
223,"THOMASVILLE GA",3,2,0,2,0,2,-83.97835541,30.8371582
223,"THORNTON CO",3,7,1,0,6,7,-104.9727631,39.86811829
223,"THOUSAND OAKS CA",3,1,0,1,0,1,-118.8398514,34.17078018
223,"THREE RIVERS MI",3,3,1,2,0,3,-85.63246918,41.94419861
223,"TIFTON GA",3,1,1,0,0,1,-83.508255,31.4508934
223,"TILLAMOOK OR",3,2,0,1,1,2,-123.8468399,45.45576096
223,"TINLEY PARK IL",3,3,2,1,0,3,-87.78465271,41.57352448
223,"TOLEDO OH",3,46,14,12,20,46,-83.55497742,41.66411591
223,"TOMBALL TX",3,1,0,0,1,1,-95.6162262,30.09776115
223,"TOMBSTONE AZ",3,3,1,1,1,3,-110.0689316,31.71310997
223,"TOPEKA KS",3,12,3,6,3,12,-95.67857361,39.04813766
223,"TORRANCE CA",3,9,2,2,5,9,-118.3428345,33.8359642
223,"TRAVERSE CITY MI",3,1,0,1,0,1,-85.6207962,44.76324844
223,"TRENTON NJ",3,34,6,13,15,34,-74.74206543,40.21709442
223,"TROY AL",3,1,1,0,0,1,-85.97013855,31.80913544
223,"TROY MI",3,3,2,0,1,3,-83.14983368,42.60589218
223,"TROY MO",3,9,2,2,5,9,-90.98098755,38.979702
223,"TROY OH",3,9,4,1,4,9,-84.20330811,40.03966141
223,"TUCKER GA",3,3,0,3,0,3,-84.21690369,33.85486603
223,"TUCSON AZ",3,27,11,9,7,27,-110.9277954,32.22209167
223,"TULSA OK",3,55,14,21,20,55,-95.98488617,36.1603241
223,"TUPELO MS",3,3,2,1,0,3,-88.71934509,34.26508713
223,"TUSCALOOSA AL",3,13,4,2,7,13,-87.56897736,33.21024704
223,"TUSCUMBIA AL",3,1,0,0,1,1,-87.70251465,34.73139191
223,"TYLER TX",3,6,2,0,4,6,-95.3013916,32.35176468
223,"UNION ME",3,1,1,0,0,1,-69.27328491,44.21183395
223,"UNION MO",3,1,0,1,0,1,-91.00618744,38.44558716
223,"UNION NJ",3,1,0,0,1,1,-74.26235199,40.69780731
223,"UNIVERSITY CITY MO",3,63,14,17,32,63,-90.33391571,38.66000748
223,"UNIVERSITY HEIGHTS OH",3,1,0,0,1,1,-81.5369873,41.49779892
223,"UPPER MARLBORO MD",3,2,1,0,1,2,-76.74905396,38.81620026
223,"URBANA IL",3,7,2,4,1,7,-88.20746613,40.11079025
223,"UTICA NY",3,1,0,0,1,1,-75.23220062,43.10119629
223,"VACAVILLE CA",3,13,5,7,1,13,-121.9900284,38.35633469
223,"VALDOSTA GA",3,11,1,4,6,11,-83.27806854,30.83293533
223,"VALIER IL",3,2,1,1,0,2,-89.04284668,38.01522064
223,"VALLEJO CA",3,10,3,3,4,10,-122.2594299,38.1039505
223,"VAN BUREN MO",3,1,0,1,0,1,-91.01494598,36.99590302
223,"VANCOUVER WA",3,3,1,2,0,3,-122.6816559,45.63534164
223,"VESTAL NY",3,2,0,0,2,2,-76.05289459,42.08543015
223,"VICKSBURG MS",3,4,0,1,3,4,-90.87818909,32.35280991
223,"VICTORVILLE CA",3,1,0,0,1,1,-117.2928162,34.53612137
223,"VIDALIA GA",3,1,0,1,0,1,-82.41294098,32.21813965
223,"VIENNA VA",3,1,1,0,0,1,-77.2645874,38.90164566
223,"VIENNA WV",3,1,0,0,1,1,-81.54671478,39.33840179
223,"VILLA RICA GA",3,8,2,2,4,8,-84.91907501,33.73210907
223,"VIRGINIA BEACH VA",3,83,31,14,38,83,-75.97751617,36.8533783
223,"VISALIA CA",3,1,0,1,0,1,-119.2938156,36.33000946
223,"VISTA CA",3,1,0,1,0,1,-117.2447052,33.2000885
223,"WACO TX",3,8,0,3,5,8,-97.14704895,31.54987144
223,"WALKER MI",3,2,1,1,0,2,-85.7684021,43.00150299
223,"WALNUT CREEK CA",3,3,1,0,2,3,-122.0670624,37.90636826
223,"WALTHAM MA",3,2,0,1,1,2,-71.2346344,42.37656403
223,"WARNER ROBINS GA",3,3,1,1,1,3,-83.59963989,32.62118149
223,"WARREN MI",3,154,33,41,80,154,-83.02783203,42.47764969
223,"WARRENSBURG MO",3,2,1,1,0,2,-93.73639679,38.76289749
223,"WARRENTON MO",3,34,12,16,6,34,-91.14160919,38.81156921
223,"WARWICK RI",3,1,0,1,0,1,-71.37738037,41.69232941
223,"WASHINGTON DC",3,1441,376,434,631,1441,-77.01257324,38.88911819
223,"WASHINGTON MO",3,77,22,17,38,77,-91.01213074,38.55807495
223,"WASILLA AK",3,1,0,0,1,1,-149.4517059,61.58290482
223,"WATERBURY CT",3,3,1,2,0,3,-73.05029297,41.55849075
223,"WATERFORD WI",3,1,1,0,0,1,-88.21479797,42.76306152
223,"WATSONVILLE CA",3,2,0,0,2,2,-121.7594147,36.90995407
223,"WAUKEGAN IL",3,4,1,1,2,4,-87.84466553,42.36366653
223,"WAUKESHA WI",3,3,1,0,2,3,-88.23146057,43.01194382
223,"WAUSAU WI",3,1,0,1,0,1,-89.63059998,44.95904922
223,"WAYNESVILLE OH",3,1,0,0,1,1,-84.08625793,39.52976227
223,"WEATHERFORD TX",3,4,0,4,0,4,-97.79758453,32.7595253
223,"WEAVERVILLE NC",3,1,0,1,0,1,-82.56031799,35.6974411
223,"WEBB CITY MO",3,1,1,0,0,1,-94.4631958,37.14646912
223,"WEBSTER GROVES MO",3,4,1,1,2,4,-90.35769653,38.59287262
223,"WENTZVILLE MO",3,17,3,5,9,17,-90.85335541,38.81171036
223,"WESLACO TX",3,2,0,1,1,2,-97.99131775,26.16018867
223,"WEST CHESTER OH",3,1,0,0,1,1,-84.40789032,39.33029938
223,"WEST CHESTER PA",3,5,1,1,3,5,-75.60475159,39.96074677
223,"WEST COVINA CA",3,1,0,1,0,1,-117.9406204,34.0685463
223,"WEST DES MOINES IA",3,4,1,0,3,4,-93.71179962,41.57717514
223,"WEST HARTFORD CT",3,3,2,1,0,3,-72.74108887,41.76238251
223,"WEST HOLLYWOOD CA",3,10,1,2,7,10,-118.3634567,34.08982468
223,"WEST LAFAYETTE IN",3,1,0,0,1,1,-86.9082489,40.42613983
223,"WEST ORANGE NJ",3,4,1,1,2,4,-74.23833466,40.7989006
223,"WEST ORANGE TX",3,1,0,0,1,1,-93.78001404,30.08396149
223,"WEST PALM BEACH FL",3,25,9,10,6,25,-80.05298615,26.71585464
223,"WEST TX",3,3,1,0,2,3,-97.09226227,31.80267906
223,"WESTERVILLE OH",3,3,2,1,0,3,-82.92906952,40.12620926
223,"WESTFIELD NJ",3,1,1,0,0,1,-74.34671783,40.65938187
223,"WESTFIELD WI",3,1,0,0,1,1,-89.49338531,43.88357544
223,"WESTMINSTER CO",3,2,1,1,0,2,-105.0385208,39.83644867
223,"WESTMINSTER MD",3,2,1,1,0,2,-76.99542999,39.57574463
223,"WESTPORT CT",3,2,0,0,2,2,-73.35696411,41.14154053
223,"WHEELING WV",3,5,1,3,1,5,-80.7192688,40.06991577
223,"WHITE CASTLE LA",3,1,0,0,1,1,-91.14699554,30.17041969
223,"WHITE HOUSE TN",3,1,0,1,0,1,-86.65110016,36.47054672
223,"WHITE PLAINS NY",3,1,0,1,0,1,-73.76217651,41.03399658
223,"WHITEHALL PA",3,2,0,1,1,2,-79.99015045,40.36117554
223,"WHITTIER CA",3,6,1,2,3,6,-118.0349197,33.9793129
223,"WICHITA FALLS TX",3,3,2,0,1,3,-98.49403381,33.91383743
223,"WICHITA KS",3,42,9,12,21,42,-97.3383255,37.69230652
223,"WILKINSBURG PA",3,1,1,0,0,1,-79.88179016,40.44174194
223,"WILLIAMSBURG KY",3,1,0,1,0,1,-84.15948486,36.74344254
223,"WILLIAMSBURG VA",3,5,1,1,3,5,-76.70659637,37.27114868
223,"WILLIAMSTOWN MA",3,1,0,0,1,1,-73.21173859,42.70910263
223,"WILMINGTON DE",3,16,3,6,7,16,-75.54558563,39.74601364
223,"WILMINGTON NC",3,5,1,1,3,5,-77.94431305,34.22592926
223,"WINCHESTER KY",3,5,0,1,4,5,-84.17945862,37.99042511
223,"WINCHESTER VA",3,2,1,1,0,2,-78.16301727,39.18608475
223,"WINDER GA",3,1,0,1,0,1,-83.71982574,33.99271393
223,"WINDSOR MO",3,16,2,9,5,16,-93.5224762,38.53234863
223,"WINFIELD MO",3,5,1,0,4,5,-90.73840332,38.99734879
223,"WINONA MS",3,1,0,0,1,1,-89.73496246,33.48717499
223,"WINSTON-SALEM NC",3,37,12,19,6,37,-80.24356842,36.1001091
223,"WINTER PARK FL",3,12,5,4,3,12,-81.33872223,28.6003685
223,"WISCONSIN DELLS WI",3,1,1,0,0,1,-89.77094269,43.62741089
223,"WOODBURY MN",3,1,0,1,0,1,-92.95999908,44.92368698
223,"WOODLAND CA",3,2,1,0,1,2,-121.7751541,38.67827225
223,"WOODRIDGE IL",3,1,0,1,0,1,-88.05056763,41.74704742
223,"WOODSTOCK GA",3,1,0,0,1,1,-84.51925659,34.10178375
223,"WORCESTER MA",3,7,1,4,2,7,-71.801651,42.26288986
223,"WRIGHT CITY MO",3,1,0,0,1,1,-91.02021027,38.82786942
223,"WYOMING MI",3,1,0,0,1,1,-85.70549011,42.9133873
223,"YANKTON SD",3,1,0,1,0,1,-97.39076233,42.8748703
223,"YONKERS NY",3,15,1,7,7,15,-73.89792633,40.93142319
223,"YORK NE",3,1,1,0,0,1,-97.59262848,40.8681221
223,"YORK PA",3,8,4,0,4,8,-76.72687531,39.96264267
223,"YOUNGSTOWN OH",3,2,2,0,0,2,-80.64901733,41.1000061
223,"YPSILANTI MI",3,4,1,0,3,4,-83.61315155,42.24105453
223,"YUMA AZ",3,2,0,0,2,2,-114.6262665,32.72531128
223,"YUMA CO",3,2,1,1,0,2,-102.7258301,40.12628937
223,"ZANESVILLE OH",3,1,0,1,0,1,-82.01314545,39.94056702
224,"ABERDEEN WA",4,4,1,2,1,4,-123.8181381,46.97493744
224,"ABILENE TX",4,2,0,0,2,2,-99.73384094,32.44894028
224,"ABINGDON IL",4,1,0,0,1,1,-90.40194702,40.80449295
224,"ABSECON NJ",4,9,2,2,5,9,-74.49462128,39.42850494
224,"ACTON MA",4,2,1,0,1,2,-71.43197632,42.48540115
224,"ACWORTH GA",4,1,0,0,1,1,-84.67662811,34.06597519
224,"ADAMS MA",4,1,0,0,1,1,-73.1167984,42.62440872
224,"ADDISON TX",4,1,0,0,1,1,-96.82976532,32.96215057
224,"ADRIAN MI",4,1,0,1,0,1,-84.03691101,41.89771652
224,"AKRON NY",4,1,0,0,1,1,-78.49505615,43.02077484
224,"AKRON OH",4,54,13,19,22,54,-81.51885223,41.08151627
224,"AKRON PA",4,2,1,1,0,2,-76.20130157,40.15691757
224,"ALAMEDA CA",4,19,5,6,8,19,-122.2444763,37.76513672
224,"ALBANY CA",4,2,0,1,1,2,-122.3003311,37.88674164
224,"ALBANY GA",4,1,1,0,0,1,-84.15510559,31.58296013
224,"ALBANY NY",4,46,6,16,24,46,-73.75520325,42.6529007
224,"ALBANY OR",4,1,0,0,1,1,-123.1083984,44.63620758
224,"ALBUQUERQUE NM",4,111,31,25,55,111,-106.6517639,35.08336639
224,"ALEXANDRIA LA",4,6,1,4,1,6,-92.44517517,31.31143761
224,"ALEXANDRIA MN",4,1,1,0,0,1,-95.37786865,45.88516617
224,"ALEXANDRIA VA",4,85,22,26,37,85,-77.04605103,38.80503082
224,"ALHAMBRA CA",4,1,0,1,0,1,-118.1287003,34.0954628
224,"ALLENTOWN PA",4,2,0,1,1,2,-75.46569824,40.60851288
224,"ALPHARETTA GA",4,5,2,2,1,5,-84.29410553,34.07542419
224,"ALPINE TX",4,1,0,1,0,1,-103.6622238,30.35860062
224,"ALTAMONTE SPRINGS FL",4,2,2,0,0,2,-81.39485931,28.66284752
224,"ALTON IL",4,18,3,6,9,18,-90.18429565,38.89074326
224,"ALTOONA PA",4,2,0,2,0,2,-78.39411163,40.51860046
224,"AMARILLO TX",4,4,0,2,2,4,-101.8324051,35.22210312
224,"AMBLER PA",4,2,0,1,1,2,-75.2210083,40.15485382
224,"AMES IA",4,6,0,2,4,6,-93.61370087,42.02269363
224,"AMHERST MA",4,7,2,1,4,7,-72.5192337,42.37371826
224,"AMORY MS",4,1,0,0,1,1,-88.48745728,33.98094559
224,"ANAHEIM CA",4,24,5,7,12,24,-117.9165115,33.8354454
224,"ANCHORAGE AK",4,22,5,6,11,22,-149.8811951,61.21649933
224,"ANDERSON IN",4,4,0,2,2,4,-85.68051147,40.1053772
224,"ANDERSON SC",4,2,0,1,1,2,-82.65641785,34.50934219
224,"ANDOVER MA",4,2,0,0,2,2,-71.13011169,42.65668869
224,"ANN ARBOR MI",4,87,14,28,45,87,-83.74536896,42.28347015
224,"ANNAPOLIS MD",4,15,5,5,5,15,-76.49166107,38.97844696
224,"ANTIOCH CA",4,2,2,0,0,2,-121.808136,38.0049057
224,"APPLETON WI",4,6,1,3,2,6,-88.41551208,44.2618866
224,"ARCADIA CA",4,1,0,0,1,1,-118.0368881,34.1397934
224,"ARCATA CA",4,4,1,1,2,4,-124.08564,40.86624527
224,"ARDEN HILLS MN",4,1,1,0,0,1,-93.15720367,45.05033112
224,"ARDMORE OK",4,1,0,0,1,1,-97.14401245,34.17425156
224,"ARKADELPHIA AR",4,1,0,1,0,1,-93.05423737,34.12095642
224,"ARKANSAS CITY KS",4,1,0,1,0,1,-97.03897858,37.06211472
224,"ARLINGTON MA",4,4,1,1,2,4,-71.15559387,42.41545486
224,"ARLINGTON TN",4,1,0,1,0,1,-89.66139984,35.29637527
224,"ARLINGTON TX",4,49,17,11,21,49,-97.10882568,32.73590469
224,"ARNOLD MO",4,2,0,0,2,2,-90.37690735,38.43906784
224,"ARROYO GRANDE CA",4,2,0,2,0,2,-120.5928879,35.11868668
224,"ASBURY PARK NJ",4,2,1,0,1,2,-74.01100159,40.22047806
224,"ASHEVILLE NC",4,59,18,12,29,59,-82.55367279,35.60134888
224,"ASHLAND MO",4,2,0,0,2,2,-92.25737762,38.77433395
224,"ASHLAND OH",4,1,0,0,1,1,-82.31797028,40.86874771
224,"ASHLAND OR",4,23,3,13,7,23,-122.7111359,42.19425583
224,"ASHLAND WI",4,2,0,1,1,2,-90.88419342,46.59241104
224,"ASHTABULA OH",4,2,0,2,0,2,-80.78971863,41.86506653
224,"ASPEN CO",4,2,0,2,0,2,-106.8185959,39.19105911
224,"ATHENS OH",4,11,2,3,6,11,-82.10113525,39.32934952
224,"ATHENS PA",4,2,0,1,1,2,-76.52072906,41.9661293
224,"ATLANTA GA",4,1593,333,520,740,1593,-84.38757324,33.74927521
224,"ATLANTIC BEACH FL",4,2,1,0,1,2,-81.39808655,30.33498573
224,"ATLANTIC CITY NJ",4,2,1,0,1,2,-74.42202759,39.36457062
224,"AUBURN AL",4,7,0,4,3,7,-85.48087311,32.61021423
224,"AUBURN CA",4,10,3,2,5,10,-121.0794067,38.89623642
224,"AUBURN ME",4,1,0,0,1,1,-70.23028564,44.09794235
224,"AUBURN NY",4,1,0,1,0,1,-76.56542969,42.93203735
224,"AUBURN WA",4,3,1,1,1,3,-122.2304688,47.30677795
224,"AUDUBON NJ",4,1,0,1,0,1,-75.07247162,39.89139175
224,"AUGUSTA KS",4,2,1,0,1,2,-96.97721863,37.68652725
224,"AURORA CO",4,19,6,4,9,19,-104.8693161,39.73983765
224,"AURORA IL",4,13,4,4,5,13,-88.32048798,41.76070023
224,"AUSTELL GA",4,1,1,0,0,1,-84.63414001,33.81290054
224,"AUSTIN TX",4,716,155,252,309,716,-97.74386597,30.26748466
224,"AVIS PA",4,9,1,3,5,9,-77.31352997,41.1848526
224,"AVON CO",4,1,0,0,1,1,-106.5237427,39.63142395
224,"AVONDALE AZ",4,1,0,1,0,1,-112.3513947,33.43592072
224,"AZUSA CA",4,1,0,1,0,1,-117.9098816,34.13357544
224,"BAKERSFIELD CA",4,30,6,10,14,30,-119.0206375,35.37326813
224,"BALDWINSVILLE NY",4,1,1,0,0,1,-76.33219147,43.15886307
224,"BALLSTON SPA NY",4,8,5,1,2,8,-73.84790039,43.00103378
224,"BALLWIN MO",4,19,5,4,10,19,-90.54669189,38.5951004
224,"BALTIMORE MD",4,627,140,233,254,627,-76.6115799,39.29075623
224,"BANGOR ME",4,1,1,0,0,1,-68.77653503,44.80109406
224,"BARTLESVILLE OK",4,1,0,1,0,1,-95.98135376,36.74737549
224,"BARTLETT TN",4,4,1,1,2,4,-89.87441254,35.20460892
224,"BARTONVILLE IL",4,9,2,1,6,9,-89.65235138,40.6502037
224,"BATAVIA NY",4,1,0,1,0,1,-78.18697357,42.99835587
224,"BATESVILLE MS",4,3,0,1,2,3,-89.94464874,34.31167603
224,"BATON ROUGE LA",4,106,15,28,63,106,-91.15479279,30.45132256
224,"BATTLE CREEK MI",4,1,1,0,0,1,-85.17985535,42.32100677
224,"BAY VILLAGE OH",4,5,2,2,1,5,-81.92155457,41.48464966
224,"BAYTOWN TX",4,2,0,1,1,2,-94.97782135,29.73608589
224,"BEACON NY",4,1,0,0,1,1,-73.9688797,41.50502014
224,"BEAUMONT TX",4,6,2,0,4,6,-94.10238647,30.08622551
224,"BEAVER DAM KY",4,2,0,2,0,2,-86.87591553,37.40219879
224,"BEAVER FALLS PA",4,2,0,1,1,2,-80.3188858,40.75218582
224,"BEAVERCREEK OH",4,2,0,2,0,2,-84.06332397,39.70913696
224,"BEAVERTON OR",4,12,3,3,6,12,-122.8055344,45.48670197
224,"BEDFORD MA",4,1,0,0,1,1,-71.27526855,42.49069214
224,"BEDFORD NY",4,3,1,1,1,3,-73.64318085,41.204319
224,"BEDFORD TX",4,2,0,2,0,2,-97.14364624,32.8442955
224,"BEECH GROVE IN",4,1,1,0,0,1,-86.08973694,39.72201157
224,"BEEVILLE TX",4,1,0,0,1,1,-97.7488327,28.40157127
224,"BELEN NM",4,1,0,1,0,1,-106.7750244,34.65850067
224,"BELL CA",4,8,1,5,2,8,-118.1889572,33.97753906
224,"BELLEVILLE IL",4,28,6,8,14,28,-89.98438263,38.52002716
224,"BELLEVUE WA",4,11,3,3,5,11,-122.2029648,47.61014557
224,"BELLFLOWER CA",4,1,1,0,0,1,-118.1186295,33.88169479
224,"BELLINGHAM WA",4,13,2,4,7,13,-122.4727402,48.76121521
224,"BELLPORT NY",4,1,0,0,1,1,-72.93808746,40.75737
224,"BELMONT CA",4,1,0,0,1,1,-122.2783508,37.51996613
224,"BELMONT MA",4,1,0,0,1,1,-71.1774292,42.39597321
224,"BELTON MO",4,2,0,1,1,2,-94.53222656,38.81176376
224,"BEMIDJI MN",4,1,0,0,1,1,-94.88105774,47.47352982
224,"BEND OR",4,13,0,8,5,13,-121.3171387,44.0577774
224,"BENTON HARBOR MI",4,4,1,1,2,4,-86.45429993,42.11692429
224,"BENTONVILLE AR",4,6,2,3,1,6,-94.20933533,36.3728447
224,"BERKELEY CA",4,98,21,37,40,98,-122.2752533,37.87145615
224,"BERKELEY MO",4,3,1,2,0,3,-90.33169556,38.75470734
224,"BERWICK PA",4,1,0,1,0,1,-76.23230743,41.05486679
224,"BETHLEHEM PA",4,2,1,0,1,2,-75.36949921,40.62598801
224,"BETTENDORF IA",4,6,1,3,2,6,-90.51612854,41.52465439
224,"BEVERLY HILLS CA",4,43,10,14,19,43,-118.4019775,34.07383347
224,"BILLINGS MT",4,3,0,1,2,3,-108.504631,45.7833786
224,"BILOXI MS",4,3,1,0,2,3,-88.89369202,30.40021133
224,"BINGHAMTON NY",4,25,4,10,11,25,-75.91755676,42.0986557
224,"BIRMINGHAM AL",4,77,18,17,42,77,-86.80226898,33.52098846
224,"BIRMINGHAM MI",4,6,3,1,2,6,-83.21121216,42.54697418
224,"BISBEE AZ",4,4,2,1,1,4,-109.9298477,31.44821548
224,"BIXBY OK",4,1,0,0,1,1,-95.88382721,35.94215775
224,"BLACK JACK MO",4,3,0,0,3,3,-90.26735687,38.79346085
224,"BLACK MOUNTAIN NC",4,5,1,2,2,5,-82.32103729,35.61796188
224,"BLACKSBURG VA",4,19,4,4,11,19,-80.41369629,37.22999573
224,"BLADENSBURG MD",4,6,1,2,3,6,-76.9335556,38.93954849
224,"BLOOMINGTON IL",4,5,0,2,3,5,-88.99375916,40.48418045
224,"BLOOMINGTON IN",4,17,3,8,6,17,-86.53382874,39.16920471
224,"BLUE SPRINGS MO",4,6,1,4,1,6,-94.2820816,39.01689148
224,"BLUFF CITY TN",4,6,1,3,2,6,-82.26051331,36.47451019
224,"BLUFFTON IN",4,1,0,1,0,1,-85.17154694,40.73873138
224,"BLYTHEVILLE AR",4,1,0,0,1,1,-89.91928101,35.92730713
224,"BOARDMAN OH",4,1,0,1,0,1,-80.66256714,41.02441788
224,"BOCA RATON FL",4,7,3,2,2,7,-80.08280182,26.35960197
224,"BOLINGBROOK IL",4,8,0,5,3,8,-88.06878662,41.69866562
224,"BOLIVAR MO",4,1,0,1,0,1,-93.41101074,37.61450195
224,"BONHAM TX",4,3,1,1,1,3,-96.17896271,33.57743454
224,"BOONE NC",4,1,1,0,0,1,-81.67436218,36.21696472
224,"BORDENTOWN NJ",4,2,0,1,1,2,-74.7159729,40.15003586
224,"BOSTON MA",4,568,121,181,266,568,-71.05905151,42.35883713
224,"BOTHELL WA",4,1,0,0,1,1,-122.2075424,47.75966263
224,"BOULDER CO",4,31,5,12,14,31,-105.2715302,40.01483917
224,"BOWIE MD",4,8,3,4,1,8,-76.77848816,39.00718689
224,"BOWLING GREEN KY",4,2,0,2,0,2,-86.4437027,36.99057388
224,"BOWLING GREEN OH",4,9,2,5,2,9,-83.65102386,41.37505341
224,"BOYNTON BEACH FL",4,5,1,1,3,5,-80.066185,26.52592087
224,"BOZEMAN MT",4,14,1,3,10,14,-111.0471649,45.6803093
224,"BRADENTON FL",4,5,2,1,2,5,-82.57459259,27.49969101
224,"BRANDON MS",4,1,0,1,0,1,-89.98616028,32.27327728
224,"BRANSON MO",4,1,0,1,0,1,-93.21912384,36.64381409
224,"BRAZORIA TX",4,1,0,0,1,1,-95.56978607,29.04499435
224,"BREMERTON WA",4,1,0,0,1,1,-122.6345291,47.56690598
224,"BREVARD NC",4,2,0,2,0,2,-82.73400116,35.23363113
224,"BRIDGEPORT CT",4,6,2,1,3,6,-73.2040863,41.16743088
224,"BRIDGETON MO",4,2,0,0,2,2,-90.41161346,38.76696396
224,"BRIDGETON NJ",4,6,1,1,4,6,-75.23321533,39.42769623
224,"BRISBANE CA",4,1,0,0,1,1,-122.402504,37.68077469
224,"BRISTOL CT",4,32,12,9,11,32,-72.94853973,41.67193222
224,"BROADVIEW HEIGHTS OH",4,1,1,0,0,1,-81.68503571,41.31410217
224,"BROCKPORT NY",4,7,2,2,3,7,-77.93889618,43.213871
224,"BROCKTON MA",4,5,0,3,2,5,-71.01748657,42.08340454
224,"BROOKFIELD IL",4,1,0,0,1,1,-87.85184479,41.82412338
224,"BROOKINGS SD",4,1,0,0,1,1,-96.79450989,44.3097229
224,"BROOKLINE MA",4,2,0,2,0,2,-71.12002563,42.33176804
224,"BROOKSIDE VILLAGE TX",4,1,0,0,1,1,-95.32555389,29.58737183
224,"BROOKSVILLE FL",4,3,1,0,2,3,-82.38734436,28.55600739
224,"BROOMFIELD CO",4,2,0,1,1,2,-105.0877686,39.92069244
224,"BROWNFIELD TX",4,2,1,0,1,2,-102.2751923,33.18150711
224,"BROWNSTOWN IN",4,1,0,0,1,1,-86.04185486,38.87921143
224,"BROWNSVILLE PA",4,1,0,1,0,1,-79.88352966,40.02396393
224,"BRUNSWICK GA",4,2,1,1,0,2,-81.49102783,31.1502285
224,"BRYAN TX",4,6,1,3,2,6,-96.3704071,30.67456818
224,"BUDA TX",4,4,1,0,3,4,-97.84067535,30.08543968
224,"BUENA PARK CA",4,1,0,0,1,1,-117.999939,33.86748123
224,"BUFFALO NY",4,160,29,71,60,160,-78.87787628,42.8867836
224,"BUFORD GA",4,1,1,0,0,1,-84.00788879,34.11735535
224,"BURBANK CA",4,18,5,5,8,18,-118.3104782,34.18065262
224,"BURIEN WA",4,2,0,0,2,2,-122.3500137,47.47027206
224,"BURLESON TX",4,1,0,1,0,1,-97.32151794,32.54247665
224,"BURLINGTON NJ",4,1,0,0,1,1,-74.86417389,40.07125092
224,"BURLINGTON VT",4,35,13,9,13,35,-73.20542908,44.47687531
224,"BURLINGTON WA",4,2,0,2,0,2,-122.3279495,48.47541428
224,"BURLINGTON WI",4,1,0,1,0,1,-88.27623749,42.67818832
224,"BURNET TX",4,1,0,0,1,1,-98.22889709,30.75881004
224,"BURNSVILLE MN",4,1,0,0,1,1,-93.27822113,44.76760483
224,"BUTLER PA",4,3,0,2,1,3,-79.89468384,40.86117172
224,"BYESVILLE OH",4,1,0,0,1,1,-81.53645325,39.97002411
224,"BYRON WY",4,1,0,0,1,1,-108.5082169,44.79620361
224,"CABOT AR",4,1,0,1,0,1,-92.01670837,34.9747467
224,"CAIRO GA",4,1,0,0,1,1,-84.20102692,30.87791824
224,"CALABASAS CA",4,1,0,1,0,1,-118.6473236,34.1558876
224,"CALIFORNIA MO",4,1,0,1,0,1,-92.56713104,38.62768555
224,"CALIMESA CA",4,1,0,0,1,1,-117.0634689,34.00385666
224,"CAMARILLO CA",4,41,13,10,18,41,-119.0400391,34.21628952
224,"CAMAS WA",4,1,0,0,1,1,-122.4054489,45.58965683
224,"CAMBRIDGE MA",4,68,20,25,23,68,-71.10369873,42.36532593
224,"CAMBRIDGE OH",4,2,1,0,1,2,-81.58615875,40.02525711
224,"CAMDEN AR",4,2,0,0,2,2,-92.83481598,33.58491898
224,"CAMDEN NJ",4,9,2,3,4,9,-75.118927,39.92608261
224,"CAMPBELL CA",4,3,0,1,2,3,-121.951973,37.287117
224,"CAMPBELL MO",4,1,0,0,1,1,-90.07504272,36.49356079
224,"CANAL WINCHESTER OH",4,1,0,0,1,1,-82.80456543,39.84274673
224,"CANANDAIGUA NY",4,2,1,0,1,2,-77.28107452,42.88830948
224,"CANTON GA",4,2,1,1,0,2,-84.48571014,34.23356628
224,"CANTON MS",4,1,0,0,1,1,-90.03672028,32.61313248
224,"CANTON OH",4,2,2,0,0,2,-81.37824249,40.79906845
224,"CANTON TX",4,1,0,1,0,1,-95.86379242,32.55702591
224,"CAPE CORAL FL",4,1,0,0,1,1,-81.9491806,26.56343079
224,"CAPE GIRARDEAU MO",4,10,2,2,6,10,-89.51838684,37.30613327
224,"CAPITOL HEIGHTS MD",4,11,1,4,6,11,-76.91506195,38.88552475
224,"CARBONDALE IL",4,18,6,7,5,18,-89.2168808,37.7274704
224,"CARLISLE PA",4,1,0,0,1,1,-77.18848419,40.20173264
224,"CARLSBAD CA",4,2,1,1,0,2,-117.3528137,33.1580162
224,"CARO MI",4,2,0,1,1,2,-83.39698792,43.49111176
224,"CARRBORO NC",4,3,0,2,1,3,-79.07286835,35.91213989
224,"CARROLLTON GA",4,5,2,2,1,5,-85.07631683,33.58019638
224,"CARROLLTON KY",4,1,0,0,1,1,-85.17919159,38.68099976
224,"CARSON CA",4,5,2,3,0,5,-118.2837448,33.8312645
224,"CARSON CITY NV",4,3,0,1,2,3,-119.7687988,39.16352844
224,"CARTERSVILLE GA",4,1,1,0,0,1,-84.79982758,34.1654892
224,"CARY IL",4,1,0,0,1,1,-88.23856354,42.21179962
224,"CARY NC",4,9,3,3,3,9,-78.78055573,35.79200745
224,"CASA GRANDE AZ",4,4,0,1,3,4,-111.7590179,32.87965393
224,"CASCADE LOCKS OR",4,2,0,2,0,2,-121.8928452,45.66971588
224,"CASTLE HILLS TX",4,1,0,0,1,1,-98.51991272,29.52467346
224,"CASTLE ROCK CO",4,3,0,1,2,3,-104.857811,39.37207031
224,"CASTROVILLE TX",4,1,0,0,1,1,-98.87910461,29.35617065
224,"CAVE CREEK AZ",4,1,0,0,1,1,-111.9523544,33.83345795
224,"CEDAR RAPIDS IA",4,6,0,2,4,6,-91.66259766,41.98337555
224,"CENTRALIA IL",4,2,2,0,0,2,-89.13375092,38.52496719
224,"CERES CA",4,6,1,2,3,6,-120.9599075,37.59457016
224,"CHADRON NE",4,1,0,0,1,1,-102.9998169,42.83535004
224,"CHAMPAIGN IL",4,34,7,12,15,34,-88.24346161,40.11659622
224,"CHANDLER AZ",4,5,0,1,4,5,-111.8428345,33.3062439
224,"CHAPEL HILL NC",4,19,6,6,7,19,-79.05697632,35.91110611
224,"CHARLESTON SC",4,57,15,14,28,57,-79.93032074,32.77671814
224,"CHARLESTON WV",4,54,15,6,33,54,-81.63149261,38.34872055
224,"CHARLOTTE NC",4,440,106,128,206,440,-80.84257507,35.22746277
224,"CHARLOTTESVILLE VA",4,87,18,34,35,87,-78.49123383,38.03798676
224,"CHATHAM VA",4,1,0,0,1,1,-79.39749146,36.82584
224,"CHATTANOOGA TN",4,26,3,14,9,26,-85.30583954,35.04058456
224,"CHELTENHAM PA",4,1,0,1,0,1,-75.09356689,40.06132126
224,"CHERRY HILL NJ",4,1,1,0,0,1,-75.03024292,39.93510437
224,"CHESAPEAKE VA",4,6,3,2,1,6,-76.27422333,36.81948853
224,"CHESTER PA",4,28,5,8,15,28,-75.35475159,39.84973145
224,"CHESTERFIELD MO",4,16,4,4,8,16,-90.5772934,38.6631279
224,"CHESTERTOWN MD",4,3,1,0,2,3,-76.0662384,39.20907593
224,"CHEVERLY MD",4,3,0,1,2,3,-76.91530609,38.92858505
224,"CHEVY CHASE MD",4,7,2,3,2,7,-77.07595825,38.97138977
224,"CHEYENNE WY",4,6,2,1,3,6,-104.8183899,41.13345718
224,"CHICAGO IL",4,1584,344,526,714,1584,-87.6503067,41.85000992
224,"CHICKAMAUGA GA",4,1,0,0,1,1,-85.29045105,34.87113571
224,"CHICO CA",4,85,21,33,31,85,-121.839447,39.72846222
224,"CHILHOWEE MO",4,1,0,0,1,1,-93.85474396,38.58897018
224,"CHILLICOTHE MO",4,2,0,1,1,2,-93.55298615,39.79542542
224,"CHILLICOTHE OH",4,1,1,0,0,1,-82.98206329,39.33310699
224,"CHINA GROVE NC",4,16,1,6,9,16,-80.58115387,35.56945801
224,"CHINCOTEAGUE VA",4,1,0,0,1,1,-75.37820435,37.93326569
224,"CHINO CA",4,1,0,0,1,1,-117.6906662,34.0121727
224,"CHIPLEY FL",4,1,1,0,0,1,-85.53816223,30.78241539
224,"CHRISTOPHER IL",4,1,0,0,1,1,-89.05361938,37.97265244
224,"CHULA VISTA CA",4,14,3,5,6,14,-117.0857468,32.64037704
224,"CINCINNATI OH",4,128,31,44,53,128,-84.51939392,39.10413742
224,"CITRUS HEIGHTS CA",4,1,0,1,0,1,-121.2829208,38.70672607
224,"CLAIRTON PA",4,1,0,0,1,1,-79.88103485,40.2925148
224,"CLAREMONT CA",4,6,2,1,3,6,-117.7214508,34.09675217
224,"CLARENDON HILLS IL",4,1,0,0,1,1,-87.95468903,41.79769516
224,"CLARKS SUMMIT PA",4,1,0,0,1,1,-75.70759583,41.48881531
224,"CLARKSVILLE TN",4,11,2,6,3,11,-87.35944366,36.52993011
224,"CLAYTON MO",4,6,1,2,3,6,-90.32382965,38.64260101
224,"CLEAR LAKE SHORES TX",4,30,2,12,16,30,-95.03226471,29.54773712
224,"CLEARWATER FL",4,6,2,2,2,6,-82.79984283,27.9665451
224,"CLEBURNE TX",4,1,0,0,1,1,-97.38722992,32.34804535
224,"CLEMSON SC",4,11,1,6,4,11,-82.83683014,34.68382645
224,"CLEVELAND NC",4,1,0,0,1,1,-80.6764679,35.73367691
224,"CLEVELAND OH",4,388,74,127,187,388,-81.69516754,41.49978256
224,"CLIFFSIDE PARK NJ",4,1,0,1,0,1,-73.98683167,40.82172394
224,"CLIFTON NJ",4,1,0,0,1,1,-74.16278076,40.85860062
224,"CLINTON IN",4,3,0,1,2,3,-87.39801025,39.65688324
224,"CLOVIS NM",4,1,0,1,0,1,-103.2067108,34.40181732
224,"COACHELLA CA",4,1,1,0,0,1,-116.1753616,33.68059158
224,"COCOA BEACH FL",4,2,0,1,1,2,-80.6068573,28.3203907
224,"COLLEGE PARK GA",4,33,8,8,17,33,-84.44933319,33.65347672
224,"COLLEGE PARK MD",4,12,2,3,7,12,-76.93619537,38.98080444
224,"COLLEGE STATION TX",4,13,4,4,5,13,-96.33758545,30.62316895
224,"COLLEGEVILLE MN",4,1,0,0,1,1,-94.36388397,45.59444427
224,"COLLEGEVILLE PA",4,3,0,1,2,3,-75.4506073,40.18598557
224,"COLLINSVILLE IL",4,3,2,0,1,3,-89.98478699,38.67050171
224,"COLMA CA",4,4,1,1,2,4,-122.4610977,37.67665482
224,"COLORADO SPRINGS CO",4,28,5,7,16,28,-104.8225174,38.83369446
224,"COLUMBIA MO",4,178,44,52,82,178,-92.33429718,38.95169067
224,"COLUMBIA SC",4,88,13,33,42,88,-81.04045105,34.00138855
224,"COLUMBUS GA",4,15,3,5,7,15,-84.98313141,32.46828842
224,"COLUMBUS IN",4,2,1,1,0,2,-85.92284393,39.20959473
224,"COLUMBUS MS",4,2,0,1,1,2,-88.42742157,33.49581909
224,"COLUMBUS OH",4,335,76,107,152,335,-82.99890137,39.96136475
224,"COMPTON CA",4,23,6,7,10,23,-118.2218704,33.89606857
224,"CONCORD CA",4,3,0,2,1,3,-122.0333328,37.97780228
224,"CONCORD NC",4,5,1,3,1,5,-80.57880402,35.4092598
224,"CONCORD NH",4,2,0,0,2,2,-71.53688812,43.20820999
224,"CONCORDIA KS",4,1,0,0,1,1,-97.66313934,39.57102203
224,"CONNELL WA",4,2,1,1,0,2,-118.863533,46.66334534
224,"CONOVER NC",4,8,2,3,3,8,-81.21835327,35.70663834
224,"CONWAY AR",4,3,1,2,0,3,-92.4426651,35.08877563
224,"CONYERS GA",4,4,1,2,1,4,-84.0175705,33.66764832
224,"COON RAPIDS MN",4,1,0,0,1,1,-93.32348633,45.16527176
224,"COPPELL TX",4,1,1,0,0,1,-97.01548004,32.95487213
224,"COPPERAS COVE TX",4,2,0,0,2,2,-97.90343475,31.12462616
224,"CORAL GABLES FL",4,4,2,0,2,4,-80.26779938,25.72242165
224,"CORBIN KY",4,1,0,0,1,1,-84.09648132,36.94906235
224,"CORNING AR",4,1,0,1,0,1,-90.58023834,36.40788269
224,"CORNING NY",4,1,0,1,0,1,-77.05406189,42.14312744
224,"CORONA CA",4,14,3,5,6,14,-117.5688171,33.87516785
224,"CORONADO CA",4,3,1,0,2,3,-117.1846619,32.6861763
224,"CORPUS CHRISTI TX",4,11,4,3,4,11,-97.42076874,27.77859879
224,"CORTLAND NY",4,2,1,1,0,2,-76.17972565,42.60138702
224,"CORVALLIS OR",4,15,1,5,9,15,-123.2646637,44.56417084
224,"COSTA MESA CA",4,2,1,0,1,2,-117.9204407,33.64131927
224,"COTTONWOOD HEIGHTS UT",4,1,0,1,0,1,-111.8369751,40.63098145
224,"COVINA CA",4,1,0,0,1,1,-117.8919067,34.09014511
224,"COVINGTON GA",4,3,0,2,1,3,-83.86009216,33.59708405
224,"COVINGTON LA",4,1,0,0,1,1,-90.10121918,30.475914
224,"COXSACKIE NY",4,1,1,0,0,1,-73.80188751,42.35128403
224,"CRANE MO",4,2,0,0,2,2,-93.57215881,36.90554047
224,"CRANSTON RI",4,1,0,0,1,1,-71.43634033,41.77997971
224,"CRAWFORDSVILLE IN",4,1,0,1,0,1,-86.89406586,40.04439926
224,"CRESCENT CITY CA",4,1,0,1,0,1,-124.2048645,41.75559235
224,"CREST HILL IL",4,2,1,0,1,2,-88.09871674,41.55462646
224,"CREVE COEUR MO",4,3,0,1,2,3,-90.42288971,38.66108322
224,"CROOKSTON MN",4,3,1,2,0,3,-96.60908508,47.77420044
224,"CROSSVILLE TN",4,7,1,0,6,7,-85.0270462,35.9490509
224,"CROTON-ON-HUDSON NY",4,4,1,1,2,4,-73.89041901,41.2085762
224,"CROWN POINT IN",4,4,0,3,1,4,-87.36541748,41.41695023
224,"CUBA MO",4,11,1,3,7,11,-91.40387726,38.06311035
224,"CUMMING GA",4,1,1,0,0,1,-84.1401825,34.2074852
224,"CUPERTINO CA",4,11,2,4,5,11,-122.0342026,37.32306671
224,"CUYAHOGA FALLS OH",4,12,4,5,3,12,-81.48397064,41.1338768
224,"DACULA GA",4,1,0,1,0,1,-83.89762878,33.9887352
224,"DALLAS GA",4,1,1,0,0,1,-84.84075165,33.92391586
224,"DALLAS TX",4,793,157,244,392,793,-96.80088043,32.78369904
224,"DALTON GA",4,1,0,0,1,1,-84.97008514,34.76976776
224,"DALY CITY CA",4,24,3,9,12,24,-122.4645081,37.70376968
224,"DANVILLE IL",4,9,2,3,4,9,-87.62978363,40.12442398
224,"DANVILLE IN",4,1,0,0,1,1,-86.52632904,39.76076126
224,"DANVILLE PA",4,2,0,2,0,2,-76.61188507,40.96371078
224,"DANVILLE VA",4,2,0,0,2,2,-79.39437866,36.58641434
224,"DARLINGTON SC",4,2,0,0,2,2,-79.86645508,34.30082321
224,"DAVENPORT FL",4,1,0,1,0,1,-81.60109711,28.1620388
224,"DAVENPORT IA",4,3,1,0,2,3,-90.57814026,41.52380753
224,"DAVIE FL",4,6,4,0,2,6,-80.23148346,26.0657177
224,"DAVIS CA",4,6,2,1,3,6,-121.7421722,38.54467773
224,"DAYTON OH",4,90,19,24,47,90,-84.19126892,39.75915146
224,"DAYTONA BEACH FL",4,10,2,4,4,10,-81.02253723,29.21147537
224,"DEARBORN HEIGHTS MI",4,1,0,1,0,1,-83.27328491,42.33712769
224,"DEARBORN MI",4,5,0,2,3,5,-83.1758728,42.32239914
224,"DECATUR GA",4,30,10,7,13,30,-84.29631805,33.77489471
224,"DECATUR IL",4,34,6,9,19,34,-88.95516968,39.84060287
224,"DECATUR IN",4,1,0,0,1,1,-84.93001556,40.82580566
224,"DECORAH IA",4,1,0,0,1,1,-91.78575134,43.30333328
224,"DEDHAM MA",4,7,2,2,3,7,-71.16512299,42.24193954
224,"DEER CREEK OK",4,1,0,1,0,1,-97.51993561,36.80317307
224,"DEER PARK TX",4,1,0,0,1,1,-95.1242981,29.70559502
224,"DEL CITY OK",4,4,2,0,2,4,-97.44128418,35.44212723
224,"DELAWARE OH",4,1,0,0,1,1,-83.06757355,40.29886627
224,"DELRAY BEACH FL",4,3,2,0,1,3,-80.07209778,26.46233368
224,"DENTON NC",4,1,0,1,0,1,-80.1153183,35.63389587
224,"DENTON TX",4,56,9,20,27,56,-97.13349915,33.21514893
224,"DENVER CO",4,292,65,96,131,292,-104.9853745,39.73901749
224,"DEPEW NY",4,1,0,1,0,1,-78.69154358,42.90420532
224,"DES MOINES IA",4,16,6,4,6,16,-93.6210022,41.59817123
224,"DES PERES MO",4,1,1,0,0,1,-90.43345642,38.60096741
224,"DESERT HOT SPRINGS CA",4,1,0,0,1,1,-116.5035934,33.96113586
224,"DESTIN FL",4,1,0,1,0,1,-86.49551392,30.39405632
224,"DETROIT MI",4,434,98,139,197,434,-83.04567719,42.33172226
224,"DEXTER MO",4,1,1,0,0,1,-89.95834351,36.79595947
224,"DICKINSON ND",4,4,1,0,3,4,-102.7891007,46.87979889
224,"DICKINSON TX",4,2,0,2,0,2,-95.05158234,29.46142769
224,"DISTRICT HEIGHTS MD",4,3,0,1,2,3,-76.88869476,38.85776138
224,"DONIPHAN MO",4,1,0,0,1,1,-90.82394409,36.62110138
224,"DONNA TX",4,1,0,0,1,1,-98.05448914,26.17434883
224,"DOTHAN AL",4,2,0,1,1,2,-85.39019775,31.22351265
224,"DOUGLASVILLE GA",4,1,0,0,1,1,-84.74777222,33.75165939
224,"DOVER DE",4,4,0,0,4,4,-75.52090454,39.15853882
224,"DOVER NH",4,4,1,1,2,4,-70.88840485,43.2059021
224,"DUARTE CA",4,1,0,0,1,1,-117.9786072,34.13949966
224,"DUBLIN CA",4,17,2,6,9,17,-121.9383392,37.70181274
224,"DUBUQUE IA",4,6,0,4,2,6,-90.67155457,42.51130295
224,"DULUTH MN",4,6,1,4,1,6,-92.10697174,46.78300858
224,"DUMAS AR",4,1,0,0,1,1,-91.48313904,33.88414001
224,"DUNCANVILLE TX",4,3,1,1,1,3,-96.9091568,32.65229034
224,"DUNEDIN FL",4,2,0,1,1,2,-82.77127838,28.02050591
224,"DUNN NC",4,1,0,1,0,1,-78.60855103,35.30678558
224,"DURANGO CO",4,1,0,1,0,1,-107.8810043,37.27463913
224,"DURHAM NC",4,178,37,64,77,178,-78.89787292,35.99412918
224,"EAGAN MN",4,2,2,0,0,2,-93.16746521,44.80387878
224,"EAGLE CO",4,1,1,0,0,1,-106.8298264,39.655159
224,"EAGLE PASS TX",4,1,0,1,0,1,-100.5002899,28.70978737
224,"EAGLE RIVER WI",4,1,0,1,0,1,-89.24466705,45.91718674
224,"EAGLEVILLE MO",4,1,0,0,1,1,-93.9878006,40.46938705
224,"EAST GRAND FORKS MN",4,1,0,0,1,1,-97.02550507,47.93012619
224,"EAST HARTFORD CT",4,1,0,1,0,1,-72.64693451,41.77160263
224,"EAST HELENA MT",4,14,3,4,7,14,-111.9177475,46.58939743
224,"EAST LANSING MI",4,36,11,8,17,36,-84.48403931,42.73703384
224,"EAST ORANGE NJ",4,31,8,8,15,31,-74.21418762,40.76618958
224,"EAST TROY WI",4,3,1,0,2,3,-88.40551758,42.78525925
224,"EAU CLAIRE WI",4,3,0,1,2,3,-91.49876404,44.81137466
224,"EDEN ID",4,1,0,0,1,1,-114.2123184,42.60542297
224,"EDEN PRAIRIE MN",4,11,4,5,2,11,-93.48716736,44.85310745
224,"EDGEWATER FL",4,2,0,0,2,2,-80.90637207,28.99158287
224,"EDINA MN",4,1,0,0,1,1,-93.34928131,44.91236496
224,"EDINBORO PA",4,2,0,0,2,2,-80.13100433,41.87437439
224,"EDINBURG TX",4,31,4,15,12,31,-98.16417694,26.30259705
224,"EDMOND OK",4,3,0,1,2,3,-97.48453522,35.65326309
224,"EDWARDSVILLE IL",4,42,12,12,18,42,-89.95322418,38.8115654
224,"EFFINGHAM IL",4,2,0,0,2,2,-88.54359436,39.12008667
224,"EL CAJON CA",4,2,0,2,0,2,-116.9467392,32.83002472
224,"EL CERRITO CA",4,8,1,2,5,8,-122.3142548,37.91544342
224,"EL LAGO TX",4,6,3,2,1,6,-95.04547119,29.56394196
224,"EL MONTE CA",4,5,2,1,2,5,-118.0298996,34.06880569
224,"EL PASO TX",4,39,7,11,21,39,-106.4620514,31.78388405
224,"EL RENO OK",4,1,1,0,0,1,-97.95549011,35.53218842
224,"EL SEGUNDO CA",4,3,0,2,1,3,-118.4185257,33.91943741
224,"ELDRIDGE IA",4,1,0,1,0,1,-90.5848465,41.65792465
224,"ELGIN IL",4,1,0,0,1,1,-88.28123474,42.03733444
224,"ELIZABETH NJ",4,1,0,0,1,1,-74.21881866,40.66823578
224,"ELIZABETHTON TN",4,26,10,8,8,26,-82.21013641,36.34902954
224,"ELIZABETHTOWN KY",4,8,3,0,5,8,-85.85932159,37.69418716
224,"ELIZABETHTOWN NC",4,1,0,1,0,1,-78.60453796,34.629673
224,"ELIZABETHTOWN PA",4,5,0,1,4,5,-76.60209656,40.15314865
224,"ELK GROVE CA",4,8,2,2,4,8,-121.3743591,38.40848923
224,"ELK POINT SD",4,1,0,1,0,1,-96.68419647,42.68325424
224,"ELKHART IN",4,3,0,2,1,3,-85.97689056,41.68212128
224,"ELKO NV",4,5,1,1,3,5,-115.7643967,40.83226395
224,"ELMIRA NY",4,13,5,2,6,13,-76.80737305,42.08998108
224,"ELMWOOD PARK IL",4,1,0,0,1,1,-87.80945587,41.92121506
224,"ELSBERRY MO",4,1,0,0,1,1,-90.78118896,39.16703796
224,"ELYRIA OH",4,4,1,1,2,4,-82.10734558,41.36825562
224,"EMERYVILLE CA",4,1,1,0,0,1,-122.2871475,37.83127975
224,"EMMAUS PA",4,1,0,1,0,1,-75.49610138,40.53958893
224,"EMPORIA KS",4,1,1,0,0,1,-96.18218994,38.40393448
224,"ENCINITAS CA",4,5,1,2,2,5,-117.2937012,33.0371666
224,"ENDICOTT NY",4,1,0,0,1,1,-76.04867554,42.09862137
224,"ENGLEWOOD CO",4,6,3,1,2,6,-104.9884491,39.6479187
224,"ENGLEWOOD NJ",4,4,2,0,2,4,-73.97172546,40.8928833
224,"ENGLEWOOD OH",4,1,0,1,0,1,-84.30197144,39.87775803
224,"ERIE PA",4,5,3,1,1,5,-80.08492279,42.12926483
224,"ERLANGER KY",4,2,1,0,1,2,-84.60089111,39.01673508
224,"ESCONDIDO CA",4,1,0,1,0,1,-117.0886231,33.11952591
224,"ESSEX JUNCTION VT",4,5,1,1,3,5,-73.11017609,44.49057007
224,"EUGENE OR",4,39,8,17,14,39,-123.0898361,44.05194855
224,"EULESS TX",4,4,0,2,2,4,-97.08273315,32.83728409
224,"EUREKA CA",4,2,2,0,0,2,-124.1653366,40.80156708
224,"EUTAW AL",4,2,0,2,0,2,-87.88775635,32.84085083
224,"EVANSTON IL",4,26,5,9,12,26,-87.69037628,42.04132843
224,"EVANSTON WY",4,2,1,1,0,2,-110.9652634,41.26803589
224,"EVANSVILLE IN",4,14,3,5,6,14,-87.56850433,37.97795486
224,"EVERETT MA",4,10,2,3,5,10,-71.05252075,42.40878296
224,"EVERETT WA",4,11,3,2,6,11,-122.2045441,47.97843552
224,"EXETER NH",4,3,0,2,1,3,-70.95800781,42.98471451
224,"FAIR HAVEN NJ",4,8,1,2,5,8,-74.03659821,40.35977936
224,"FAIRBANKS AK",4,3,0,0,3,3,-147.7185669,64.83367157
224,"FAIRFAX CA",4,2,1,1,0,2,-122.5909805,37.98677063
224,"FAIRFAX VA",4,9,3,2,4,9,-77.30588531,38.84661865
224,"FAIRFIELD CA",4,1,0,1,0,1,-122.0420914,38.24917603
224,"FAIRFIELD CT",4,1,0,0,1,1,-73.26300049,41.14122772
224,"FAIRMONT CITY IL",4,1,0,0,1,1,-90.09365845,38.65008545
224,"FALLON NV",4,1,0,1,0,1,-118.7788696,39.47320557
224,"FALLS CHURCH VA",4,6,2,1,3,6,-77.17056274,38.88268661
224,"FARGO ND",4,20,5,5,10,20,-96.79805756,46.87498474
224,"FARMINGTON HILLS MI",4,2,0,1,1,2,-83.3771286,42.48558807
224,"FARMINGTON MI",4,2,0,1,1,2,-83.37620544,42.46465302
224,"FARMINGTON MO",4,2,0,0,2,2,-90.4220047,37.78110504
224,"FARMINGTON NM",4,1,0,0,1,1,-108.2051544,36.73355865
224,"FARMVILLE NC",4,1,0,0,1,1,-77.41796112,35.59592056
224,"FAYETTE MO",4,1,0,1,0,1,-92.68386078,39.14609146
224,"FAYETTEVILLE AR",4,10,1,1,8,10,-94.15759277,36.06256104
224,"FAYETTEVILLE NC",4,20,4,5,11,20,-78.87771606,35.05313873
224,"FAYETTEVILLE NY",4,1,0,0,1,1,-76.0059433,43.02997971
224,"FEDERAL WAY WA",4,3,2,0,1,3,-122.314415,47.32177734
224,"FENTON MO",4,4,2,0,2,4,-90.43593597,38.51305771
224,"FERGUSON MO",4,59,14,14,31,59,-90.306633,38.74429321
224,"FERNDALE MI",4,6,3,2,1,6,-83.13441467,42.46089172
224,"FILLMORE CA",4,1,0,0,1,1,-118.919754,34.39930344
224,"FISHERS IN",4,1,0,1,0,1,-86.0140152,39.95565414
224,"FITCHBURG MA",4,1,0,0,1,1,-71.79621124,42.58549881
224,"FLAGLER BEACH FL",4,1,0,1,0,1,-81.12680054,29.47527695
224,"FLAGSTAFF AZ",4,11,3,4,4,11,-111.6533051,35.19802475
224,"FLINT MI",4,45,10,12,23,45,-83.68744659,43.01246643
224,"FLORENCE AL",4,23,4,6,13,23,-87.67726898,34.7997818
224,"FLORENCE SC",4,8,4,1,3,8,-79.76351166,34.19935226
224,"FLORIDA CITY FL",4,1,0,0,1,1,-80.47893524,25.44846153
224,"FLORISSANT MO",4,59,16,16,27,59,-90.32299042,38.78946304
224,"FLOSSMOOR IL",4,2,0,1,1,2,-87.68474579,41.54309845
224,"FOND DU LAC WI",4,3,1,2,0,3,-88.44734955,43.77285004
224,"FONTANA CA",4,1,0,1,0,1,-117.4363785,34.09202576
224,"FOREST HILLS PA",4,1,1,0,0,1,-79.84965515,40.42011642
224,"FORT ATKINSON WI",4,1,0,0,1,1,-88.83695984,42.92907715
224,"FORT COLLINS CO",4,27,2,13,12,27,-105.0858688,40.58546066
224,"FORT LAUDERDALE FL",4,141,25,36,80,141,-80.14283752,26.12309074
224,"FORT LUPTON CO",4,1,0,1,0,1,-104.8086929,40.07614517
224,"FORT MILL SC",4,2,1,0,1,2,-80.94496155,35.00762558
224,"FORT MYERS FL",4,9,3,1,5,9,-81.87184143,26.64133644
224,"FORT SMITH AR",4,4,2,1,1,4,-94.39919281,35.3862114
224,"FORT VALLEY GA",4,4,0,3,1,4,-83.88742828,32.5541687
224,"FORT WAYNE IN",4,42,11,15,16,42,-85.13967896,41.07278061
224,"FORT WORTH TX",4,84,16,25,43,84,-97.32135773,32.72562027
224,"FRAMINGHAM MA",4,2,0,1,1,2,-71.41543579,42.27958298
224,"FRANKFORT KY",4,4,0,0,4,4,-84.87322235,38.20124054
224,"FRANKLIN LA",4,2,0,0,2,2,-91.50192261,29.79652786
224,"FRANKLIN TN",4,1,0,0,1,1,-86.87760162,35.92164993
224,"FREDERICK MD",4,16,3,7,6,16,-77.40981293,39.41444397
224,"FREDERICKSBURG VA",4,4,0,2,2,4,-77.45996094,38.30348969
224,"FREDERICKTOWN MO",4,1,0,1,0,1,-90.29403687,37.5598793
224,"FREEBURG IL",4,1,0,0,1,1,-89.91384888,38.42782593
224,"FREEPORT IL",4,3,0,0,3,3,-89.62126923,42.29691696
224,"FREEPORT NY",4,2,1,1,0,2,-73.58229065,40.65803146
224,"FREMONT CA",4,22,4,5,13,22,-121.9740372,37.55101776
224,"FREMONT OH",4,1,0,0,1,1,-83.12195587,41.35057831
224,"FRESNO CA",4,31,9,4,18,31,-119.7739868,36.74755478
224,"FRIDLEY MN",4,7,3,2,2,7,-93.2636261,45.08617401
224,"FRISCO CO",4,3,0,2,1,3,-106.0990143,39.57444763
224,"FRISCO TX",4,7,3,2,2,7,-96.82434082,33.15098572
224,"FULLERTON CA",4,9,2,4,3,9,-117.9268646,33.87014771
224,"FULTON MO",4,1,0,0,1,1,-91.94814301,38.84679031
224,"GADSDEN AL",4,2,0,1,1,2,-86.00675201,34.01457596
224,"GAFFNEY SC",4,1,1,0,0,1,-81.64937592,35.07206345
224,"GAINESVILLE FL",4,34,7,12,15,34,-82.32462311,29.65203285
224,"GAINESVILLE GA",4,73,21,28,24,73,-83.82389832,34.29787827
224,"GAITHERSBURG MD",4,9,2,3,4,9,-77.20072174,39.14352417
224,"GALESBURG IL",4,23,5,5,13,23,-90.37152863,40.9480629
224,"GALLATIN TN",4,2,0,0,2,2,-86.44691467,36.38848495
224,"GALVESTON TX",4,5,1,0,4,5,-94.79576111,29.30070114
224,"GARDEN CITY ID",4,1,0,1,0,1,-116.2400971,43.62173462
224,"GARDEN CITY MI",4,1,0,0,1,1,-83.33091736,42.32582092
224,"GARDEN CITY MO",4,2,1,0,1,2,-94.19150543,38.56124496
224,"GARDEN GROVE CA",4,12,3,2,7,12,-117.943718,33.77397156
224,"GARDENA CA",4,5,1,2,2,5,-118.3105164,33.88837814
224,"GARDINER ME",4,1,0,0,1,1,-69.77404785,44.23034286
224,"GARDNER KS",4,5,0,1,4,5,-94.92789459,38.81066132
224,"GARLAND TX",4,4,0,1,3,4,-96.63926697,32.91297531
224,"GARNER NC",4,5,1,3,1,5,-78.61359406,35.71166992
224,"GARY IN",4,7,0,2,5,7,-87.33873749,41.59325409
224,"GASTONIA NC",4,2,1,0,1,2,-81.18706512,35.26216507
224,"GENOA CITY WI",4,1,0,0,1,1,-88.32978821,42.49824905
224,"GEORGETOWN KY",4,1,0,1,0,1,-84.55860138,38.21012115
224,"GEORGETOWN TX",4,2,1,1,0,2,-97.67801666,30.6329689
224,"GIG HARBOR WA",4,1,0,1,0,1,-122.590683,47.32983398
224,"GILBERT AZ",4,20,8,7,5,20,-111.7899933,33.35302353
224,"GILROY CA",4,2,2,0,0,2,-121.570343,37.00583267
224,"GLADSTONE MO",4,13,1,5,7,13,-94.55509186,39.20398331
224,"GLASGOW KY",4,19,2,6,11,19,-85.91189575,36.99584961
224,"GLASSBORO NJ",4,1,0,0,1,1,-75.11103058,39.70306778
224,"GLEN ELLYN IL",4,2,1,0,1,2,-88.06699371,41.87755585
224,"GLENDALE AZ",4,3,0,2,1,3,-112.1871796,33.5386467
224,"GLENDALE CA",4,22,8,5,9,22,-118.2566681,34.1423645
224,"GLENDIVE MT",4,1,0,1,0,1,-104.7115021,47.11004257
224,"GLENDORA CA",4,2,1,0,1,2,-117.8665314,34.13615417
224,"GLENS FALLS NY",4,3,2,1,0,3,-73.64286041,43.30945969
224,"GODFREY IL",4,3,0,1,2,3,-90.18669891,38.95780182
224,"GOESSEL KS",4,1,0,1,0,1,-97.34946442,38.246315
224,"GOLDEN CO",4,2,0,1,1,2,-105.2226791,39.75567627
224,"GOLDEN VALLEY MN",4,2,0,1,1,2,-93.33234406,44.98583603
224,"GOLDSBORO NC",4,2,0,1,1,2,-77.99216461,35.38506317
224,"GOODRICH TX",4,3,2,1,0,3,-94.9467926,30.60574341
224,"GRAMBLING LA",4,4,0,1,3,4,-92.71523285,32.52869415
224,"GRAND BLANC MI",4,3,0,1,2,3,-83.62955475,42.92750168
224,"GRAND FORKS ND",4,7,2,2,3,7,-97.03855133,47.92044067
224,"GRAND JUNCTION CO",4,2,0,1,1,2,-108.5520706,39.06374741
224,"GRAND LEDGE MI",4,1,0,1,0,1,-84.74642944,42.7535553
224,"GRAND PRAIRIE TX",4,2,1,0,1,2,-96.99823761,32.74625015
224,"GRAND RAPIDS MI",4,49,8,18,23,49,-85.66797638,42.96317291
224,"GRANDVIEW MO",4,1,1,0,0,1,-94.53369904,38.88563538
224,"GRANDVILLE MI",4,1,0,1,0,1,-85.76309204,42.90962982
224,"GRANITE CITY IL",4,14,6,4,4,14,-90.14891815,38.70147705
224,"GRANITE FALLS NC",4,1,0,0,1,1,-81.43023682,35.79683304
224,"GRANTS PASS OR",4,2,0,1,1,2,-123.3306351,42.43851471
224,"GRANVILLE OH",4,2,0,2,0,2,-82.51766205,40.06572723
224,"GREAT BARRINGTON MA",4,30,4,2,24,30,-73.36142731,42.19623566
224,"GREAT BEND KS",4,1,0,1,0,1,-98.76521301,38.36428452
224,"GREAT FALLS MT",4,1,0,0,1,1,-111.2823257,47.50692368
224,"GREELEY CO",4,1,0,0,1,1,-104.7104645,40.42345047
224,"GREEN BAY WI",4,30,2,12,16,30,-88.01370239,44.51335907
224,"GREENBELT MD",4,15,6,3,6,15,-76.87561035,39.00544357
224,"GREENEVILLE TN",4,1,0,1,0,1,-82.83133698,36.16376495
224,"GREENFIELD IN",4,1,1,0,0,1,-85.76914978,39.78491974
224,"GREENSBORO NC",4,102,27,36,39,102,-79.79152679,36.0729599
224,"GREENSBURG PA",4,2,0,1,1,2,-79.53821564,40.30168915
224,"GREENVILLE IL",4,2,0,0,2,2,-89.41333008,38.89213562
224,"GREENVILLE NC",4,5,0,2,3,5,-77.37215424,35.61170959
224,"GREENVILLE SC",4,71,13,22,36,71,-82.39870453,34.84753418
224,"GREENWICH CT",4,6,1,3,2,6,-73.62783051,41.02645111
224,"GREENWOOD IN",4,3,0,1,2,3,-86.10647583,39.61371994
224,"GRESHAM OR",4,2,2,0,0,2,-122.4333954,45.4980278
224,"GRETNA LA",4,1,0,1,0,1,-90.05435181,29.91518021
224,"GRETNA NE",4,1,0,0,1,1,-96.24054718,41.14088058
224,"GRIFFITH IN",4,2,0,0,2,2,-87.42803955,41.52181625
224,"GRINNELL IA",4,1,0,0,1,1,-92.72964478,41.7466507
224,"GROTON CT",4,3,0,1,2,3,-72.07763672,41.3502121
224,"GROVE CITY OH",4,1,1,0,0,1,-83.09304047,39.88161087
224,"GROVETOWN GA",4,1,0,1,0,1,-82.19797516,33.45065308
224,"GUADALUPE CA",4,1,1,0,0,1,-120.5658035,34.94911575
224,"GULFPORT MS",4,4,1,1,2,4,-89.09369659,30.37276649
224,"GUSTINE CA",4,3,1,1,1,3,-121.001297,37.25769043
224,"HACKENSACK NJ",4,1,0,0,1,1,-74.04291534,40.88635254
224,"HADDONFIELD NJ",4,25,6,10,9,25,-75.03710937,39.89155197
224,"HAINES CITY FL",4,1,0,1,0,1,-81.61740875,28.1145668
224,"HALF MOON BAY CA",4,9,2,3,4,9,-122.4299774,37.46336365
224,"HALLSTEAD PA",4,1,0,0,1,1,-75.74239349,41.96153259
224,"HAMILTON NJ",4,4,1,1,2,4,-74.0803299,40.20712662
224,"HAMILTON OH",4,2,0,1,1,2,-84.56098175,39.39949799
224,"HAMMOND IN",4,7,4,1,2,7,-87.50006104,41.58346558
224,"HAMMOND LA",4,3,1,0,2,3,-90.46140289,30.50458908
224,"HAMPTON GA",4,1,0,0,1,1,-84.28277588,33.3870697
224,"HAMPTON VA",4,26,4,7,15,26,-76.34473419,37.03002548
224,"HAMTRAMCK MI",4,5,0,3,2,5,-83.04947662,42.39274597
224,"HANOVER NH",4,3,2,1,0,3,-72.28845215,43.70233917
224,"HARBOR SPRINGS MI",4,1,0,0,1,1,-84.99181366,45.43172455
224,"HARKER HEIGHTS TX",4,17,4,4,9,17,-97.66394806,31.08788109
224,"HARLINGEN TX",4,8,2,2,4,8,-97.69669342,26.19152069
224,"HARRINGTON PARK NJ",4,1,0,0,1,1,-73.97896576,40.98410034
224,"HARRISBURG PA",4,27,10,12,5,27,-76.88382721,40.27407455
224,"HARRISONBURG VA",4,10,3,4,3,10,-78.86815643,38.44975281
224,"HARRISONVILLE MO",4,3,0,2,1,3,-94.34924316,38.65325928
224,"HARTFORD CT",4,112,25,32,55,112,-72.68445587,41.76383591
224,"HARTFORD KY",4,1,0,0,1,1,-86.90929413,37.45124435
224,"HARTSVILLE SC",4,2,0,0,2,2,-80.07303619,34.37445068
224,"HARVEY IL",4,2,0,0,2,2,-87.64677429,41.61020279
224,"HATTIESBURG MS",4,14,1,5,8,14,-89.29040527,31.32738686
224,"HAVANA FL",4,1,0,0,1,1,-84.41448975,30.62413788
224,"HAVERFORD PA",4,1,1,0,0,1,-75.29338837,40.01327896
224,"HAVRE DE GRACE MD",4,1,0,0,1,1,-76.09111023,39.54937363
224,"HAW RIVER NC",4,1,0,1,0,1,-79.36388397,36.09186172
224,"HAWTHORNE CA",4,2,0,1,1,2,-118.3549194,33.91656113
224,"HAYDEN ID",4,2,1,1,0,2,-116.7890625,47.76594925
224,"HAYMARKET VA",4,1,0,0,1,1,-77.63591766,38.81214142
224,"HAYS KS",4,1,1,0,0,1,-99.32746887,38.87940598
224,"HAYWARD CA",4,9,2,4,3,9,-122.0832672,37.66890335
224,"HAYWARD WI",4,2,0,2,0,2,-91.48522949,46.01277161
224,"HAZELWOOD MO",4,4,0,0,4,4,-90.37133789,38.77171707
224,"HAZLETON PA",4,1,1,0,0,1,-75.97418213,40.95857239
224,"HEALDSBURG CA",4,5,1,0,4,5,-122.8713226,38.6101799
224,"HEATH SPRINGS SC",4,1,1,0,0,1,-80.67503357,34.5934639
224,"HEBRON IN",4,5,1,1,3,5,-87.20029449,41.31857681
224,"HELENA MT",4,19,8,3,8,19,-112.0374527,46.59269333
224,"HELOTES TX",4,4,2,1,1,4,-98.69043732,29.57864761
224,"HEMPSTEAD NY",4,7,0,6,1,7,-73.61798096,40.70619965
224,"HENDERSON KY",4,1,0,0,1,1,-87.58986664,37.8363266
224,"HENDERSON NV",4,11,2,6,3,11,-114.9741058,36.03540421
224,"HENDERSONVILLE NC",4,1,0,0,1,1,-82.46079254,35.31912994
224,"HENRIETTA NY",4,2,0,2,0,2,-77.61167145,43.05939865
224,"HERMANN MO",4,4,3,0,1,4,-91.43791199,38.70432281
224,"HERMOSA BEACH CA",4,1,0,1,0,1,-118.401619,33.86245728
224,"HERNANDO MS",4,1,0,1,0,1,-89.99411774,34.82405853
224,"HIALEAH FL",4,3,0,3,0,3,-80.27757263,25.85853386
224,"HICKORY NC",4,4,2,2,0,4,-81.34054565,35.72800827
224,"HIGH POINT NC",4,3,1,1,1,3,-80.00497437,35.95609665
224,"HIGHLAND CA",4,1,0,0,1,1,-117.2105789,34.12824631
224,"HIGHLAND IL",4,3,0,2,1,3,-89.6713562,38.73976135
224,"HIGHLAND IN",4,1,0,0,1,1,-87.45178223,41.55387115
224,"HIGHLAND PARK IL",4,2,0,0,2,2,-87.80068207,42.18181992
224,"HILLSBORO MO",4,1,0,0,1,1,-90.56336975,38.23225021
224,"HILLSBORO OR",4,20,2,5,13,20,-122.9927826,45.52270508
224,"HILLSBOROUGH NC",4,6,2,2,2,6,-79.09932709,36.07565308
224,"HINESVILLE GA",4,1,1,0,0,1,-81.59757996,31.85308266
224,"HOBART IN",4,6,3,1,2,6,-87.24478912,41.53391266
224,"HOBOKEN NJ",4,11,0,6,5,11,-74.0316925,40.7443428
224,"HOFFMAN ESTATES IL",4,1,1,0,0,1,-88.07968903,42.04299927
224,"HOGANSVILLE GA",4,2,0,2,0,2,-84.91479492,33.17349243
224,"HOLLAND MI",4,2,0,1,1,2,-86.10916138,42.78744507
224,"HOLLISTER CA",4,3,1,1,1,3,-121.4038849,36.85258865
224,"HOLLY SPRINGS NC",4,1,1,0,0,1,-78.83320618,35.65140915
224,"HOLLYWOOD FL",4,24,5,7,12,24,-80.14926147,26.01175499
224,"HOLYOKE MA",4,2,0,0,2,2,-72.61522675,42.20437241
224,"HOMER MI",4,3,1,1,1,3,-84.80869293,42.14587021
224,"HOMESTEAD FL",4,5,0,3,2,5,-80.47710419,25.46927071
224,"HOMETOWN IL",4,1,0,0,1,1,-87.73152924,41.73308182
224,"HOPKINSVILLE KY",4,1,1,0,0,1,-87.48854828,36.86588287
224,"HORSHAM PA",4,1,0,0,1,1,-75.12754822,40.17853165
224,"HOT SPRINGS AR",4,10,1,5,4,10,-93.05556488,34.5039978
224,"HOUMA LA",4,1,0,0,1,1,-90.71982574,29.59630585
224,"HOUSTON MO",4,1,1,0,0,1,-91.95644379,37.3261528
224,"HOUSTON TX",4,1059,202,316,541,1059,-95.36399841,29.76376343
224,"HUDSON NC",4,1,1,0,0,1,-81.49536133,35.84866714
224,"HUMBLE TX",4,7,1,4,2,7,-95.26166534,29.99774551
224,"HUNTERSVILLE NC",4,2,0,2,0,2,-80.83785248,35.41359711
224,"HUNTINGTON BEACH CA",4,19,6,9,4,19,-118.0006027,33.66012955
224,"HUNTINGTON PARK CA",4,1,0,0,1,1,-118.2265549,33.98159409
224,"HUNTINGTON WV",4,13,2,4,7,13,-82.44620514,38.4181366
224,"HUNTSVILLE AL",4,95,30,21,44,95,-86.58609772,34.73073959
224,"HUNTSVILLE UT",4,1,0,1,0,1,-111.7737732,41.26464844
224,"HUTCHINSON KS",4,2,2,0,0,2,-97.93050385,38.06093216
224,"HUTTO TX",4,3,0,1,2,3,-97.54733276,30.54326057
224,"HYATTSVILLE MD",4,6,2,1,3,6,-76.94467163,38.95636749
224,"IDA LA",4,1,1,0,0,1,-93.89510345,33.00457001
224,"IMPERIAL CA",4,1,0,1,0,1,-115.5716705,32.84782791
224,"INDEPENDENCE KY",4,4,0,1,3,4,-84.54380035,38.94332886
224,"INDEPENDENCE MO",4,25,8,9,8,25,-94.41611481,39.09104538
224,"INDIAN TRAIL NC",4,3,0,0,3,3,-80.66901398,35.07696915
224,"INDIANA PA",4,1,1,0,0,1,-79.15187073,40.6216507
224,"INDIANAPOLIS IN",4,207,33,73,101,207,-86.15828705,39.76844788
224,"INDIO CA",4,4,0,0,4,4,-116.2173004,33.72047043
224,"INGLEWOOD CA",4,32,7,7,18,32,-118.354805,33.96157074
224,"INMAN SC",4,1,1,0,0,1,-82.09005737,35.04743958
224,"IOWA CITY IA",4,48,13,13,22,48,-91.53023529,41.66130066
224,"IRMO SC",4,1,1,0,0,1,-81.18247223,34.08623123
224,"IRVINE CA",4,18,5,3,10,18,-117.8243942,33.66952515
224,"IRVING TX",4,19,3,9,7,19,-96.94924927,32.81419754
224,"ISSAQUAH WA",4,1,0,1,0,1,-122.0345993,47.52977753
224,"ITHACA NY",4,4,2,1,1,4,-76.49575043,42.44075775
224,"JACKSON MI",4,2,0,1,1,2,-84.40149689,42.24575043
224,"JACKSON MS",4,55,14,12,29,55,-90.19654846,32.298172
224,"JACKSON OH",4,1,0,1,0,1,-82.63652039,39.05205917
224,"JACKSON TN",4,20,5,2,13,20,-88.81397247,35.61472321
224,"JACKSON WY",4,1,0,1,0,1,-110.7644806,43.4798851
224,"JACKSONVILLE AR",4,2,0,0,2,2,-92.11023712,34.86617279
224,"JACKSONVILLE BEACH FL",4,15,3,9,3,15,-81.39300537,30.29505539
224,"JACKSONVILLE FL",4,83,16,33,34,83,-81.65545654,30.33253288
224,"JACKSONVILLE NC",4,1,0,0,1,1,-77.42939758,34.75283813
224,"JANESVILLE WI",4,7,4,1,2,7,-89.01893616,42.68303299
224,"JASPER AL",4,1,0,0,1,1,-87.27728271,33.83164597
224,"JEFFERSON CITY MO",4,27,10,6,11,27,-92.17385864,38.57698441
224,"JENNINGS MO",4,1,1,0,0,1,-90.26077271,38.71944046
224,"JERSEY CITY NJ",4,70,17,32,21,70,-74.07667542,40.72816849
224,"JOHNSON CITY TN",4,7,2,3,2,7,-82.35308075,36.31352615
224,"JOLIET IL",4,29,7,12,10,29,-88.08213043,41.52493668
224,"JONESBORO AR",4,8,2,3,3,8,-90.70430756,35.84226608
224,"JONESBORO GA",4,4,2,0,2,4,-84.35381317,33.52181625
224,"JOPLIN MO",4,5,3,2,0,5,-94.5140686,37.08442688
224,"KALAMAZOO MI",4,30,8,7,15,30,-85.58725739,42.29179764
224,"KANKAKEE IL",4,2,0,2,0,2,-87.86149597,41.12018204
224,"KANSAS CITY KS",4,10,0,5,5,10,-94.62808228,39.1141777
224,"KANSAS CITY MO",4,482,107,156,219,482,-94.57884979,39.09976578
224,"KATY TX",4,1,0,0,1,1,-95.82484436,29.78606224
224,"KEANSBURG NJ",4,1,0,0,1,1,-74.12910461,40.44215393
224,"KENMORE WA",4,5,2,2,1,5,-122.2464905,47.7568779
224,"KENNER LA",4,7,4,1,2,7,-90.24167633,29.99442101
224,"KENNESAW GA",4,10,2,2,6,10,-84.61528015,34.02365875
224,"KENT OH",4,6,0,4,2,6,-81.35736084,41.15368271
224,"KENT WA",4,20,5,9,6,20,-122.2377701,47.38068008
224,"KENTWOOD MI",4,2,0,0,2,2,-85.64472198,42.86936569
224,"KERMAN CA",4,6,0,3,3,6,-120.0621414,36.723423
224,"KETTERING OH",4,1,0,0,1,1,-84.1687088,39.68964005
224,"KEY WEST FL",4,18,8,4,6,18,-81.78218079,24.556427
224,"KILL DEVIL HILLS NC",4,1,1,0,0,1,-75.6541214,36.01398468
224,"KILLEEN TX",4,5,0,2,3,5,-97.72832489,31.11753464
224,"KIMBERLY ID",4,2,0,0,2,2,-114.3663406,42.53341293
224,"KINGMAN AZ",4,1,1,0,0,1,-114.0542908,35.18925858
224,"KINGSPORT TN",4,1,0,0,1,1,-82.56182861,36.54841232
224,"KINLOCH MO",4,1,1,0,0,1,-90.32682037,38.74011612
224,"KIRKLAND WA",4,4,1,0,3,4,-122.2108688,47.6813736
224,"KIRKSVILLE MO",4,1,0,1,0,1,-92.58364105,40.19476318
224,"KIRKWOOD MO",4,32,5,6,21,32,-90.40686798,38.5832901
224,"KISSIMMEE FL",4,20,5,8,7,20,-81.40729523,28.29271317
224,"KLAMATH FALLS OR",4,1,0,0,1,1,-121.7844772,42.2244873
224,"KNOXVILLE TN",4,52,12,10,30,52,-83.92067719,35.96077728
224,"KOKOMO IN",4,1,0,0,1,1,-86.12706757,40.48566818
224,"KOUNTZE TX",4,3,0,0,3,3,-94.31259918,30.3719101
224,"LA CROSSE WI",4,9,1,3,5,9,-91.23967743,43.80151367
224,"LA GRANDE OR",4,1,1,0,0,1,-118.090126,45.32435989
224,"LA MESA CA",4,3,1,1,1,3,-117.0447464,32.76841354
224,"LA VERNE CA",4,9,3,1,5,9,-117.7696304,34.1006546
224,"LACONIA NH",4,2,1,0,0,1,-71.46888733,43.52740097
224,"LAFAYETTE CA",4,3,2,0,1,3,-122.1200104,37.88574982
224,"LAFAYETTE CO",4,2,1,0,1,2,-105.0904388,39.99370956
224,"LAFAYETTE IN",4,2,1,1,0,2,-86.88406372,40.42077255
224,"LAFAYETTE LA",4,31,6,9,16,31,-92.01987457,30.22468185
224,"LAFAYETTE TN",4,2,1,1,0,2,-86.02629089,36.52130127
224,"LAGUNA BEACH CA",4,5,0,3,2,5,-117.7847061,33.54205322
224,"LAKE JACKSON TX",4,1,1,0,0,1,-95.43475342,29.03430176
224,"LAKE OSWEGO OR",4,2,0,0,2,2,-122.6727066,45.42033005
224,"LAKE WORTH FL",4,2,0,0,2,2,-80.05649567,26.61662102
224,"LAKELAND FL",4,5,2,2,1,5,-81.95620728,28.04432487
224,"LAKEMOOR IL",4,1,0,1,0,1,-88.19921875,42.32862854
224,"LAKEWOOD CO",4,4,1,3,0,4,-105.0827332,39.70486069
224,"LAKEWOOD NJ",4,1,0,1,0,1,-74.21684265,40.09822845
224,"LAKEWOOD NY",4,1,1,0,0,1,-79.33265686,42.10427094
224,"LAKEWOOD OH",4,10,3,2,5,10,-81.79773712,41.48223114
224,"LAKEWOOD WA",4,2,0,0,1,1,-122.3653679,47.661533355
224,"LAMBERTVILLE NJ",4,6,1,2,3,6,-74.94231415,40.36618423
224,"LANCASTER CA",4,1,0,0,1,1,-118.1386871,34.69804001
224,"LANCASTER OH",4,2,0,0,2,2,-82.59890747,39.71387482
224,"LANCASTER PA",4,18,4,7,7,18,-76.30498505,40.03824234
224,"LANCASTER SC",4,1,0,1,0,1,-80.76622772,34.71495819
224,"LANDOVER HILLS MD",4,10,1,2,7,10,-76.89152527,38.94342804
224,"LANGLEY WA",4,3,1,0,2,3,-122.4162674,48.03789139
224,"LANSDALE PA",4,2,0,0,2,2,-75.28330994,40.24167633
224,"LANSDOWNE PA",4,9,1,1,7,9,-75.27108765,39.93852234
224,"LANSING IL",4,2,1,0,1,2,-87.5393219,41.56502151
224,"LANSING MI",4,27,6,10,11,27,-84.55532074,42.73265839
224,"LAREDO TX",4,2,0,2,0,2,-99.50824738,27.50720978
224,"LARGO FL",4,13,2,7,4,13,-82.78675079,27.91026115
224,"LAS CRUCES NM",4,3,0,3,0,3,-106.7798538,32.31209564
224,"LAS VEGAS NV",4,204,33,76,95,204,-115.1382141,36.17488098
224,"LAWRENCE KS",4,93,24,27,42,93,-95.23565674,38.97153091
224,"LAWRENCE MA",4,1,1,0,0,1,-71.15792084,42.70630646
224,"LAWRENCEBURG TN",4,2,1,0,1,2,-87.33492279,35.24256897
224,"LAWRENCEVILLE GA",4,8,2,3,3,8,-83.98753357,33.95662308
224,"LAWTON OK",4,4,2,1,1,4,-98.39124298,34.60861969
224,"LAYTON UT",4,1,1,0,0,1,-111.9724808,41.06021118
224,"LEAGUE CITY TX",4,7,2,2,3,7,-95.09550476,29.50793457
224,"LEANDER TX",4,2,0,0,2,2,-97.85368347,30.57936287
224,"LEAVENWORTH KS",4,2,0,0,2,2,-94.92282867,39.31124115
224,"LEBANON PA",4,1,0,0,1,1,-76.41091156,40.34118652
224,"LEBANON TN",4,1,0,0,1,1,-86.29133606,36.20846939
224,"LEESBURG FL",4,5,0,2,3,5,-81.87727356,28.81123161
224,"LEHI UT",4,1,0,1,0,1,-111.8519974,40.39155197
224,"LENEXA KS",4,5,0,4,1,5,-94.73374176,38.95368576
224,"LENOIR NC",4,16,3,3,10,16,-81.53869629,35.91436386
224,"LEWES DE",4,8,0,3,5,8,-75.1359024,38.77365494
224,"LEWISBURG PA",4,1,0,0,1,1,-76.88389587,40.96484756
224,"LEWISVILLE TX",4,3,1,1,1,3,-96.99449921,33.04630661
224,"LEXINGTON MA",4,1,0,0,1,1,-71.22381592,42.44742584
224,"LEXINGTON NC",4,1,1,0,0,1,-80.25289154,35.8242569
224,"LEXINGTON SC",4,1,1,0,0,1,-81.23597717,33.98204041
224,"LEXINGTON VA",4,4,0,2,2,4,-79.4422226,37.78420639
224,"LIBERTY MO",4,4,0,2,2,4,-94.4196167,39.24604034
224,"LICKING MO",4,2,0,2,0,2,-91.85713959,37.49972916
224,"LIMA OH",4,1,0,1,0,1,-84.10490417,40.74259186
224,"LINCOLN NE",4,25,5,9,11,25,-96.6674118,40.80001068
224,"LINDALE TX",4,1,0,1,0,1,-95.40984344,32.51585007
224,"LINDEN NJ",4,1,1,0,0,1,-74.24382782,40.62202454
224,"LINDEN TN",4,1,0,1,0,1,-87.83943939,35.61751175
224,"LITITZ PA",4,1,0,1,0,1,-76.30600739,40.15749741
224,"LITTLE ROCK AR",4,35,5,11,19,35,-92.28178406,34.7369194
224,"LITTLESTOWN PA",4,1,0,0,1,1,-77.08756256,39.74491119
224,"LITTLETON CO",4,3,0,1,2,3,-105.0176163,39.6132431
224,"LIVERMORE CA",4,2,1,0,1,2,-121.7701416,37.68147659
224,"LIVONIA MI",4,1,0,0,1,1,-83.35256958,42.36862564
224,"LOGANSPORT IN",4,1,0,0,1,1,-86.36410522,40.75329208
224,"LOGANVILLE GA",4,3,1,1,1,3,-83.90035248,33.83914948
224,"LOMBARD IL",4,1,0,1,0,1,-88.00775909,41.8800621
224,"LOMIRA WI",4,5,0,2,3,5,-88.44380188,43.59117126
224,"LONE JACK MO",4,1,1,0,0,1,-94.17330933,38.87243652
224,"LONG BEACH CA",4,60,11,28,21,60,-118.1908112,33.7670517
224,"LONG BEACH WA",4,1,0,1,0,1,-124.0569916,46.35176086
224,"LONG BRANCH NJ",4,4,0,2,2,4,-73.991745,40.30428314
224,"LONGMONT CO",4,1,0,0,1,1,-105.1026764,40.16700745
224,"LONGVIEW TX",4,3,0,2,1,3,-94.73707581,32.4966507
224,"LONOKE AR",4,2,1,0,1,2,-91.90023804,34.78399277
224,"LORAIN OH",4,5,1,1,3,5,-82.17118073,41.45874023
224,"LOS ALTOS CA",4,1,0,1,0,1,-122.1163025,37.38525772
224,"LOS ANGELES CA",4,1636,335,555,746,1636,-118.2459106,34.05225754
224,"LOS GATOS CA",4,1,0,0,1,1,-121.9771652,37.22674561
224,"LOUISA KY",4,1,0,0,1,1,-82.60322571,38.11429596
224,"LOUISA VA",4,1,0,1,0,1,-78.00349426,38.0253067
224,"LOUISVILLE CO",4,5,0,1,4,5,-105.1326523,39.97768402
224,"LOVELAND OH",4,5,0,3,2,5,-84.25993347,39.26356506
224,"LOWELL IN",4,2,0,1,1,2,-87.42073059,41.29130173
224,"LOWELL MA",4,3,2,1,0,3,-71.31530762,42.63344574
224,"LUBBOCK TX",4,9,1,5,3,9,-101.8544312,33.59677505
224,"LUFKIN TX",4,1,0,0,1,1,-94.72932434,31.33858681
224,"LUVERNE MN",4,1,0,0,1,1,-96.21320343,43.65433121
224,"LYNCHBURG VA",4,1,1,0,0,1,-79.14174652,37.41383362
224,"LYNDEN WA",4,10,2,2,6,10,-122.455101,48.94639969
224,"LYNDHURST NJ",4,1,0,0,1,1,-74.12353516,40.81222153
224,"LYNNWOOD WA",4,7,0,3,4,7,-122.3175736,47.82042313
224,"LYNWOOD CA",4,4,2,0,2,4,-118.2135544,33.93053055
224,"MACCLESFIELD NC",4,2,0,0,2,2,-77.66950226,35.75227356
224,"MACOMB IL",4,1,1,0,0,1,-90.67189026,40.45938873
224,"MADISON CT",4,6,0,1,5,6,-72.59211731,41.28052902
224,"MADISON IL",4,3,0,0,3,3,-90.15700531,38.68284988
224,"MADISON MS",4,2,2,0,0,2,-90.11543274,32.46231079
224,"MADISON SD",4,1,0,0,1,1,-97.11444855,44.00682449
224,"MADISON WI",4,116,33,35,48,116,-89.40128326,43.07303619
224,"MALVERN PA",4,2,0,1,1,2,-75.51319885,40.03642654
224,"MANASQUAN NJ",4,1,0,1,0,1,-74.04832458,40.12630463
224,"MANASSAS VA",4,2,0,1,1,2,-77.47459412,38.75112534
224,"MANCHESTER CT",4,1,0,0,1,1,-72.52075958,41.77622986
224,"MANCHESTER KY",4,1,0,1,0,1,-83.76169586,37.15374756
224,"MANCHESTER MO",4,2,1,0,1,2,-90.50953674,38.597229
224,"MANCHESTER NH",4,17,4,8,5,17,-71.45406342,42.99581528
224,"MANDEVILLE LA",4,1,0,0,1,1,-90.06562805,30.35881805
224,"MANHATTAN BEACH CA",4,2,0,1,1,2,-118.4129181,33.88484192
224,"MANHATTAN KS",4,5,2,1,2,5,-96.57228851,39.18354034
224,"MANKATO MN",4,7,0,1,6,7,-94.02125549,44.15895462
224,"MANNING SC",4,16,2,6,8,16,-80.21025085,33.69546509
224,"MANSFIELD TX",4,1,1,0,0,1,-97.14230347,32.56362152
224,"MANTECA CA",4,1,0,0,1,1,-121.2179031,37.79747391
224,"MANVEL TX",4,2,1,0,1,2,-95.35823822,29.46306229
224,"MAPLE GROVE MN",4,1,1,0,0,1,-93.47679138,45.14711761
224,"MAPLEWOOD MO",4,8,1,4,3,8,-90.32471466,38.6126976
224,"MAPLEWOOD NJ",4,10,3,2,5,10,-74.27243805,40.77401733
224,"MARANA AZ",4,10,3,2,5,10,-111.2269363,32.43688965
224,"MARCELINE MO",4,2,1,0,1,2,-92.94842529,39.71203232
224,"MARICOPA AZ",4,4,1,1,2,4,-112.0491562,33.05832672
224,"MARIETTA GA",4,26,4,5,17,26,-84.54958344,33.9527359
224,"MARINETTE WI",4,1,0,0,1,1,-87.63109589,45.10002518
224,"MARION AL",4,1,0,0,1,1,-87.31942749,32.63277054
224,"MARION IA",4,2,0,1,1,2,-91.60752869,42.032547
224,"MARION IL",4,1,0,1,0,1,-88.93344116,37.73056412
224,"MARION OH",4,5,2,0,3,5,-83.12861633,40.58881378
224,"MARSHALL MN",4,1,0,1,0,1,-95.78921509,44.4466362
224,"MARSHALLTOWN IA",4,13,1,5,7,13,-92.90861511,42.04956055
224,"MARTIN TN",4,2,2,0,0,2,-88.85335541,36.34902573
224,"MARYLAND HEIGHTS MO",4,6,4,1,1,6,-90.43025208,38.71334076
224,"MARYSVILLE CA",4,1,0,1,0,1,-121.5933762,39.14567947
224,"MARYSVILLE OH",4,1,1,0,0,1,-83.36706543,40.2364006
224,"MARYVILLE TN",4,3,0,2,1,3,-83.96243286,35.76000977
224,"MASCOUTAH IL",4,2,0,1,1,2,-89.79308319,38.49026489
224,"MATAWAN NJ",4,1,0,1,0,1,-74.22887421,40.41519547
224,"MATTESON IL",4,1,1,0,0,1,-87.71334839,41.50400162
224,"MAYETTA KS",4,1,1,0,0,1,-95.72317505,39.33889008
224,"MAYFIELD KY",4,7,0,4,3,7,-88.63654327,36.74169922
224,"MAYWOOD IL",4,1,0,1,0,1,-87.84314728,41.87941742
224,"MCALLEN TX",4,2,0,1,1,2,-98.23077393,26.20433426
224,"MCCOMB MS",4,1,0,0,1,1,-90.45623016,31.2437973
224,"MCDONOUGH GA",4,1,0,0,1,1,-84.1467514,33.44765472
224,"MCGREGOR TX",4,3,1,0,2,3,-97.41001129,31.44441986
224,"MCHENRY IL",4,3,1,1,1,3,-88.2740097,42.34480286
224,"MCKINNEY TX",4,3,0,0,3,3,-96.6155777,33.19782257
224,"MCMINNVILLE OR",4,2,1,0,1,2,-123.2019272,45.20968628
224,"MEBANE NC",4,1,0,0,1,1,-79.26649475,36.09629059
224,"MECHANICSBURG IL",4,1,0,1,0,1,-89.39729309,39.80957794
224,"MECHANICSBURG PA",4,2,1,0,1,2,-77.00779724,40.21432114
224,"MEDFORD MA",4,3,1,2,0,3,-71.10526276,42.41849518
224,"MEDFORD OR",4,2,0,0,2,2,-122.8773193,42.32625961
224,"MEDINA OH",4,2,1,0,1,2,-81.86336517,41.13858795
224,"MELBOURNE FL",4,3,1,1,1,3,-80.60625458,28.07838249
224,"MELISSA TX",4,2,0,1,1,2,-96.57331848,33.28625488
224,"MELROSE MA",4,1,0,0,1,1,-71.07271576,42.45837784
224,"MELVINDALE MI",4,1,0,0,1,1,-83.17527771,42.2828331
224,"MEMPHIS TN",4,232,52,80,100,232,-90.01696014,35.1194191
224,"MENA AR",4,1,1,0,0,1,-94.24035645,34.58638
224,"MENDOTA HEIGHTS MN",4,1,0,0,1,1,-93.12650299,44.88226318
224,"MENLO PARK CA",4,13,4,6,3,13,-122.1842423,37.45361328
224,"MENOMONEE FALLS WI",4,1,0,1,0,1,-88.11719513,43.17907715
224,"MENTOR OH",4,4,1,1,2,4,-81.33918762,41.66637421
224,"MERCED CA",4,11,3,3,5,11,-120.4848785,37.30197525
224,"MERIDIAN ID",4,2,1,0,1,2,-116.3941193,43.611866
224,"MERIDIAN MS",4,1,0,1,0,1,-88.70374298,32.36473846
224,"MERRILLVILLE IN",4,1,0,1,0,1,-87.33312988,41.48298645
224,"MESA AZ",4,21,4,10,7,21,-111.8239059,33.42222214
224,"MESQUITE TX",4,12,5,2,5,12,-96.59959412,32.76692581
224,"MEXICO MO",4,1,1,0,0,1,-91.8833313,39.16965866
224,"MIAMI BEACH FL",4,25,8,5,12,25,-80.12982178,25.79146576
224,"MIAMI FL",4,402,73,119,210,402,-80.19329071,25.77483749
224,"MIAMISBURG OH",4,3,0,1,2,3,-84.28652191,39.643116
224,"MIDDLEBURY IN",4,5,4,1,0,5,-85.71139526,41.67531967
224,"MIDDLEBURY VT",4,14,5,2,7,14,-73.16629028,44.01540756
224,"MIDDLETOWN CT",4,2,0,1,1,2,-72.64955902,41.56232071
224,"MIDDLETOWN DE",4,2,1,0,1,2,-75.71700287,39.44935226
224,"MIDLAND MI",4,6,3,2,1,6,-84.24700928,43.61585236
224,"MIDLAND TX",4,4,0,1,3,4,-102.0793686,31.99754143
224,"MIDWEST CITY OK",4,1,0,1,0,1,-97.39709473,35.44970703
224,"MILAN MI",4,1,0,0,1,1,-83.68206024,42.08535004
224,"MILFORD DE",4,1,0,0,1,1,-75.42737579,38.9128685
224,"MILFORD MA",4,1,0,0,1,1,-71.51522064,42.14015198
224,"MILFORD NY",4,2,1,1,0,2,-74.94455719,42.59064865
224,"MILLBURY MA",4,1,0,1,0,1,-71.76168823,42.1903038
224,"MILLEDGEVILLE GA",4,1,0,1,0,1,-83.23179626,33.08055878
224,"MILLVILLE NJ",4,2,2,0,0,2,-75.03882599,39.40239716
224,"MILPITAS CA",4,1,1,0,0,1,-121.9090805,37.42808533
224,"MILTON WA",4,1,0,1,0,1,-122.3157044,47.2477684
224,"MILWAUKEE WI",4,139,36,40,63,139,-87.90684509,43.03887939
224,"MILWAUKIE OR",4,1,0,1,0,1,-122.6417084,45.44596481
224,"MINDEN LA",4,5,3,0,2,5,-93.28716278,32.61589432
224,"MINNEAPOLIS MN",4,310,71,111,128,310,-93.26397705,44.97980118
224,"MINOT ND",4,1,0,1,0,1,-101.2953949,48.23139572
224,"MIRAMAR FL",4,2,0,1,1,2,-80.23181915,25.98794746
224,"MISSION KS",4,10,1,5,4,10,-94.65638733,39.02796173
224,"MISSION SD",4,1,1,0,0,1,-100.6579437,43.30659866
224,"MISSION TX",4,3,0,1,2,3,-98.32580566,26.21655273
224,"MISSION VIEJO CA",4,2,0,1,1,2,-117.6737366,33.59992218
224,"MISSOULA MT",4,7,2,2,3,7,-113.9832687,46.87278366
224,"MISSOURI CITY TX",4,6,1,1,4,6,-95.5381012,29.61878204
224,"MOAB UT",4,6,0,4,2,6,-109.5508347,38.57315063
224,"MOBERLY MO",4,1,0,0,1,1,-92.43862152,39.41818619
224,"MOBILE AL",4,21,5,4,12,21,-88.04309845,30.69476128
224,"MODESTO CA",4,1,0,0,1,1,-120.9991455,37.63897324
224,"MOLINE IL",4,3,2,1,0,3,-90.51522064,41.5069809
224,"MONMOUTH IL",4,1,0,0,1,1,-90.64776611,40.91139221
224,"MONMOUTH OR",4,1,0,1,0,1,-123.2363892,44.84816742
224,"MONROE LA",4,5,0,0,5,5,-92.11960602,32.50980759
224,"MONROE MI",4,4,1,0,3,4,-83.39758301,41.91663742
224,"MONROE NY",4,2,0,0,2,2,-74.18616486,41.33085632
224,"MONROVIA CA",4,1,1,0,0,1,-118.0006485,34.14796829
224,"MONTCLAIR NJ",4,6,1,2,3,6,-74.20848083,40.82605362
224,"MONTEREY CA",4,7,1,3,3,7,-121.8974838,36.6002388
224,"MONTEVALLO AL",4,1,0,0,1,1,-86.86419678,33.10087967
224,"MONTGOMERY AL",4,44,14,14,16,44,-86.29966736,32.36724472
224,"MONTPELIER VT",4,1,0,0,1,1,-72.57458496,44.26039124
224,"MOORE OK",4,5,2,1,2,5,-97.48735046,35.33969498
224,"MOORPARK CA",4,4,1,1,2,4,-118.8839111,34.28554535
224,"MORAGA CA",4,1,0,1,0,1,-122.1321945,37.83471298
224,"MOREHEAD KY",4,1,0,0,1,1,-83.43223572,38.18409348
224,"MORGAN HILL CA",4,1,0,0,1,1,-121.6563797,37.1303978
224,"MORGANTON NC",4,3,1,0,2,3,-81.68434906,35.74584961
224,"MORGANTOWN WV",4,8,2,2,4,8,-79.95038605,39.63131714
224,"MORRIS IL",4,1,0,0,1,1,-88.42147064,41.3571167
224,"MORRIS MN",4,3,0,0,3,3,-95.91436005,45.58617401
224,"MORRO BAY CA",4,1,1,0,0,1,-120.8519135,35.36568451
224,"MORROW GA",4,5,1,1,3,5,-84.33943939,33.58339691
224,"MORTON MS",4,1,1,0,0,1,-89.65461731,32.35386658
224,"MOSCOW ID",4,6,1,1,4,6,-117.0021973,46.73223877
224,"MOSCOW MILLS MO",4,1,0,1,0,1,-90.91833496,38.94809341
224,"MOUNDSVILLE WV",4,2,1,1,0,2,-80.74716949,39.92013931
224,"MOUNT CLEMENS MI",4,1,0,0,1,1,-82.87785339,42.59724808
224,"MOUNT JOY PA",4,1,0,0,1,1,-76.50283051,40.10977936
224,"MOUNT PLEASANT MI",4,2,1,0,1,2,-84.76785278,43.59777832
224,"MOUNT PLEASANT SC",4,3,0,0,3,3,-79.86242676,32.79427719
224,"MOUNT RAINIER MD",4,3,0,0,3,3,-76.96430206,38.9414978
224,"MOUNT STERLING OH",4,1,0,1,0,1,-83.26514435,39.71972275
224,"MOUNT VERNON IL",4,1,0,1,0,1,-88.90307617,38.31738663
224,"MOUNT VERNON NY",4,2,0,0,1,1,-76.36322403,41.83351135
224,"MOUNTAIN VIEW CA",4,15,2,6,7,15,-122.0861969,37.3859024
224,"MOUNTLAKE TERRACE WA",4,2,1,0,1,2,-122.3119507,47.78780365
224,"MUNCIE IN",4,7,0,2,5,7,-85.38398743,40.18970871
224,"MUNHALL PA",4,2,0,2,0,2,-79.89945984,40.39241409
224,"MURFREESBORO TN",4,7,1,3,3,7,-86.39038086,35.84575653
224,"MURRAY KY",4,13,1,6,6,13,-88.31504059,36.61037827
224,"MURRIETA CA",4,1,0,1,0,1,-117.2157898,33.55398941
224,"MUSKEGON MI",4,6,0,1,2,3,-86.25441742,43.23139763
224,"MUSKOGEE OK",4,4,0,1,3,4,-95.36999512,35.74824142
224,"MYRTLE BEACH SC",4,1,0,1,0,1,-78.88601685,33.69656372
224,"NAMPA ID",4,7,0,2,5,7,-116.5658188,43.54054642
224,"NAPERVILLE IL",4,2,0,1,1,2,-88.14768219,41.78578949
224,"NAPLES FL",4,9,2,1,6,9,-81.79434204,26.14280128
224,"NASHUA NH",4,1,1,0,0,1,-71.46669769,42.76576996
224,"NASHVILLE IL",4,1,0,1,0,1,-89.3805542,38.34370804
224,"NATALIA TX",4,1,0,0,1,1,-98.86307526,29.19000626
224,"NATCHITOCHES LA",4,1,0,0,1,1,-93.08662415,31.76096535
224,"NATICK MA",4,2,1,0,1,2,-71.3484726,42.2836113
224,"NEDERLAND TX",4,1,0,0,1,1,-93.99260712,29.97476387
224,"NEEDHAM MA",4,1,0,1,0,1,-71.21767426,42.27159119
224,"NEODESHA KS",4,1,0,1,0,1,-95.68075562,37.41866684
224,"NEOGA IL",4,1,1,0,0,1,-88.45291901,39.31969833
224,"NEOSHO MO",4,1,0,1,0,1,-94.36846161,36.86910629
224,"NEW ALBANY IN",4,5,2,1,2,5,-85.80917358,38.29167938
224,"NEW BADEN IL",4,1,0,0,1,1,-89.70088196,38.53531647
224,"NEW BEDFORD MA",4,2,0,0,2,2,-70.93328857,41.63626862
224,"NEW BERN NC",4,1,0,0,1,1,-77.04354095,35.10897827
224,"NEW BRAUNFELS TX",4,8,1,2,5,8,-98.12486267,29.70325089
224,"NEW BRIGHTON PA",4,1,0,1,0,1,-80.30953217,40.73060989
224,"NEW BRITAIN CT",4,1,0,0,1,1,-72.77884674,41.6615181
224,"NEW BRUNSWICK NJ",4,9,3,1,5,9,-74.45104218,40.48620987
224,"NEW CARROLLTON MD",4,2,1,0,1,2,-76.8794632,38.97011185
224,"NEW CASTLE CO",4,1,0,0,1,1,-107.5379181,39.57275009
224,"NEW CASTLE DE",4,19,3,6,10,19,-75.56227875,39.66440964
224,"NEW CASTLE PA",4,1,0,1,0,1,-80.34657288,41.00389481
224,"NEW GLARUS WI",4,1,1,0,0,1,-89.63531494,42.81429672
224,"NEW HAVEN CT",4,65,21,24,20,65,-72.92726898,41.3084259
224,"NEW LONDON CT",4,12,3,5,4,12,-72.09841156,41.35572815
224,"NEW LONDON MN",4,1,0,1,0,1,-94.94470978,45.30108261
224,"NEW LONDON WI",4,4,1,2,1,4,-88.74013519,44.39267731
224,"NEW MADRID MO",4,1,0,1,0,1,-89.52796936,36.58650589
224,"NEW ORLEANS LA",4,302,59,99,144,302,-90.07525635,29.95483589
224,"NEW PALTZ NY",4,7,2,3,2,7,-74.08605194,41.74787903
224,"NEW PORT RICHEY FL",4,1,0,1,0,1,-82.71899414,28.24477577
224,"NEW ROCHELLE NY",4,20,8,6,6,20,-73.78160858,40.91175842
224,"NEW YORK NY",4,1258,277,411,570,1258,-74.00528717,40.7145195
224,"NEWARK DE",4,17,3,4,10,17,-75.74462128,39.68774414
224,"NEWARK NJ",4,55,11,17,27,55,-74.17185211,40.73570633
224,"NEWARK NY",4,1,0,1,0,1,-77.09454346,43.04671097
224,"NEWARK OH",4,2,0,1,1,2,-82.40110779,40.05843353
224,"NEWBURGH NY",4,6,0,2,4,6,-74.00939941,41.50367737
224,"NEWBURYPORT MA",4,4,1,1,2,4,-70.8768692,42.81164551
224,"NEWNAN GA",4,1,1,0,0,1,-84.79645538,33.37108231
224,"NEWPORT NEWS VA",4,10,4,2,4,10,-76.42758942,36.97909927
224,"NEWPORT RI",4,8,2,1,5,8,-71.31213379,41.49024963
224,"NEWTON IA",4,1,0,0,1,1,-93.05852509,41.69826126
224,"NEWTON IL",4,2,1,0,1,2,-88.16280365,38.99100876
224,"NEWTON KS",4,4,1,1,2,4,-97.3455658,38.04684067
224,"NEWTON MA",4,16,3,6,7,16,-71.20809937,42.33743286
224,"NIAGARA FALLS NY",4,3,1,1,1,3,-79.05632019,43.09456253
224,"NICHOLASVILLE KY",4,1,0,0,1,1,-84.57271576,37.88071442
224,"NIXA MO",4,1,0,1,0,1,-93.29502869,37.04324341
224,"NOBLESVILLE IN",4,12,3,2,7,12,-86.01766205,40.03728104
224,"NODAWAY IA",4,1,1,0,0,1,-94.89551544,40.93712997
224,"NOLANVILLE TX",4,1,0,1,0,1,-97.60596466,31.07933617
224,"NOLENSVILLE TN",4,1,1,0,0,1,-86.66940308,35.95249557
224,"NORFOLK NE",4,1,0,1,0,1,-97.41788483,42.02838898
224,"NORFOLK VA",4,61,10,20,31,61,-76.28334045,36.84831619
224,"NORMAL IL",4,10,1,6,3,10,-88.99052429,40.51409912
224,"NORMAN OK",4,4,0,2,2,4,-97.44689178,35.22203827
224,"NORTH ADAMS MA",4,1,0,0,1,1,-73.10797882,42.70087814
224,"NORTH AUGUSTA SC",4,11,1,4,6,11,-81.96509552,33.5021019
224,"NORTH BEND WA",4,8,2,3,3,8,-121.7899017,47.49547195
224,"NORTH BERGEN NJ",4,4,0,2,2,4,-74.0112381,40.8045845
224,"NORTH CHARLESTON SC",4,9,3,2,4,9,-79.97457886,32.85499191
224,"NORTH CHICAGO IL",4,2,0,1,1,2,-87.8412323,42.3254509
224,"NORTH HAVEN ME",4,1,0,0,1,1,-68.87295532,44.13141251
224,"NORTH LAS VEGAS NV",4,1,0,0,1,1,-115.1192093,36.19900131
224,"NORTH LITTLE ROCK AR",4,6,1,3,2,6,-92.26677704,34.76465988
224,"NORTH MIAMI BEACH FL",4,21,9,6,6,21,-80.16223907,25.93397713
224,"NORTH MIAMI FL",4,1,1,0,0,1,-80.18624115,25.8908596
224,"NORTH OLMSTED OH",4,1,0,0,1,1,-81.92334747,41.41566849
224,"NORTH POLE AK",4,2,0,1,1,2,-147.3626251,64.7430191
224,"NORTH PORT FL",4,1,0,0,1,1,-82.23706055,27.04372597
224,"NORTHAMPTON MA",4,5,1,1,3,5,-72.64012146,42.32544708
224,"NORTHFIELD MN",4,2,0,2,0,2,-93.16210175,44.45811081
224,"NORTHPORT AL",4,1,1,0,0,1,-87.57746124,33.22927856
224,"NORWALK CA",4,4,0,3,1,4,-118.0839539,33.90219116
224,"NORWALK CT",4,2,1,0,1,2,-73.40729523,41.11759949
224,"NORWALK OH",4,3,3,0,0,3,-82.61576843,41.24267197
224,"NORWOOD OH",4,1,0,0,1,1,-84.45967865,39.15586853
224,"NOVATO CA",4,2,0,0,2,2,-122.576561,38.11727142
224,"NOVI MI",4,1,0,0,1,1,-83.47566223,42.48064423
224,"NYACK NY",4,9,2,3,4,9,-73.91687012,41.09091568
224,"O'FALLON MO",4,84,20,21,43,84,-90.69979095,38.8109436
224,"OAK BLUFFS MA",4,1,1,0,0,1,-70.56096649,41.45436859
224,"OAK HILL FL",4,1,0,0,1,1,-80.85381317,28.8651619
224,"OAK LAWN IL",4,4,0,2,2,4,-87.7545929,41.721138
224,"OAK PARK IL",4,10,1,3,6,10,-87.78443909,41.88500595
224,"OAK RIDGE TN",4,1,1,0,0,1,-84.26974487,36.01036072
224,"OAKLAND CA",4,531,118,188,225,531,-122.2733154,37.80438614
224,"OBERLIN OH",4,2,0,0,2,2,-82.21720886,41.29413223
224,"OCEANSIDE CA",4,19,7,7,5,19,-117.3814011,33.19587326
224,"OCOEE FL",4,2,0,1,1,2,-81.54336548,28.56987
224,"ODESSA TX",4,2,0,1,1,2,-102.3682938,31.84587097
224,"OGALLALA NE",4,30,14,3,13,30,-101.7200775,41.1279068
224,"OGDEN AR",4,3,1,1,1,3,-94.04294586,33.58304214
224,"OGDEN UT",4,5,0,2,3,5,-111.9730225,41.22582626
224,"OKEECHOBEE FL",4,1,0,0,1,1,-80.82913971,27.24450302
224,"OKLAHOMA CITY OK",4,120,36,30,54,120,-97.51699829,35.46761322
224,"OKMULGEE OK",4,1,0,0,1,1,-95.96085358,35.62366486
224,"OLATHE KS",4,33,6,5,22,33,-94.81970215,38.88142395
224,"OLD SAYBROOK CT",4,1,0,0,1,1,-72.37509918,41.29185104
224,"OLEAN NY",4,1,1,0,0,1,-78.42921448,42.07747269
224,"OLIVE BRANCH MS",4,2,1,0,1,2,-89.82355499,34.96377563
224,"OLIVETTE MO",4,1,0,0,1,1,-90.37620544,38.66527557
224,"OLYMPIA WA",4,23,1,9,13,23,-122.8909378,47.04053497
224,"OMAHA NE",4,92,18,27,47,92,-95.93825531,41.25878906
224,"ONEONTA NY",4,1,0,1,0,1,-75.0631485,42.45296097
224,"ONTARIO CA",4,7,4,1,2,7,-117.6528702,34.06340408
224,"OPELIKA AL",4,2,1,0,1,2,-85.3780365,32.64568329
224,"ORANGE CA",4,17,2,8,7,17,-117.8544846,33.7877388
224,"ORANGE CITY FL",4,1,1,0,0,1,-81.29846191,28.94932175
224,"ORANGE PARK FL",4,1,0,1,0,1,-81.70614624,30.16655731
224,"ORANGEBURG SC",4,8,1,3,4,8,-80.86129761,33.48974228
224,"ORCHARD PARK NY",4,1,0,0,1,1,-78.74337006,42.76783371
224,"OREGON WI",4,1,0,0,1,1,-89.38459778,42.92614746
224,"ORLANDO FL",4,180,37,49,94,180,-81.3789978,28.53886795
224,"ORMOND BEACH FL",4,7,2,4,1,7,-81.05541992,29.28623772
224,"OROVILLE CA",4,1,0,1,0,1,-121.5581131,39.51348877
224,"OSSINING NY",4,7,3,0,4,7,-73.86093903,41.16327286
224,"OSWEGO IL",4,1,0,0,1,1,-88.3513031,41.68288422
224,"OVERLAND MO",4,1,0,1,0,1,-90.36277008,38.70130157
224,"OVERLAND PARK KS",4,37,8,12,17,37,-94.67124939,38.98216248
224,"OWATONNA MN",4,2,1,0,1,2,-93.22633362,44.08358383
224,"OWENSBORO KY",4,4,0,2,2,4,-87.11345673,37.77421188
224,"OXFORD MS",4,23,3,8,12,23,-89.52319336,34.37203979
224,"OXFORD OH",4,2,1,0,1,2,-84.74536133,39.50694275
224,"OXFORD PA",4,1,0,1,0,1,-75.97814178,39.78580856
224,"OXNARD CA",4,1,0,1,0,1,-119.1790085,34.19766998
224,"PACIFICA CA",4,1,0,0,1,1,-122.4893951,37.61383438
224,"PAINTSVILLE KY",4,1,1,0,0,1,-82.80673218,37.8147049
224,"PALISADES PARK NJ",4,4,2,1,1,4,-73.9969635,40.84852982
224,"PALM BAY FL",4,1,1,0,0,1,-80.58313751,28.03806496
224,"PALM BEACH FL",4,5,1,2,2,5,-80.03616333,26.70643616
224,"PALM BEACH GARDENS FL",4,2,0,1,1,2,-80.07454681,26.8109169
224,"PALM DESERT CA",4,5,1,0,4,5,-116.3907166,33.72164154
224,"PALM SPRINGS CA",4,12,4,2,6,12,-116.5467758,33.83036423
224,"PALMDALE CA",4,2,0,1,1,2,-118.118454,34.57925034
224,"PALMETTO GA",4,2,0,1,0,1,-83.79598999,33.71222115
224,"PALMYRA MO",4,1,1,0,0,1,-91.53061676,39.80343628
224,"PALO ALTO CA",4,24,2,11,11,24,-122.1449661,37.44177628
224,"PALOS HEIGHTS IL",4,1,1,0,0,1,-87.79647827,41.66812134
224,"PANAMA CITY BEACH FL",4,5,1,4,0,5,-85.80211639,30.1792717
224,"PANAMA CITY FL",4,5,1,0,4,5,-85.65970612,30.16412926
224,"PAPILLION NE",4,3,1,0,2,3,-96.04257202,41.15442276
224,"PARIS IL",4,4,0,3,1,4,-87.69623566,39.61117172
224,"PARIS TX",4,3,1,1,1,3,-95.55589294,33.66113663
224,"PARK CITY UT",4,13,4,6,3,13,-111.5018539,40.65143204
224,"PARKER CO",4,2,1,0,1,2,-104.7624359,39.51849365
224,"PARKERSBURG WV",4,1,0,1,0,1,-81.54850006,39.28261948
224,"PARLIER CA",4,2,1,0,1,2,-119.5286789,36.61136627
224,"PARMA OH",4,1,0,0,1,1,-81.72257996,41.40510178
224,"PASADENA CA",4,41,14,11,16,41,-118.1466675,34.14794922
224,"PASADENA TX",4,4,0,2,2,4,-95.20979309,29.69150162
224,"PASCAGOULA MS",4,1,0,1,0,1,-88.55257416,30.36789703
224,"PASCO WA",4,1,0,1,0,1,-119.1023636,46.2282753
224,"PASSAIC NJ",4,2,1,0,1,2,-74.12754822,40.8571434
224,"PATERSON NJ",4,2,1,0,1,2,-74.17102051,40.91714478
224,"PATTERSON NY",4,1,0,0,1,1,-73.60557556,41.51379395
224,"PAULSBORO NJ",4,1,0,0,1,1,-75.23970032,39.83067322
224,"PAWTUCKET RI",4,2,1,0,1,2,-71.38137054,41.87892532
224,"PEARLAND TX",4,1,0,1,0,1,-95.28644562,29.56411743
224,"PEMBROKE PINES FL",4,5,0,2,3,5,-80.22357941,26.00384903
224,"PENDLETON IN",4,1,0,0,1,1,-85.74658203,39.99742126
224,"PENDLETON OR",4,3,0,2,1,3,-118.7900848,45.67152786
224,"PENDLETON SC",4,1,1,0,0,1,-82.78354645,34.65194321
224,"PENN HILLS PA",4,1,0,0,1,1,-79.85767365,40.46170044
224,"PENSACOLA FL",4,32,9,6,17,32,-87.21669006,30.42154694
224,"PEORIA IL",4,14,4,3,7,14,-89.59487152,40.70241928
224,"PERRYSBURG OH",4,2,1,0,1,2,-83.62700653,41.55728531
224,"PERRYVILLE MO",4,3,0,1,2,3,-89.86131287,37.72448349
224,"PERU IN",4,2,1,1,0,2,-86.06684875,40.74810028
224,"PETAL MS",4,1,0,0,1,1,-89.26022339,31.34682083
224,"PETALUMA CA",4,3,0,1,2,3,-122.6394272,38.23221207
224,"PETERSBURG VA",4,4,1,1,2,4,-77.40148926,37.2280426
224,"PFLUGERVILLE TX",4,2,0,0,2,2,-97.62039948,30.4396553
224,"PHARR TX",4,6,0,2,4,6,-98.1840744,26.19566154
224,"PHENIX CITY AL",4,2,1,1,0,2,-85.00059509,32.4714241
224,"PHILADELPHIA PA",4,724,172,233,319,724,-75.16322327,39.95243835
224,"PHOENIX AZ",4,204,46,58,100,204,-112.0752716,33.44825363
224,"PHOENIXVILLE PA",4,2,0,0,2,2,-75.51416779,40.13076401
224,"PIERPONT SD",4,1,0,1,0,1,-97.82962036,45.49657059
224,"PINE BLUFF AR",4,3,0,3,0,3,-92.00374603,34.22846222
224,"PINELLAS PARK FL",4,1,1,0,0,1,-82.69934845,27.84342194
224,"PISMO BEACH CA",4,5,3,2,0,5,-120.6432953,35.1427269
224,"PITTSBURG CA",4,12,3,2,7,12,-121.8871613,38.02787781
224,"PITTSBURG KS",4,4,1,1,2,4,-94.70526123,37.41111374
224,"PITTSBURGH PA",4,355,91,129,135,355,-79.99537659,40.44091415
224,"PITTSFIELD MA",4,5,1,1,3,5,-73.24451447,42.45004272
224,"PLACERVILLE CA",4,3,1,0,2,3,-120.8002701,38.72951508
224,"PLAINFIELD IL",4,4,1,2,1,4,-88.20417786,41.62700653
224,"PLAINFIELD IN",4,1,0,1,0,1,-86.39954376,39.70450974
224,"PLAINFIELD NJ",4,6,1,3,2,6,-74.40673065,40.63404083
224,"PLANO TX",4,13,5,3,5,13,-96.69931793,33.01993942
224,"PLANT CITY FL",4,1,0,0,1,1,-82.11231232,28.01914597
224,"PLANTATION FL",4,2,0,0,2,2,-80.23281097,26.12825966
224,"PLAQUEMINE LA",4,1,0,1,0,1,-91.23427582,30.28962708
224,"PLATTSBURGH NY",4,1,1,0,0,1,-73.45239258,44.69951248
224,"PLEASANT HILL CA",4,1,0,0,1,1,-122.0632401,37.94770813
224,"PLYMOUTH MA",4,4,1,1,2,4,-70.67458344,41.95769882
224,"PLYMOUTH MN",4,1,0,0,1,1,-93.45163727,45.02838898
224,"POMONA CA",4,2,0,0,2,2,-117.7534485,34.05541611
224,"PONTIAC MI",4,13,1,4,8,13,-83.29104614,42.63900757
224,"POPLAR BLUFF MO",4,4,2,1,1,4,-90.3928833,36.75717545
224,"PORT ARTHUR TX",4,8,1,4,3,8,-93.93045807,29.90067863
224,"PORT HURON MI",4,1,1,0,0,1,-82.42453766,42.97105026
224,"PORT ORANGE FL",4,52,12,19,21,52,-81.00856781,29.13491631
224,"PORT ORCHARD WA",4,2,1,0,1,2,-122.6369019,47.53696823
224,"PORT ORFORD OR",4,1,0,0,1,1,-124.4993668,42.74531555
224,"PORTERVILLE CA",4,2,0,0,2,2,-119.0190811,36.06521988
224,"PORTLAND IN",4,1,0,1,0,1,-84.97788239,40.43445969
224,"PORTLAND ME",4,45,13,12,20,45,-70.25403595,43.6618576
224,"PORTLAND OR",4,603,130,199,274,603,-122.6786423,45.52309418
224,"PORTLAND TX",4,2,1,0,1,2,-97.32419586,27.87795258
224,"PORTSMOUTH NH",4,2,0,0,2,2,-70.76164246,43.07198334
224,"PORTSMOUTH VA",4,7,5,2,0,7,-76.29769135,36.83554077
224,"POTOSI MO",4,1,0,0,1,1,-90.78826141,37.93638992
224,"POUGHKEEPSIE NY",4,8,2,4,2,8,-73.92034149,41.70055771
224,"POWAY CA",4,1,0,1,0,1,-117.0376205,32.96272659
224,"PRAIRIE VIEW TX",4,1,0,0,1,1,-95.9883194,30.09370232
224,"PRATTVILLE AL",4,1,1,0,0,1,-86.45972443,32.46446228
224,"PRESCOTT AZ",4,1,0,0,1,1,-112.4702301,34.54008102
224,"PRESQUE ISLE ME",4,3,0,1,2,3,-68.01457214,46.68122482
224,"PRINCESS ANNE MD",4,4,1,2,1,4,-75.69158173,38.20330429
224,"PRINCETON NJ",4,19,5,6,8,19,-74.65805817,40.34872055
224,"PRINEVILLE OR",4,1,0,1,0,1,-120.8366928,44.29957581
224,"PROCTORVILLE OH",4,1,1,0,0,1,-82.37682343,38.43706512
224,"PROVIDENCE RI",4,88,22,27,39,88,-71.40118408,41.82990265
224,"PROVINCETOWN MA",4,53,14,14,25,53,-70.17770386,42.05849075
224,"PROVO UT",4,2,1,1,0,2,-111.6589813,40.23337936
224,"PUEBLO CO",4,9,0,4,5,9,-104.6108551,38.25450516
224,"PULLMAN WA",4,28,7,8,13,28,-117.180481,46.73068619
224,"PUYALLUP WA",4,2,1,1,0,2,-122.2927628,47.19064331
224,"QUAKERTOWN PA",4,1,1,0,0,1,-75.33325958,40.44256592
224,"QUEEN CREEK AZ",4,3,0,1,2,3,-111.6382294,33.25391769
224,"QUINCY IL",4,4,1,0,3,4,-91.41021729,39.9356575
224,"QUINCY MA",4,2,0,2,0,2,-71.00706482,42.24961472
224,"QUINCY MI",4,2,0,1,1,2,-84.88388824,41.94426727
224,"RACINE WI",4,5,0,0,5,5,-87.78296661,42.72628021
224,"RADFORD VA",4,1,0,0,1,1,-80.57588196,37.13208389
224,"RALEIGH NC",4,229,50,78,101,229,-78.63800049,35.77230835
224,"RANCHO PALOS VERDES CA",4,1,0,1,0,1,-118.388916,33.74456406
224,"RANGER GA",4,1,1,0,0,1,-84.71112823,34.50128555
224,"RAYTOWN MO",4,11,2,3,6,11,-94.46369934,39.00871277
224,"READING PA",4,4,0,1,3,4,-75.9259491,40.33562851
224,"RED BLUFF CA",4,3,0,0,3,3,-122.2382431,40.17803574
224,"RED HOOK NY",4,2,0,1,1,2,-73.87477875,41.99516296
224,"RED OAK TX",4,2,1,1,0,2,-96.80502319,32.51770401
224,"REDDING CA",4,2,0,1,1,2,-122.3944626,40.58649826
224,"REDLANDS CA",4,4,1,1,2,4,-117.21064,34.0318718
224,"REDMOND OR",4,10,2,1,7,10,-121.1761093,44.27230453
224,"REDMOND WA",4,39,11,10,18,39,-122.1240006,47.67367172
224,"REDONDO BEACH CA",4,9,0,4,5,9,-118.3907471,33.84916687
224,"REDWOOD CITY CA",4,11,2,3,6,11,-122.2364655,37.48601151
224,"REIDSVILLE NC",4,1,0,1,0,1,-79.66392517,36.35525513
224,"RENO NV",4,27,5,8,14,27,-119.8160934,39.5294838
224,"RENTON WA",4,11,4,7,0,11,-122.2197342,47.48252487
224,"REVERE MA",4,2,0,1,1,2,-71.01091003,42.40863037
224,"REYNOLDSBURG OH",4,2,0,2,0,2,-82.81163788,39.95471191
224,"RICHARDSON TX",4,7,4,1,2,7,-96.73020172,32.94840622
224,"RICHFIELD MN",4,1,1,0,0,1,-93.28303528,44.87028503
224,"RICHLAND WA",4,1,1,0,0,1,-119.2866592,46.28547287
224,"RICHMOND CA",4,8,3,2,3,8,-122.3500443,37.9354744
224,"RICHMOND HEIGHTS MO",4,15,4,3,8,15,-90.31951904,38.62892532
224,"RICHMOND TX",4,1,0,1,0,1,-95.76106262,29.58276558
224,"RICHMOND VA",4,118,22,40,56,118,-77.45962524,37.55412674
224,"RIDGEFIELD CT",4,1,1,0,0,1,-73.49742126,41.28165054
224,"RIDGELAND MS",4,4,2,0,2,4,-90.13221741,32.42857742
224,"RITZVILLE WA",4,1,0,0,1,1,-118.382103,47.12727737
224,"RIVERDALE GA",4,1,0,0,1,1,-84.4131012,33.57296371
224,"RIVERDALE IL",4,1,1,0,0,1,-87.633255,41.6336174
224,"RIVERSIDE CA",4,80,20,29,31,80,-117.3973999,33.95311737
224,"RIVERSIDE NJ",4,1,1,0,0,1,-74.95646667,40.03240967
224,"ROANOKE VA",4,12,2,2,8,12,-79.94111633,37.27119827
224,"ROBBINSDALE MN",4,1,0,0,1,1,-93.33868408,45.03195572
224,"ROBINSON IL",4,5,2,1,2,5,-87.73912048,39.00521469
224,"ROCHESTER MN",4,3,1,1,1,3,-92.47042084,44.02156448
224,"ROCHESTER NY",4,158,38,60,60,158,-77.61522675,43.15487671
224,"ROCHESTER PA",4,1,1,0,0,1,-80.28598022,40.70254135
224,"ROCK HILL SC",4,12,2,2,8,12,-81.02463531,34.92498779
224,"ROCK ISLAND IL",4,1,1,0,0,1,-90.5790329,41.50963593
224,"ROCK SPRINGS WY",4,1,0,1,0,1,-109.2040176,41.58724976
224,"ROCKDALE TX",4,1,0,0,1,1,-97.00177765,30.65601349
224,"ROCKFORD IL",4,13,2,4,7,13,-89.09428406,42.27135086
224,"ROCKLAND ME",4,1,0,0,1,1,-69.1079483,44.10363388
224,"ROCKLIN CA",4,3,0,1,2,3,-121.2383118,38.79031754
224,"ROCKVILLE CENTRE NY",4,1,0,1,0,1,-73.64044189,40.6588974
224,"ROCKVILLE MD",4,5,0,4,1,5,-77.15235901,39.08402252
224,"ROCKY RIVER OH",4,7,3,3,1,7,-81.83889008,41.4756279
224,"ROGERS AR",4,1,0,0,1,1,-94.11903381,36.33228683
224,"ROSEMOUNT MN",4,2,0,1,1,2,-93.12598419,44.73943329
224,"ROSENBERG TX",4,1,0,1,0,1,-95.80905914,29.5575695
224,"ROSEVILLE CA",4,1,0,0,1,1,-121.2899246,38.75195694
224,"ROSEVILLE MN",4,1,0,1,0,1,-93.14508057,45.02290726
224,"ROSSVILLE IN",4,1,0,1,0,1,-86.59479523,40.41724014
224,"ROSWELL GA",4,1,0,1,0,1,-84.36141205,34.02328491
224,"ROUND ROCK TX",4,5,0,1,4,5,-97.67939758,30.50861359
224,"ROWLETT TX",4,1,1,0,0,1,-96.56422424,32.90298462
224,"ROXANA IL",4,1,0,0,1,1,-90.07637024,38.84868622
224,"ROYERSFORD PA",4,1,0,0,1,1,-75.53735352,40.18464279
224,"RUMSON NJ",4,5,3,1,1,5,-73.99851227,40.37051773
224,"RUSSELLVILLE AR",4,1,0,0,1,1,-93.1343689,35.27845383
224,"RYE CO",4,1,0,1,0,1,-104.9316177,37.92366791
224,"SACRAMENTO CA",4,179,39,62,78,179,-121.4959793,38.58154297
224,"SADDLE BROOK NJ",4,1,1,0,0,1,-74.09207153,40.89922333
224,"SAGINAW MI",4,1,0,1,0,1,-83.95076752,43.41968918
224,"SAHUARITA AZ",4,23,3,9,11,23,-110.9567032,31.95795059
224,"SALEM IL",4,7,2,2,3,7,-88.94590759,38.62715149
224,"SALEM MA",4,13,3,3,7,13,-70.89565277,42.51993179
224,"SALEM NH",4,2,1,1,0,2,-71.19998169,42.78861618
224,"SALEM OH",4,1,0,0,1,1,-80.85612488,40.90091705
224,"SALEM OR",4,16,3,5,8,16,-123.0377197,44.94248199
224,"SALINAS CA",4,112,43,25,44,112,-121.6571732,36.67780304
224,"SALINE MI",4,2,1,0,1,2,-83.78155518,42.16699982
224,"SALISBURY MD",4,4,3,0,1,4,-75.5984726,38.36100388
224,"SALT LAKE CITY UT",4,43,6,13,24,43,-111.8912659,40.77029037
224,"SAN ANGELO TX",4,4,2,1,1,4,-100.4379044,31.46401215
224,"SAN ANTONIO TX",4,270,57,77,136,270,-98.49394989,29.42439651
224,"SAN BERNARDINO CA",4,11,0,2,9,11,-117.304596,34.12142563
224,"SAN CLEMENTE CA",4,1,0,0,1,1,-117.6134033,33.42698669
224,"SAN DIEGO CA",4,339,78,119,142,339,-117.1587296,32.71524429
224,"SAN DIMAS CA",4,1,0,1,0,1,-117.8088913,34.10668945
224,"SAN FRANCISCO CA",4,599,149,175,275,599,-122.4213257,37.77465057
224,"SAN JOSE CA",4,68,16,20,32,68,-121.8973846,37.33491516
224,"SAN LEANDRO CA",4,4,0,0,4,4,-122.155983,37.70180511
224,"SAN LUIS OBISPO CA",4,3,2,0,1,3,-120.6622849,35.28281021
224,"SAN MARCOS CA",4,2,2,0,0,2,-117.1673966,33.14345551
224,"SAN MARCOS TX",4,39,9,11,19,39,-97.94176483,29.88363266
224,"SAN MATEO CA",4,2,1,1,0,2,-122.3270264,37.56283569
224,"SAN RAFAEL CA",4,12,3,7,2,12,-122.5331726,37.97325134
224,"SAN RAMON CA",4,1,1,0,0,1,-121.9799347,37.77985764
224,"SAND SPRINGS OK",4,1,0,0,1,1,-96.10940552,36.13979721
224,"SANDY OR",4,1,0,0,1,1,-122.263649,45.39704132
224,"SANDY SPRINGS GA",4,3,0,0,3,3,-84.37850952,33.92443848
224,"SANFORD NC",4,4,3,1,0,4,-79.17978668,35.4800415
224,"SANTA ANA CA",4,12,3,5,4,12,-117.8697281,33.74567413
224,"SANTA BARBARA CA",4,43,8,13,22,43,-119.7056656,34.4233017
224,"SANTA CLARA CA",4,3,0,1,2,3,-121.946434,37.34754181
224,"SANTA CLAUS GA",4,1,0,1,0,1,-82.33099365,32.17210007
224,"SANTA CRUZ CA",4,19,2,7,10,19,-122.0333557,36.97389984
224,"SANTA FE NM",4,18,4,4,10,18,-105.9468155,35.68014526
224,"SANTA MARIA CA",4,1,0,0,1,1,-120.437973,34.95292664
224,"SANTA MONICA CA",4,43,9,10,24,43,-118.4925232,34.01921082
224,"SANTA ROSA CA",4,19,5,6,8,19,-122.7165146,38.44017792
224,"SARANAC LAKE NY",4,2,1,0,1,2,-74.1305542,44.32965851
224,"SARASOTA FL",4,11,3,4,4,11,-82.53031158,27.33688736
224,"SARATOGA CA",4,1,0,0,1,1,-122.0252457,37.26384735
224,"SARATOGA SPRINGS NY",4,8,0,4,4,8,-73.78382111,43.08345032
224,"SAUGERTIES NY",4,4,2,2,0,4,-73.95199585,42.07786942
224,"SAVANNAH GA",4,31,11,5,15,31,-81.09463501,32.07280731
224,"SAYREVILLE NJ",4,1,0,1,0,1,-74.36043549,40.45940018
224,"SCARSDALE NY",4,1,0,1,0,1,-73.78360748,41.00525665
224,"SCHENECTADY NY",4,1,0,0,1,1,-73.938591,42.81433487
224,"SCOTT CITY KS",4,1,0,0,1,1,-100.9082565,38.48249817
224,"SCOTT LA",4,3,1,0,2,3,-92.09500885,30.23620224
224,"SCOTTSBLUFF NE",4,2,0,0,2,2,-103.6682434,41.86663818
224,"SCOTTSDALE AZ",4,16,2,9,5,16,-111.9002533,33.50918579
224,"SCRANTON PA",4,4,1,1,2,4,-75.66184998,41.40919113
224,"SEAL BEACH CA",4,1,0,1,0,1,-118.1067505,33.74150848
224,"SEARCY AR",4,1,1,0,0,1,-91.73634338,35.25092697
224,"SEASIDE CA",4,1,0,1,0,1,-121.8542252,36.6110611
224,"SEAT PLEASANT MD",4,1,1,0,0,1,-76.90610504,38.8963623
224,"SEATTLE WA",4,851,186,286,379,851,-122.3343964,47.60571289
224,"SEBRING FL",4,1,0,0,1,1,-81.4406662,27.49625397
224,"SECAUCUS NJ",4,1,0,1,0,1,-74.05567169,40.78977585
224,"SEDALIA MO",4,1,0,1,0,1,-93.22884369,38.70438766
224,"SEDONA AZ",4,1,0,1,0,1,-111.7623367,34.86959839
224,"SEGUIN TX",4,5,1,1,3,5,-97.96529388,29.56933594
224,"SELMA AL",4,1,0,0,1,1,-87.02119446,32.40768433
224,"SEMINOLE FL",4,1,0,0,1,1,-82.79083252,27.84035683
224,"SENECA SC",4,1,0,0,1,1,-82.95318604,34.68600845
224,"SEQUIM WA",4,1,1,0,0,1,-123.1045303,48.07928085
224,"SEWARD NE",4,1,1,0,0,1,-97.09983063,40.90684891
224,"SHAKER HEIGHTS OH",4,31,1,7,23,31,-81.53669739,41.47419357
224,"SHAKOPEE MN",4,1,0,1,0,1,-93.52770233,44.79788971
224,"SHARON WI",4,1,0,0,1,1,-88.7290802,42.50258255
224,"SHAWNEE KS",4,1,0,0,1,1,-94.7208786,39.0417366
224,"SHAWNEE OK",4,2,0,1,1,2,-96.92608643,35.32754898
224,"SHEBOYGAN WI",4,3,1,1,1,3,-87.71476746,43.75089264
224,"SHELBY IA",4,3,1,1,1,3,-95.45110321,41.51625061
224,"SHELBYVILLE KY",4,1,1,0,0,1,-85.22341156,38.21203232
224,"SHELTON CT",4,1,0,1,0,1,-73.09243011,41.31684494
224,"SHERMAN TX",4,2,0,2,0,2,-96.60933685,33.63597488
224,"SHERWOOD AR",4,1,1,0,0,1,-92.22438049,34.81515884
224,"SHIVELY KY",4,2,0,0,2,2,-85.82255554,38.20013809
224,"SHREVEPORT LA",4,32,7,10,15,32,-93.7507019,32.52565002
224,"SHREWSBURY MO",4,1,0,1,0,1,-90.3371582,38.59024811
224,"SIKESTON MO",4,2,0,1,1,2,-89.5878067,36.87693024
224,"SILOAM SPRINGS AR",4,1,0,1,0,1,-94.54097748,36.18841934
224,"SIMI VALLEY CA",4,2,0,0,2,2,-118.7839508,34.26951981
224,"SIMPSONVILLE SC",4,1,0,0,1,1,-82.25405121,34.73744202
224,"SIOUX CITY IA",4,1,1,0,0,1,-96.40085602,42.5001564
224,"SIOUX FALLS SD",4,17,6,5,6,17,-96.73429108,43.54177475
224,"SLIDELL LA",4,15,8,1,6,15,-89.78143311,30.27558708
224,"SMITHTON MO",4,1,1,0,0,1,-93.09358978,38.68019104
224,"SMYRNA GA",4,6,0,2,4,6,-84.51447296,33.88409042
224,"SMYRNA TN",4,1,0,0,1,1,-86.51843262,35.98318863
224,"SNYDER TX",4,1,0,0,1,1,-100.9179764,32.71789169
224,"SOLEDAD CA",4,1,0,0,1,1,-121.3278732,36.42473984
224,"SOLON IA",4,1,0,1,0,1,-91.49409485,41.80740738
224,"SOLON OH",4,2,0,0,2,2,-81.44110107,41.3899231
224,"SOMERVILLE MA",4,95,24,29,42,95,-71.09860992,42.38757324
224,"SONORA CA",4,7,3,1,3,7,-120.3842011,37.98400497
224,"SOUTH BEND IN",4,13,1,7,5,13,-86.25171661,41.67295837
224,"SOUTH BOUND BROOK NJ",4,2,1,1,0,2,-74.53087616,40.55379105
224,"SOUTH CHICAGO HEIGHTS IL",4,1,1,0,0,1,-87.63790894,41.48114014
224,"SOUTH GATE CA",4,5,0,4,1,5,-118.213707,33.95462799
224,"SOUTH HOLLAND IL",4,2,0,2,0,2,-87.60710144,41.60099792
224,"SOUTH JORDAN UT",4,1,0,1,0,1,-111.9315186,40.56394577
224,"SOUTH LAKE TAHOE CA",4,1,0,0,1,1,-119.972786,38.94574356
224,"SOUTH MIAMI FL",4,1,0,0,1,1,-80.29296875,25.70849991
224,"SOUTH PASADENA CA",4,4,1,0,3,4,-118.1516647,34.11618805
224,"SOUTH PLAINFIELD NJ",4,1,1,0,0,1,-74.41103363,40.57961655
224,"SOUTH PORTLAND ME",4,2,2,0,0,2,-70.23975372,43.6415062
224,"SOUTH SAN FRANCISCO CA",4,3,0,2,1,3,-122.4101868,37.65430069
224,"SOUTHAMPTON NY",4,21,6,7,8,21,-72.38861084,40.88444519
224,"SOUTHFIELD MI",4,1,0,1,0,1,-83.22153473,42.47357559
224,"SOUTHINGTON CT",4,1,0,1,0,1,-72.8768158,41.59680557
224,"SOUTHWICK MA",4,1,0,0,1,1,-72.76921844,42.05488205
224,"SPANISH FORK UT",4,2,0,0,2,2,-111.6517334,40.11501312
224,"SPARTANBURG SC",4,23,7,6,10,23,-81.93160248,34.94982529
224,"SPEEDWAY IN",4,7,2,2,3,7,-86.2671051,39.80224609
224,"SPENCER NC",4,1,0,0,1,1,-80.43426514,35.69260025
224,"SPERRY OK",4,1,0,0,1,1,-95.99079132,36.2984314
224,"SPOKANE WA",4,25,8,8,9,25,-117.4281387,47.65847015
224,"SPRING HILL TN",4,4,1,2,1,4,-86.93003845,35.75111389
224,"SPRINGDALE AR",4,10,0,5,5,10,-94.12921143,36.1869278
224,"SPRINGFIELD IL",4,39,7,13,19,39,-89.6439743,39.80184174
224,"SPRINGFIELD MA",4,8,4,0,4,8,-72.57289124,42.10980606
224,"SPRINGFIELD MO",4,110,28,37,45,110,-93.29862213,37.21548843
224,"SPRINGFIELD OH",4,2,2,0,0,2,-83.80889893,39.92424011
224,"SPRINGFIELD OR",4,1,0,0,1,1,-123.024704,44.04590988
224,"SPRINGFIELD PA",4,1,0,1,0,1,-75.31934357,39.93074036
224,"ST LOUIS MO",4,4289,1081,1037,2171,4289,-90.19819641,38.62716675
224,"STAMFORD CT",4,9,2,3,4,9,-73.53807068,41.05353165
224,"STANFORD KY",4,1,0,0,1,1,-84.66183472,37.53141403
224,"STANTON CA",4,1,0,0,1,1,-117.9945526,33.80238724
224,"STANWOOD WA",4,3,0,1,2,3,-122.3728256,48.24087524
224,"STARKVILLE MS",4,1,0,1,0,1,-88.81492615,33.46545029
224,"STATE COLLEGE PA",4,8,1,2,5,8,-77.85973358,40.79336929
224,"STATESBORO GA",4,9,3,2,4,9,-81.78266907,32.44914246
224,"STATESVILLE NC",4,1,1,0,0,1,-80.88671875,35.78310013
224,"STAUNTON VA",4,2,1,1,0,2,-79.07145691,38.14970016
224,"STEAMBOAT SPRINGS CO",4,8,1,3,4,8,-106.8292313,40.48627853
224,"STEILACOOM WA",4,3,1,0,2,3,-122.6048813,47.16923141
224,"STEPHENVILLE TX",4,4,2,0,2,4,-98.20308685,32.22081757
224,"STERLING HEIGHTS MI",4,1,0,1,0,1,-83.03016663,42.58047485
224,"STILLWATER MN",4,1,1,0,0,1,-92.80657959,45.05171967
224,"STILLWATER OK",4,2,0,1,1,2,-97.0588913,36.11580658
224,"STOCKBRIDGE GA",4,1,0,0,1,1,-84.23356628,33.54455185
224,"STOCKTON CA",4,8,2,0,6,8,-121.293457,37.95776749
224,"STONE MOUNTAIN GA",4,12,2,3,7,12,-84.14538574,33.8065033
224,"STOW OH",4,5,1,1,3,5,-81.44025421,41.1593895
224,"STUART VA",4,1,1,0,0,1,-80.26490784,36.64115906
224,"STURGIS MI",4,1,0,1,0,1,-85.41933441,41.7995491
224,"SUFFOLK VA",4,14,2,1,11,14,-76.58317566,36.72846985
224,"SUGAR LAND TX",4,2,1,1,0,2,-95.6352005,29.61997795
224,"SULLIVAN MO",4,1,0,0,1,1,-91.16096497,38.20802689
224,"SUMMERVILLE SC",4,13,4,4,5,13,-80.17547607,33.01868439
224,"SUMMIT IL",4,5,0,0,5,5,-87.81018066,41.78816223
224,"SUMMIT NJ",4,1,0,1,0,1,-74.3586731,40.74148178
224,"SUN PRAIRIE WI",4,1,0,0,1,1,-89.21392059,43.18373108
224,"SUN VALLEY ID",4,1,0,0,1,1,-114.3539352,43.69688034
224,"SUNNYVALE CA",4,8,5,1,2,8,-122.0380707,37.36878967
224,"SUNRISE FL",4,2,0,0,2,2,-80.2282486,26.14059067
224,"SUNSET LA",4,1,0,1,0,1,-92.06873322,30.41154289
224,"SURFSIDE FL",4,5,0,2,3,5,-80.12493134,25.87931252
224,"SWANSEA IL",4,5,1,1,3,5,-89.98918152,38.53406143
224,"SYLVANIA OH",4,12,3,3,6,12,-83.71266174,41.71902466
224,"SYRACUSE NY",4,39,14,8,17,39,-76.14653015,43.04846191
224,"TACOMA WA",4,47,12,12,23,47,-122.4466705,47.25242233
224,"TAHLEQUAH OK",4,2,1,0,1,2,-94.9703064,35.91559982
224,"TAKOMA PARK MD",4,6,2,2,2,6,-77.00667572,38.97793198
224,"TALLAHASSEE FL",4,82,25,24,33,82,-84.27896881,30.44669914
224,"TALLULA IL",4,2,0,1,1,2,-89.93762207,39.94442749
224,"TAMARAC FL",4,1,0,0,1,1,-80.22389984,26.19458199
224,"TAMPA FL",4,439,107,135,197,439,-82.4580307,27.94833755
224,"TAOS NM",4,2,0,1,1,2,-105.5769424,36.40658188
224,"TARPON SPRINGS FL",4,56,15,20,21,56,-82.75656128,28.14682198
224,"TAUNTON MA",4,1,1,0,0,1,-71.08903503,41.900177
224,"TAYLORVILLE IL",4,9,2,2,5,9,-89.29446411,39.5492363
224,"TEANECK NJ",4,5,1,2,2,5,-74.01485443,40.89759064
224,"TEMPE AZ",4,68,18,21,29,68,-111.9108276,33.41504288
224,"TEMPLE TX",4,11,6,1,4,11,-97.34354401,31.09850502
224,"TENAFLY NJ",4,1,0,1,0,1,-73.9623642,40.92551041
224,"TERRE HAUTE IN",4,2,0,2,0,2,-87.41414642,39.46681976
224,"TEWKSBURY MA",4,3,0,1,2,3,-71.23313904,42.61103439
224,"THIBODAUX LA",4,3,1,1,1,3,-90.82309723,29.79626465
224,"THOMASVILLE GA",4,1,0,0,1,1,-83.97835541,30.8371582
224,"THOMASVILLE NC",4,1,0,1,0,1,-80.08161163,35.88302994
224,"THORNTON CO",4,8,1,4,3,8,-104.9727631,39.86811829
224,"THOUSAND OAKS CA",4,2,0,1,1,2,-118.8398514,34.17078018
224,"THREE RIVERS MI",4,2,2,0,0,2,-85.63246918,41.94419861
224,"TIJERAS NM",4,1,0,1,0,1,-106.3882523,35.07998657
224,"TIMPSON TX",4,1,1,0,0,1,-94.39550781,31.90409851
224,"TINLEY PARK IL",4,3,0,2,1,3,-87.78465271,41.57352448
224,"TOLEDO OH",4,36,6,15,15,36,-83.55497742,41.66411591
224,"TOMBALL TX",4,1,1,0,0,1,-95.6162262,30.09776115
224,"TOMBSTONE AZ",4,1,1,0,0,1,-110.0689316,31.71310997
224,"TOMS RIVER NJ",4,1,1,0,0,1,-74.19700623,39.95401382
224,"TOOELE UT",4,5,0,1,4,5,-112.3005066,40.53457642
224,"TOPEKA KS",4,23,8,9,6,23,-95.67857361,39.04813766
224,"TORONTO KS",4,1,0,0,1,1,-95.94944,37.79908752
224,"TORRANCE CA",4,5,0,0,5,5,-118.3428345,33.8359642
224,"TORRINGTON CT",4,3,0,2,1,3,-73.12056732,41.80105209
224,"TORRINGTON WY",4,1,1,0,0,1,-104.1826859,42.06502533
224,"TOWANDA KS",4,1,1,0,0,1,-97.00056458,37.79741669
224,"TRACY CA",4,1,0,1,0,1,-121.427269,37.73949814
224,"TRAVELERS REST SC",4,1,0,1,0,1,-82.44297028,34.96780014
224,"TRAVERSE CITY MI",4,8,3,1,4,8,-85.6207962,44.76324844
224,"TRENTON FL",4,1,0,1,0,1,-82.81704712,29.61356735
224,"TRENTON NJ",4,20,1,6,13,20,-74.74206543,40.21709442
224,"TROY MO",4,7,4,0,3,7,-90.98098755,38.979702
224,"TROY NY",4,9,2,2,5,9,-73.69088745,42.72839737
224,"TROY OH",4,25,5,10,10,25,-84.20330811,40.03966141
224,"TRUCKEE CA",4,5,1,1,3,5,-120.1852493,39.32775879
224,"TUCSON AZ",4,84,16,36,32,84,-110.9277954,32.22209167
224,"TULARE CA",4,2,0,1,1,2,-119.3488922,36.20763016
224,"TULSA OK",4,60,8,22,30,60,-95.98488617,36.1603241
224,"TUPELO MS",4,2,1,1,0,2,-88.71934509,34.26508713
224,"TUSCALOOSA AL",4,16,4,4,8,16,-87.56897736,33.21024704
224,"TUSCUMBIA AL",4,1,0,1,0,1,-87.70251465,34.73139191
224,"TUSKEGEE AL",4,1,0,0,1,1,-85.69181061,32.42424011
224,"TUSTIN CA",4,2,0,1,1,2,-117.8277283,33.74598312
224,"TWIN FALLS ID",4,3,1,1,1,3,-114.4627686,42.56301498
224,"TYLER TX",4,1,0,0,1,1,-95.3013916,32.35176468
224,"UNION KY",4,2,0,0,2,2,-84.68045044,38.94612122
224,"UNION ME",4,1,0,1,0,1,-69.27328491,44.21183395
224,"UNION NJ",4,1,0,1,0,1,-74.26235199,40.69780731
224,"UNIONTOWN AL",4,1,1,0,0,1,-87.51420593,32.44990921
224,"UNIVERSITY CITY MO",4,28,10,8,10,28,-90.33391571,38.66000748
224,"UNIVERSITY PLACE WA",4,1,0,0,1,1,-122.5529404,47.2352562
224,"UPLAND CA",4,1,0,0,1,1,-117.6498413,34.09745026
224,"UPPER DARBY PA",4,2,0,2,0,2,-75.27319336,39.92858124
224,"UPPER MARLBORO MD",4,11,2,2,7,11,-76.74905396,38.81620026
224,"URBANA IL",4,16,6,6,4,16,-88.20746613,40.11079025
224,"UTICA NY",4,1,0,1,0,1,-75.23220062,43.10119629
224,"VACAVILLE CA",4,2,1,0,1,2,-121.9900284,38.35633469
224,"VALDOSTA GA",4,12,1,5,6,12,-83.27806854,30.83293533
224,"VALLEJO CA",4,11,3,6,2,11,-122.2594299,38.1039505
224,"VANCOUVER WA",4,46,10,19,17,46,-122.6816559,45.63534164
224,"VARNADO LA",4,4,0,3,1,4,-89.82972717,30.89409256
224,"VERMILLION SD",4,5,0,3,2,5,-96.92948914,42.77981949
224,"VERNON HILLS IL",4,1,0,0,1,1,-87.97944641,42.21946716
224,"VERONA WI",4,2,0,0,2,2,-89.53356171,42.99075699
224,"VERSAILLES KY",4,1,0,0,1,1,-84.73013306,38.05267715
224,"VESTAL NY",4,1,0,0,1,1,-76.05289459,42.08543015
224,"VESTAVIA HILLS AL",4,1,0,1,0,1,-86.78768921,33.44869995
224,"VICKSBURG MS",4,1,0,0,1,1,-90.87818909,32.35280991
224,"VICTORIA TX",4,4,1,1,2,4,-97.00409698,28.80560303
224,"VICTORVILLE CA",4,1,1,0,0,1,-117.2928162,34.53612137
224,"VIENNA VA",4,11,2,2,7,11,-77.2645874,38.90164566
224,"VIENNA WV",4,1,0,0,1,1,-81.54671478,39.33840179
224,"VILLA RICA GA",4,3,0,1,2,3,-84.91907501,33.73210907
224,"VINTON IA",4,1,0,1,0,1,-92.02865601,42.1633873
224,"VIRGINIA BEACH VA",4,104,30,25,49,104,-75.97751617,36.8533783
224,"VISALIA CA",4,1,0,1,0,1,-119.2938156,36.33000946
224,"VISTA CA",4,4,3,0,1,4,-117.2447052,33.2000885
224,"WACO TX",4,8,0,3,5,8,-97.14704895,31.54987144
224,"WAKE FOREST NC",4,3,2,0,1,3,-78.50919342,35.98039246
224,"WAKEFIELD MA",4,2,0,0,2,2,-71.07489014,42.51018906
224,"WALKERTOWN NC",4,1,0,1,0,1,-80.15262604,36.17556
224,"WALLA WALLA WA",4,2,1,0,1,2,-118.3452072,46.06405258
224,"WALNUT CREEK CA",4,5,0,2,3,5,-122.0670624,37.90636826
224,"WALTHAM MA",4,3,2,0,1,3,-71.2346344,42.37656403
224,"WARDEN WA",4,1,0,0,1,1,-119.0420456,46.96730423
224,"WARNER ROBINS GA",4,5,0,0,5,5,-83.59963989,32.62118149
224,"WARREN MI",4,74,20,20,34,74,-83.02783203,42.47764969
224,"WARREN OH",4,1,0,0,1,1,-80.81771851,41.23757935
224,"WARRENTON MO",4,15,5,2,8,15,-91.14160919,38.81156921
224,"WARRENTON VA",4,12,2,6,4,12,-77.79475403,38.71380615
224,"WARSAW NC",4,1,0,0,1,1,-78.09035492,34.99985886
224,"WASCO CA",4,1,0,0,1,1,-119.3427811,35.59425735
224,"WASHINGTON DC",4,2378,555,756,1067,2378,-77.01257324,38.88911819
224,"WASHINGTON IL",4,1,0,1,0,1,-89.40994263,40.70514297
224,"WASHINGTON MO",4,44,14,7,23,44,-91.01213074,38.55807495
224,"WASHINGTON PA",4,2,0,2,0,2,-80.24552155,40.17398453
224,"WASILLA AK",4,13,4,3,6,13,-149.4517059,61.58290482
224,"WATERBURY CT",4,1,0,1,0,1,-73.05029297,41.55849075
224,"WATERFORD WI",4,1,0,0,1,1,-88.21479797,42.76306152
224,"WATERLOO IL",4,3,0,1,2,3,-90.14981842,38.3361702
224,"WATERVILLE ME",4,1,0,0,1,1,-69.63098145,44.55205154
224,"WAUKEE IA",4,1,0,0,1,1,-93.8857193,41.61172485
224,"WAUKEGAN IL",4,2,0,0,2,2,-87.84466553,42.36366653
224,"WAUKESHA WI",4,6,1,0,5,6,-88.23146057,43.01194382
224,"WAUWATOSA WI",4,4,2,1,1,4,-88.00754547,43.04960632
224,"WAVERLY IA",4,1,0,1,0,1,-92.47597504,42.7256813
224,"WAYNESBORO MS",4,1,0,1,0,1,-88.64648437,31.67511749
224,"WAYNESVILLE MO",4,1,1,0,0,1,-92.20101166,37.8287735
224,"WEATHERBY LAKE MO",4,1,0,0,1,1,-94.69628906,39.23784256
224,"WEATHERFORD TX",4,1,0,0,1,1,-97.79758453,32.7595253
224,"WEAUBLEAU MO",4,1,1,0,0,1,-93.5421524,37.8908577
224,"WEBSTER GROVES MO",4,1,1,0,0,1,-90.35769653,38.59287262
224,"WEBSTER NY",4,1,0,1,0,1,-77.42967224,43.21234131
224,"WEED CA",4,15,5,6,4,15,-122.388382,41.42225266
224,"WEIRTON WV",4,1,0,0,1,1,-80.58799744,40.40523529
224,"WENTZVILLE MO",4,14,0,6,8,14,-90.85335541,38.81171036
224,"WESLACO TX",4,7,2,0,5,7,-97.99131775,26.16018867
224,"WEST BRANCH MI",4,1,1,0,0,1,-84.23848724,44.2763443
224,"WEST CHESTER PA",4,3,2,1,0,3,-75.60475159,39.96074677
224,"WEST COVINA CA",4,1,0,0,1,1,-117.9406204,34.0685463
224,"WEST DES MOINES IA",4,2,0,0,2,2,-93.71179962,41.57717514
224,"WEST FARGO ND",4,1,0,0,1,1,-96.90450287,46.87138367
224,"WEST HARTFORD CT",4,9,2,3,4,9,-72.74108887,41.76238251
224,"WEST HOLLYWOOD CA",4,14,2,5,7,14,-118.3634567,34.08982468
224,"WEST LAFAYETTE IN",4,34,5,10,19,34,-86.9082489,40.42613983
224,"WEST ORANGE NJ",4,2,0,1,1,2,-74.23833466,40.7989006
224,"WEST PALM BEACH FL",4,39,9,11,19,39,-80.05298615,26.71585464
224,"WEST PLAINS MO",4,4,3,1,0,4,-91.85284424,36.72810745
224,"WEST TX",4,8,1,3,4,8,-97.09226227,31.80267906
224,"WESTERVILLE OH",4,6,0,3,3,6,-82.92906952,40.12620926
224,"WESTFIELD IN",4,4,0,2,2,4,-86.12757111,40.04309464
224,"WESTFIELD NJ",4,4,1,0,3,4,-74.34671783,40.65938187
224,"WESTLAND MI",4,3,0,1,2,3,-83.39988708,42.32430649
224,"WESTMINSTER CO",4,1,0,0,1,1,-105.0385208,39.83644867
224,"WESTMINSTER MD",4,1,0,0,1,1,-76.99542999,39.57574463
224,"WESTMONT IL",4,2,1,0,1,2,-87.97566223,41.79613113
224,"WESTPORT CT",4,3,1,1,1,3,-73.35696411,41.14154053
224,"WHEATON IL",4,2,2,0,0,2,-88.10729218,41.86618805
224,"WHEELING WV",4,5,0,4,1,5,-80.7192688,40.06991577
224,"WHITE BEAR LAKE MN",4,1,0,1,0,1,-93.01039886,45.08457947
224,"WHITE PLAINS NY",4,4,1,2,1,4,-73.76217651,41.03399658
224,"WHITEFISH BAY WI",4,4,1,0,1,2,-87.561748505,44.0099659
224,"WHITEFISH MT",4,1,0,0,1,1,-114.3380127,48.41337967
224,"WHITESBURG KY",4,1,0,1,0,1,-82.82665253,37.11859894
224,"WHITESTOWN IN",4,1,0,0,1,1,-86.34572601,39.99731445
224,"WHITTIER CA",4,12,5,4,3,12,-118.0349197,33.9793129
224,"WICHITA FALLS TX",4,4,2,2,0,4,-98.49403381,33.91383743
224,"WICHITA KS",4,53,11,10,32,53,-97.3383255,37.69230652
224,"WICKLIFFE OH",4,2,0,1,1,2,-81.45320129,41.60562515
224,"WILLIAMSBURG VA",4,10,3,2,5,10,-76.70659637,37.27114868
224,"WILLIAMSON WV",4,1,1,0,0,1,-82.27328491,37.67479324
224,"WILLIAMSPORT PA",4,3,0,3,0,3,-77.00060272,41.24121475
224,"WILLIAMSTOWN MA",4,4,2,0,2,4,-73.21173859,42.70910263
224,"WILLINGBORO NJ",4,2,0,1,1,2,-74.86815643,40.02816391
224,"WILLITS CA",4,2,0,1,1,2,-123.3572464,39.40924072
224,"WILLMAR MN",4,1,0,1,0,1,-95.04427338,45.12181473
224,"WILLOUGHBY OH",4,2,0,1,1,2,-81.40597534,41.63972092
224,"WILMETTE IL",4,1,0,0,1,1,-87.72296143,42.07221222
224,"WILMINGTON DE",4,19,4,6,9,19,-75.54558563,39.74601364
224,"WILMINGTON NC",4,7,3,3,1,7,-77.94431305,34.22592926
224,"WILSON NC",4,1,0,0,1,1,-77.914711,35.72143173
224,"WILSONVILLE OR",4,3,2,0,1,3,-122.7757416,45.29935455
224,"WINCHESTER VA",4,1,0,0,1,1,-78.16301727,39.18608475
224,"WINDSOR MO",4,9,4,1,4,9,-93.5224762,38.53234863
224,"WINDSOR VA",4,1,0,1,0,1,-76.74337006,36.80891037
224,"WINDSOR VT",4,1,0,0,1,1,-72.38378906,43.48069
224,"WINGATE NC",4,2,0,0,2,2,-80.4487915,34.98449326
224,"WINONA MN",4,2,0,0,2,2,-91.63965607,44.04986572
224,"WINSTON-SALEM NC",4,53,8,19,26,53,-80.24356842,36.1001091
224,"WINTER HAVEN FL",4,5,0,2,3,5,-81.73223114,28.02276421
224,"WINTER PARK CO",4,3,0,3,0,3,-105.7649307,39.89161301
224,"WINTER PARK FL",4,15,6,4,5,15,-81.33872223,28.6003685
224,"WITT IL",4,2,0,2,0,2,-89.34815216,39.2564888
224,"WOOD RIVER IL",4,1,0,1,0,1,-90.09774017,38.86127472
224,"WOODBURY MN",4,1,1,0,0,1,-92.95999908,44.92368698
224,"WOODBURY NJ",4,1,0,1,0,1,-75.15171051,39.83841705
224,"WOODINVILLE WA",4,2,2,0,0,2,-122.1656876,47.75372314
224,"WOODLAND CA",4,4,1,1,2,4,-121.7751541,38.67827225
224,"WOODSTOCK GA",4,2,0,0,2,2,-84.51925659,34.10178375
224,"WOOSTER OH",4,6,2,3,1,6,-81.93497467,40.80502319
224,"WORCESTER MA",4,14,2,4,8,14,-71.801651,42.26288986
224,"YALE OK",4,1,0,0,1,1,-96.70005798,36.11446381
224,"YELM WA",4,1,0,1,0,1,-122.608902,46.94182968
224,"YONKERS NY",4,13,3,3,7,13,-73.89792633,40.93142319
224,"YORBA LINDA CA",4,2,2,0,0,2,-117.8147278,33.88856888
224,"YORK PA",4,2,1,0,1,2,-76.72687531,39.96264267
224,"YOUNGSTOWN OH",4,25,4,5,16,25,-80.64901733,41.1000061
224,"YOUNTVILLE CA",4,1,0,1,0,1,-122.3634491,38.40127182
224,"YPSILANTI MI",4,18,5,7,6,18,-83.61315155,42.24105453
224,"YUCCA VALLEY CA",4,2,1,0,1,2,-116.4475403,34.11928558
224,"ZACHARY LA",4,1,0,0,1,1,-91.15661621,30.64884186
224,"ZIONSVILLE IN",4,1,1,0,0,1,-86.26182556,39.95092773
225,"ABILENE TX",5,4,2,0,2,4,-99.73384094,32.44894028
225,"ABSECON NJ",5,1,0,1,0,1,-74.49462128,39.42850494
225,"ACTON MA",5,9,2,4,3,9,-71.43197632,42.48540115
225,"ADDISON TX",5,3,0,1,2,3,-96.82976532,32.96215057
225,"AIKEN SC",5,1,1,0,0,1,-81.71619415,33.55714417
225,"AKRON OH",5,21,8,4,9,21,-81.51885223,41.08151627
225,"ALAMEDA CA",5,10,4,2,4,10,-122.2444763,37.76513672
225,"ALBANY NY",5,28,3,14,11,28,-73.75520325,42.6529007
225,"ALBANY OR",5,1,0,0,1,1,-123.1083984,44.63620758
225,"ALBUQUERQUE NM",5,105,35,27,43,105,-106.6517639,35.08336639
225,"ALEXANDRIA LA",5,8,1,2,5,8,-92.44517517,31.31143761
225,"ALEXANDRIA MN",5,2,0,1,1,2,-95.37786865,45.88516617
225,"ALEXANDRIA VA",5,33,9,7,17,33,-77.04605103,38.80503082
225,"ALHAMBRA CA",5,1,1,0,0,1,-118.1287003,34.0954628
225,"ALIQUIPPA PA",5,3,0,1,2,3,-80.23978424,40.63685608
225,"ALLEN TX",5,1,0,1,0,1,-96.67116547,33.10336685
225,"ALLENTOWN PA",5,4,1,1,2,4,-75.46569824,40.60851288
225,"ALLIANCE OH",5,1,0,1,0,1,-81.10575867,40.91523743
225,"ALPHARETTA GA",5,1,1,0,0,1,-84.29410553,34.07542419
225,"ALTAMONTE SPRINGS FL",5,3,1,0,2,3,-81.39485931,28.66284752
225,"ALTON IL",5,12,2,3,7,12,-90.18429565,38.89074326
225,"AMARILLO TX",5,2,1,0,1,2,-101.8324051,35.22210312
225,"AMERICUS GA",5,3,0,2,1,3,-84.23246002,32.07291031
225,"AMES IA",5,7,2,2,3,7,-93.61370087,42.02269363
225,"AMHERST MA",5,2,1,1,0,2,-72.5192337,42.37371826
225,"AMITYVILLE NY",5,1,0,0,1,1,-73.41622162,40.67899323
225,"AMMON ID",5,1,0,1,0,1,-111.9684067,43.46959305
225,"AMORY MS",5,1,1,0,0,1,-88.48745728,33.98094559
225,"ANAHEIM CA",5,16,2,5,9,16,-117.9165115,33.8354454
225,"ANCHORAGE AK",5,15,6,2,7,15,-149.8811951,61.21649933
225,"ANDERSON IN",5,2,0,0,2,2,-85.68051147,40.1053772
225,"ANDERSON SC",5,4,1,2,1,4,-82.65641785,34.50934219
225,"ANDOVER MA",5,1,0,1,0,1,-71.13011169,42.65668869
225,"ANN ARBOR MI",5,77,25,23,29,77,-83.74536896,42.28347015
225,"ANNAPOLIS MD",5,18,2,7,9,18,-76.49166107,38.97844696
225,"ANOKA MN",5,2,1,1,0,2,-93.3874588,45.19776535
225,"ANTIOCH CA",5,5,2,1,2,5,-121.808136,38.0049057
225,"APACHE JUNCTION AZ",5,2,0,2,0,2,-111.5511551,33.41511536
225,"APPLE VALLEY MN",5,1,0,0,1,1,-93.21794128,44.73189926
225,"APPLETON WI",5,2,2,0,0,2,-88.41551208,44.2618866
225,"ARCADIA CA",5,1,0,0,1,1,-118.0368881,34.1397934
225,"ARCANUM OH",5,2,0,0,2,2,-84.55335236,39.9899826
225,"ARCATA CA",5,2,0,2,0,2,-124.08564,40.86624527
225,"ARKANSAS CITY KS",5,1,1,0,0,1,-97.03897858,37.06211472
225,"ARLINGTON HEIGHTS IL",5,2,0,2,0,2,-87.98104858,42.08821106
225,"ARLINGTON MA",5,5,0,1,4,5,-71.15559387,42.41545486
225,"ARLINGTON TN",5,1,1,0,0,1,-89.66139984,35.29637527
225,"ARLINGTON TX",5,23,6,9,8,23,-97.10882568,32.73590469
225,"ARLINGTON WA",5,2,1,1,0,2,-122.1277237,48.19829941
225,"ARNOLD MO",5,1,0,0,1,1,-90.37690735,38.43906784
225,"ASBURY PARK NJ",5,2,0,0,2,2,-74.01100159,40.22047806
225,"ASHEBORO NC",5,1,0,0,1,1,-79.81291199,35.70822525
225,"ASHEVILLE NC",5,36,13,9,14,36,-82.55367279,35.60134888
225,"ASHLAND AL",5,5,1,3,1,5,-85.83626556,33.27382278
225,"ASHLAND KY",5,10,4,1,5,10,-82.63764954,38.47874069
225,"ASHLAND MA",5,1,1,0,0,1,-71.46256256,42.26143265
225,"ASHLAND MO",5,1,1,0,0,1,-92.25737762,38.77433395
225,"ASHLAND OR",5,16,4,5,7,16,-122.7111359,42.19425583
225,"ASHLAND VA",5,3,1,1,1,3,-77.47959137,37.75937653
225,"ASHTABULA OH",5,5,2,2,1,5,-80.78971863,41.86506653
225,"ASPEN CO",5,1,0,1,0,1,-106.8185959,39.19105911
225,"ATHENS PA",5,1,1,0,0,1,-76.52072906,41.9661293
225,"ATLANTA GA",5,1154,298,356,500,1154,-84.38757324,33.74927521
225,"ATLANTIC CITY NJ",5,4,2,0,2,4,-74.42202759,39.36457062
225,"ATWATER CA",5,1,0,1,0,1,-120.6140137,37.34663773
225,"AUBURN AL",5,11,2,4,5,11,-85.48087311,32.61021423
225,"AUBURN CA",5,9,3,3,3,9,-121.0794067,38.89623642
225,"AUBURN ME",5,2,0,1,1,2,-70.23028564,44.09794235
225,"AUBURN NY",5,1,1,0,0,1,-76.56542969,42.93203735
225,"AUGUSTA ME",5,1,1,0,0,1,-69.7781601,44.31053925
225,"AURORA CO",5,14,1,6,7,14,-104.8693161,39.73983765
225,"AURORA IL",5,6,3,0,3,6,-88.32048798,41.76070023
225,"AUSTIN MN",5,1,0,1,0,1,-92.97491455,43.6665535
225,"AUSTIN TX",5,499,123,171,205,499,-97.74386597,30.26748466
225,"AUSTINTOWN OH",5,1,0,0,1,1,-80.76424408,41.10162354
225,"AVA MO",5,1,1,0,0,1,-92.6605835,36.95189667
225,"AVONDALE AZ",5,2,0,1,1,2,-112.3513947,33.43592072
225,"AVONMORE PA",5,1,0,1,0,1,-79.46125031,40.52923965
225,"AZUSA CA",5,2,0,1,1,2,-117.9098816,34.13357544
225,"BAKERSFIELD CA",5,12,2,2,8,12,-119.0206375,35.37326813
225,"BALDWIN CITY KS",5,1,0,0,1,1,-95.18656921,38.77522659
225,"BALLWIN MO",5,4,0,1,3,4,-90.54669189,38.5951004
225,"BALTIMORE MD",5,360,97,115,148,360,-76.6115799,39.29075623
225,"BANDERA TX",5,1,0,0,1,1,-99.07427216,29.72691536
225,"BANGOR ME",5,5,0,1,4,5,-68.77653503,44.80109406
225,"BARBERTON OH",5,1,1,0,0,1,-81.60507965,41.0127182
225,"BARDSTOWN KY",5,4,0,0,2,2,-85.46318817,37.810512545
225,"BARTONVILLE IL",5,7,1,1,5,7,-89.65235138,40.6502037
225,"BATAVIA NY",5,2,1,1,0,2,-78.18697357,42.99835587
225,"BATON ROUGE LA",5,38,10,13,15,38,-91.15479279,30.45132256
225,"BATTLE CREEK MI",5,2,1,1,0,2,-85.17985535,42.32100677
225,"BAXTER SPRINGS KS",5,3,1,1,1,3,-94.73813629,37.02472305
225,"BAY CITY MI",5,1,0,0,1,1,-83.8886261,43.59466171
225,"BAY VILLAGE OH",5,4,3,0,1,4,-81.92155457,41.48464966
225,"BEACON NY",5,1,0,0,1,1,-73.9688797,41.50502014
225,"BEAUFORT NC",5,1,0,0,1,1,-76.66288757,34.71848679
225,"BEAUFORT SC",5,1,0,1,0,1,-80.68718719,32.44019699
225,"BEAVER PA",5,1,0,1,0,1,-80.30450439,40.69532776
225,"BEAVERCREEK OH",5,2,0,0,2,2,-84.06332397,39.70913696
225,"BEAVERTON OR",5,8,2,4,2,8,-122.8055344,45.48670197
225,"BEDFORD NY",5,3,2,0,1,3,-73.64318085,41.204319
225,"BEDFORD TX",5,2,1,1,0,2,-97.14364624,32.8442955
225,"BEL AIR MD",5,1,0,1,0,1,-76.34788513,39.53611374
225,"BELL CA",5,1,1,0,0,1,-118.1889572,33.97753906
225,"BELLEVILLE IL",5,47,10,16,21,47,-89.98438263,38.52002716
225,"BELLEVUE NE",5,2,1,0,1,2,-95.89156342,41.13648224
225,"BELLEVUE WA",5,4,1,1,2,4,-122.2029648,47.61014557
225,"BELLFLOWER CA",5,1,0,0,1,1,-118.1186295,33.88169479
225,"BELLINGHAM WA",5,10,4,2,4,10,-122.4727402,48.76121521
225,"BELOIT WI",5,1,0,0,1,1,-89.03194427,42.50856781
225,"BEMIDJI MN",5,1,0,0,1,1,-94.88105774,47.47352982
225,"BENBROOK TX",5,1,0,1,0,1,-97.46098328,32.67370987
225,"BEND OR",5,8,2,2,4,8,-121.3171387,44.0577774
225,"BENTONVILLE AR",5,4,2,0,2,4,-94.20933533,36.3728447
225,"BERGENFIELD NJ",5,2,0,1,1,2,-73.99640656,40.92791748
225,"BERKELEY CA",5,93,30,18,45,93,-122.2752533,37.87145615
225,"BERKELEY MO",5,2,0,1,1,2,-90.33169556,38.75470734
225,"BERKLEY MI",5,1,0,1,0,1,-83.18341827,42.50307083
225,"BERNALILLO NM",5,1,0,1,0,1,-106.5516357,35.30175781
225,"BERWICK PA",5,3,0,0,3,3,-76.23230743,41.05486679
225,"BESSEMER CITY NC",5,1,0,0,1,1,-81.28375244,35.28520966
225,"BETHALTO IL",5,1,0,1,0,1,-90.04077911,38.90911865
225,"BETHEL PARK PA",5,1,0,0,1,1,-80.01592255,40.33843613
225,"BETHLEHEM PA",5,8,1,1,6,8,-75.36949921,40.62598801
225,"BETTENDORF IA",5,3,2,1,0,3,-90.51612854,41.52465439
225,"BEVERLY HILLS CA",5,47,16,14,17,47,-118.4019775,34.07383347
225,"BEVERLY MA",5,3,1,0,2,3,-70.87913513,42.55848312
225,"BIG SPRING TX",5,2,0,1,1,2,-101.4811173,32.25181198
225,"BILLINGS MT",5,1,0,1,0,1,-108.504631,45.7833786
225,"BILOXI MS",5,3,1,2,0,3,-88.89369202,30.40021133
225,"BINGHAMTON NY",5,13,4,2,7,13,-75.91755676,42.0986557
225,"BIRMINGHAM AL",5,68,15,14,39,68,-86.80226898,33.52098846
225,"BIRMINGHAM MI",5,4,1,2,1,4,-83.21121216,42.54697418
225,"BISBEE AZ",5,5,2,3,0,5,-109.9298477,31.44821548
225,"BLACK MOUNTAIN NC",5,5,3,1,1,5,-82.32103729,35.61796188
225,"BLACKSBURG VA",5,8,0,4,4,8,-80.41369629,37.22999573
225,"BLACKVILLE SC",5,3,3,0,0,3,-81.27037048,33.35803604
225,"BLOOMINGTON IL",5,2,0,0,2,2,-88.99375916,40.48418045
225,"BLOOMINGTON IN",5,15,1,7,7,15,-86.53382874,39.16920471
225,"BLOOMINGTON MN",5,3,0,3,0,3,-93.29154205,44.82648849
225,"BLUE SPRINGS MO",5,2,1,1,0,2,-94.2820816,39.01689148
225,"BOAZ AL",5,1,0,0,1,1,-86.16611481,34.20103073
225,"BOCA RATON FL",5,4,1,1,2,4,-80.08280182,26.35960197
225,"BOILING SPRINGS NC",5,2,1,1,0,2,-81.66678619,35.25450516
225,"BOLINGBROOK IL",5,14,3,7,4,14,-88.06878662,41.69866562
225,"BONHAM TX",5,2,0,0,2,2,-96.17896271,33.57743454
225,"BOONTON NJ",5,1,0,0,1,1,-74.4063797,40.90301514
225,"BOONVILLE MO",5,1,0,0,1,1,-92.74378967,38.97373962
225,"BORDENTOWN NJ",5,4,1,1,2,4,-74.7159729,40.15003586
225,"BOSTON MA",5,448,131,116,201,448,-71.05905151,42.35883713
225,"BOTHELL WA",5,1,0,1,0,1,-122.2075424,47.75966263
225,"BOULDER CO",5,28,10,6,12,28,-105.2715302,40.01483917
225,"BOWIE MD",5,12,5,2,5,12,-76.77848816,39.00718689
225,"BOWLING GREEN OH",5,2,2,0,0,2,-83.65102386,41.37505341
225,"BOWMAN SC",5,1,0,0,1,1,-80.68243408,33.34929657
225,"BOYNTON BEACH FL",5,3,0,0,3,3,-80.066185,26.52592087
225,"BOYS TOWN NE",5,2,1,0,1,2,-96.13262177,41.26118088
225,"BOZEMAN MT",5,10,4,2,4,10,-111.0471649,45.6803093
225,"BRADENTON FL",5,4,1,1,2,4,-82.57459259,27.49969101
225,"BRECKENRIDGE CO",5,1,1,0,0,1,-106.0398636,39.48156357
225,"BREESE IL",5,2,2,0,0,2,-89.52734375,38.61071396
225,"BREMERTON WA",5,1,0,0,1,1,-122.6345291,47.56690598
225,"BREWSTER OH",5,1,0,1,0,1,-81.5980072,40.70691681
225,"BRIDGEPORT CT",5,3,0,0,3,3,-73.2040863,41.16743088
225,"BRIDGEVILLE PA",5,2,0,1,1,2,-80.1095047,40.35649872
225,"BRIGHTON IL",5,1,0,0,1,1,-90.14067841,39.03963089
225,"BRISBANE CA",5,1,1,0,0,1,-122.402504,37.68077469
225,"BRISTOL CT",5,3,1,0,2,3,-72.94853973,41.67193222
225,"BRISTOL TN",5,6,1,1,4,6,-82.17338562,36.58886719
225,"BRISTOL VA",5,1,0,1,0,1,-82.18840027,36.59663391
225,"BROADVIEW HEIGHTS OH",5,1,1,0,0,1,-81.68503571,41.31410217
225,"BROCKTON MA",5,5,0,1,4,5,-71.01748657,42.08340454
225,"BROOKINGS OR",5,1,0,1,0,1,-124.2865219,42.05229187
225,"BROOKINGS SD",5,1,0,1,0,1,-96.79450989,44.3097229
225,"BROOKLINE MA",5,3,2,0,1,3,-71.12002563,42.33176804
225,"BROOKSIDE VILLAGE TX",5,1,0,1,0,1,-95.32555389,29.58737183
225,"BROOKSVILLE FL",5,3,0,1,2,3,-82.38734436,28.55600739
225,"BROOMFIELD CO",5,4,2,1,1,4,-105.0877686,39.92069244
225,"BROWN DEER WI",5,1,0,0,1,1,-87.96490479,43.16327667
225,"BRUNSWICK GA",5,1,0,0,1,1,-81.49102783,31.1502285
225,"BRYAN TX",5,2,0,1,1,2,-96.3704071,30.67456818
225,"BUCHANAN MI",5,1,0,1,0,1,-86.3614502,41.82715225
225,"BUCKHANNON WV",5,1,0,0,1,1,-80.22968292,38.99204254
225,"BUFFALO NY",5,81,32,23,26,81,-78.87787628,42.8867836
225,"BUFORD GA",5,1,0,1,0,1,-84.00788879,34.11735535
225,"BURBANK CA",5,4,1,0,3,4,-118.3104782,34.18065262
225,"BURLINGAME CA",5,2,2,0,0,2,-122.3685074,37.58408737
225,"BURLINGTON NC",5,1,0,1,0,1,-79.43729401,36.09585953
225,"BURLINGTON VT",5,13,7,3,3,13,-73.20542908,44.47687531
225,"BURNSVILLE MN",5,1,0,0,1,1,-93.27822113,44.76760483
225,"BURNSVILLE NC",5,1,0,1,0,1,-82.30067444,35.91744614
225,"BUTLER PA",5,2,2,0,0,2,-79.89468384,40.86117172
225,"CAHOKIA IL",5,2,1,1,0,2,-90.19016266,38.57118225
225,"CAIRO GA",5,5,2,0,3,5,-84.20102692,30.87791824
225,"CALABASAS CA",5,1,0,0,1,1,-118.6473236,34.1558876
225,"CALIFORNIA MO",5,3,0,0,3,3,-92.56713104,38.62768555
225,"CAMARILLO CA",5,10,0,5,5,10,-119.0400391,34.21628952
225,"CAMBRIDGE MA",5,46,15,11,20,46,-71.10369873,42.36532593
225,"CAMDEN AR",5,3,1,1,1,3,-92.83481598,33.58491898
225,"CAMDEN NJ",5,6,2,2,2,6,-75.118927,39.92608261
225,"CAMDENTON MO",5,1,1,0,0,1,-92.74469757,38.00836182
225,"CAMP HILL PA",5,1,0,0,1,1,-76.9335022,40.24120331
225,"CANANDAIGUA NY",5,2,0,1,1,2,-77.28107452,42.88830948
225,"CANNON FALLS MN",5,1,0,0,1,1,-92.90566254,44.50691605
225,"CANTON GA",5,1,0,1,0,1,-84.48571014,34.23356628
225,"CANTON OH",5,12,0,6,6,12,-81.37824249,40.79906845
225,"CANYON TX",5,1,0,0,1,1,-101.9192429,34.98051834
225,"CAPE CORAL FL",5,1,0,0,1,1,-81.9491806,26.56343079
225,"CAPE GIRARDEAU MO",5,13,2,3,8,13,-89.51838684,37.30613327
225,"CAPITOL HEIGHTS MD",5,1,1,0,0,1,-76.91506195,38.88552475
225,"CARBONDALE IL",5,4,1,1,2,4,-89.2168808,37.7274704
225,"CARENCRO LA",5,1,0,0,1,1,-92.04903412,30.31741714
225,"CARLISLE PA",5,1,0,0,1,1,-77.18848419,40.20173264
225,"CARLSBAD CA",5,6,4,0,2,6,-117.3528137,33.1580162
225,"CARNEYS POINT NJ",5,1,0,1,0,1,-75.46931458,39.71123123
225,"CARPINTERIA CA",5,1,0,1,0,1,-119.5201263,34.39894485
225,"CARRBORO NC",5,4,2,0,2,4,-79.07286835,35.91213989
225,"CARROLLTON GA",5,1,0,0,1,1,-85.07631683,33.58019638
225,"CARSON CA",5,2,1,1,0,2,-118.2837448,33.8312645
225,"CARTERET NJ",5,1,0,0,1,1,-74.2276535,40.57754135
225,"CARTHAGE MO",5,11,2,3,6,11,-94.31087494,37.17650223
225,"CARUTHERSVILLE MO",5,1,0,1,0,1,-89.65577698,36.19351578
225,"CARY NC",5,5,2,1,2,5,-78.78055573,35.79200745
225,"CASA GRANDE AZ",5,6,1,2,3,6,-111.7590179,32.87965393
225,"CASCADE LOCKS OR",5,1,0,0,1,1,-121.8928452,45.66971588
225,"CASPER WY",5,3,0,1,2,3,-106.3147507,42.86667633
225,"CASTLE ROCK CO",5,4,2,0,2,4,-104.857811,39.37207031
225,"CATHEDRAL CITY CA",5,3,1,0,2,3,-116.4663467,33.77960205
225,"CEDAR RAPIDS IA",5,7,1,3,3,7,-91.66259766,41.98337555
225,"CEDARBURG WI",5,2,1,0,1,2,-87.9877243,43.29684067
225,"CEDARVILLE OH",5,1,0,0,1,1,-83.80859375,39.74424362
225,"CENTER POINT AL",5,1,0,0,1,1,-86.68362427,33.64584732
225,"CERRITOS CA",5,1,1,0,0,1,-118.0665054,33.85832214
225,"CHADRON NE",5,1,0,1,0,1,-102.9998169,42.83535004
225,"CHAMPAIGN IL",5,27,8,4,15,27,-88.24346161,40.11659622
225,"CHANDLER AZ",5,6,1,3,2,6,-111.8428345,33.3062439
225,"CHAPEL HILL NC",5,21,6,4,11,21,-79.05697632,35.91110611
225,"CHARLESTON IL",5,2,1,1,0,2,-88.17610931,39.49612045
225,"CHARLESTON SC",5,35,11,11,13,35,-79.93032074,32.77671814
225,"CHARLESTON WV",5,11,6,2,3,11,-81.63149261,38.34872055
225,"CHARLOTTE NC",5,305,83,94,128,305,-80.84257507,35.22746277
225,"CHARLOTTESVILLE VA",5,38,13,7,18,38,-78.49123383,38.03798676
225,"CHATTANOOGA TN",5,23,8,8,7,23,-85.30583954,35.04058456
225,"CHECOTAH OK",5,1,0,0,1,1,-95.52338409,35.47038651
225,"CHERRY HILL NJ",5,1,0,0,1,1,-75.03024292,39.93510437
225,"CHESAPEAKE VA",5,23,5,5,13,23,-76.27422333,36.81948853
225,"CHESTER PA",5,1,1,0,0,1,-75.35475159,39.84973145
225,"CHESTER SC",5,3,0,2,1,3,-81.2141037,34.7049675
225,"CHESTERFIELD MO",5,7,2,2,3,7,-90.5772934,38.6631279
225,"CHESTERTOWN MD",5,2,1,1,0,2,-76.0662384,39.20907593
225,"CHETEK WI",5,1,0,1,0,1,-91.65122986,45.31412888
225,"CHEVERLY MD",5,3,0,0,3,3,-76.91530609,38.92858505
225,"CHEVY CHASE MD",5,1,0,0,1,1,-77.07595825,38.97138977
225,"CHEWELAH WA",5,1,0,1,0,1,-117.7169418,48.27609634
225,"CHEYENNE WY",5,2,1,0,1,2,-104.8183899,41.13345718
225,"CHICAGO IL",5,1010,246,291,473,1010,-87.6503067,41.85000992
225,"CHICO CA",5,78,20,25,33,78,-121.839447,39.72846222
225,"CHILLICOTHE MO",5,3,0,2,1,3,-93.55298615,39.79542542
225,"CHULA VISTA CA",5,11,1,5,5,11,-117.0857468,32.64037704
225,"CICERO IL",5,1,0,1,0,1,-87.75395203,41.84553909
225,"CINCINNATI OH",5,96,21,34,41,96,-84.51939392,39.10413742
225,"CLAREMONT CA",5,3,2,1,0,3,-117.7214508,34.09675217
225,"CLARKSVILLE TN",5,4,1,1,2,4,-87.35944366,36.52993011
225,"CLAYTON MO",5,3,1,1,1,3,-90.32382965,38.64260101
225,"CLAYTON NC",5,1,0,0,1,1,-78.45562744,35.6511879
225,"CLEAR LAKE SHORES TX",5,8,2,3,3,8,-95.03226471,29.54773712
225,"CLEARWATER FL",5,2,0,1,1,2,-82.79984283,27.9665451
225,"CLEBURNE TX",5,1,0,1,0,1,-97.38722992,32.34804535
225,"CLEMMONS NC",5,3,0,1,2,3,-80.38154602,36.02172089
225,"CLEMSON SC",5,1,0,0,1,1,-82.83683014,34.68382645
225,"CLEVELAND HEIGHTS OH",5,9,0,2,7,9,-81.55568695,41.52017975
225,"CLEVELAND OH",5,194,46,53,95,194,-81.69516754,41.49978256
225,"CLINTON TN",5,1,0,1,0,1,-84.13148499,36.10355759
225,"COLLEGE PARK GA",5,16,4,4,8,16,-84.44933319,33.65347672
225,"COLLEGE PARK MD",5,19,6,4,9,19,-76.93619537,38.98080444
225,"COLLEGE STATION TX",5,15,3,3,9,15,-96.33758545,30.62316895
225,"COLLINGSWOOD NJ",5,1,0,1,0,1,-75.07028961,39.9186058
225,"COLLINSVILLE IL",5,2,2,0,0,2,-89.98478699,38.67050171
225,"COLMA CA",5,3,0,1,2,3,-122.4610977,37.67665482
225,"COLORADO SPRINGS CO",5,33,16,6,11,33,-104.8225174,38.83369446
225,"COLUMBIA IL",5,2,0,2,0,2,-90.20130157,38.44375992
225,"COLUMBIA MO",5,107,27,30,50,107,-92.33429718,38.95169067
225,"COLUMBIA SC",5,43,10,8,25,43,-81.04045105,34.00138855
225,"COLUMBIA TN",5,6,1,1,4,6,-87.03533173,35.61502457
225,"COLUMBUS GA",5,37,10,8,19,37,-84.98313141,32.46828842
225,"COLUMBUS IN",5,1,0,0,1,1,-85.92284393,39.20959473
225,"COLUMBUS OH",5,206,59,45,102,206,-82.99890137,39.96136475
225,"COMMERCE TX",5,1,0,0,1,1,-95.90060425,33.24729538
225,"COMPTON CA",5,20,3,8,9,20,-118.2218704,33.89606857
225,"CONCORD NC",5,7,1,4,2,7,-80.57880402,35.4092598
225,"CONCORD NH",5,2,0,0,2,2,-71.53688812,43.20820999
225,"CONNELL WA",5,1,1,0,0,1,-118.863533,46.66334534
225,"CONOVER NC",5,2,1,0,1,2,-81.21835327,35.70663834
225,"CONROE TX",5,2,0,2,0,2,-95.45646667,30.31249237
225,"CONWAY AR",5,6,2,1,3,6,-92.4426651,35.08877563
225,"CONWAY SC",5,1,0,0,1,1,-79.04202271,33.83802795
225,"CONYERS GA",5,1,0,0,1,1,-84.0175705,33.66764832
225,"COOKEVILLE TN",5,1,0,0,1,1,-85.50189972,36.16290665
225,"CORAL GABLES FL",5,2,1,1,0,2,-80.26779938,25.72242165
225,"CORBIN KY",5,1,0,0,1,1,-84.09648132,36.94906235
225,"CORONA CA",5,13,5,3,5,13,-117.5688171,33.87516785
225,"CORPUS CHRISTI TX",5,5,0,3,2,5,-97.42076874,27.77859879
225,"CORRY PA",5,1,0,1,0,1,-79.63973999,41.92025375
225,"CORTE MADERA CA",5,1,0,1,0,1,-122.5294342,37.9252739
225,"CORVALLIS OR",5,1,0,1,0,1,-123.2646637,44.56417084
225,"COSHOCTON OH",5,1,0,1,0,1,-81.85901642,40.27225113
225,"COSTA MESA CA",5,3,1,2,0,3,-117.9204407,33.64131927
225,"COTATI CA",5,1,0,0,1,1,-122.7091904,38.32655334
225,"COTTONWOOD AZ",5,1,0,1,0,1,-112.0110779,34.739048
225,"COUNCIL BLUFFS IA",5,1,0,0,1,1,-95.86154938,41.26196289
225,"COVINA CA",5,1,0,1,0,1,-117.8919067,34.09014511
225,"COVINGTON GA",5,1,0,0,1,1,-83.86009216,33.59708405
225,"CRANFORD NJ",5,4,2,1,1,4,-74.29885101,40.65885925
225,"CREVE COEUR MO",5,4,1,1,2,4,-90.42288971,38.66108322
225,"CROSSVILLE TN",5,1,0,0,1,1,-85.0270462,35.9490509
225,"CROTON-ON-HUDSON NY",5,6,1,0,5,6,-73.89041901,41.2085762
225,"CROWN POINT IN",5,1,0,0,1,1,-87.36541748,41.41695023
225,"CRYSTAL MN",5,1,0,0,1,1,-93.36638641,45.05664063
225,"CUBA MO",5,1,0,1,0,1,-91.40387726,38.06311035
225,"CUMBERLAND MD",5,2,0,1,1,2,-78.76217651,39.65284729
225,"CUMMING GA",5,2,0,1,1,2,-84.1401825,34.2074852
225,"CUPERTINO CA",5,4,1,2,1,4,-122.0342026,37.32306671
225,"CUYAHOGA FALLS OH",5,3,3,0,0,3,-81.48397064,41.1338768
225,"DADEVILLE AL",5,1,1,0,0,1,-85.76355743,32.83142853
225,"DALLAS TX",5,490,128,137,225,490,-96.80088043,32.78369904
225,"DALTON GA",5,3,1,2,0,3,-84.97008514,34.76976776
225,"DALWORTHINGTON GARDENS TX",5,1,0,1,0,1,-97.1558075,32.7033844
225,"DALY CITY CA",5,49,16,12,21,49,-122.4645081,37.70376968
225,"DANBURY CT",5,1,0,0,1,1,-73.45310974,41.39499664
225,"DANVILLE CA",5,1,1,0,0,1,-122.0023193,37.82156754
225,"DANVILLE IL",5,8,2,4,2,8,-87.62978363,40.12442398
225,"DANVILLE KY",5,1,1,0,0,1,-84.77213287,37.6458931
225,"DAVENPORT IA",5,6,3,0,3,6,-90.57814026,41.52380753
225,"DAVIE FL",5,3,1,2,0,3,-80.23148346,26.0657177
225,"DAVIS CA",5,2,2,0,0,2,-121.7421722,38.54467773
225,"DAYTON OH",5,73,19,17,37,73,-84.19126892,39.75915146
225,"DAYTONA BEACH FL",5,5,3,1,1,5,-81.02253723,29.21147537
225,"DEARBORN MI",5,5,1,2,2,5,-83.1758728,42.32239914
225,"DEBARY FL",5,2,1,0,1,2,-81.30838776,28.88345909
225,"DECATUR AL",5,2,1,1,0,2,-86.98355103,34.60622406
225,"DECATUR GA",5,6,2,2,2,6,-84.29631805,33.77489471
225,"DECATUR IL",5,2,0,1,1,2,-88.95516968,39.84060287
225,"DEER CREEK OK",5,1,1,0,0,1,-97.51993561,36.80317307
225,"DEERFIELD BEACH FL",5,1,0,0,1,1,-80.09928131,26.31905365
225,"DEERFIELD IL",5,2,0,1,1,2,-87.84490204,42.17103577
225,"DEFIANCE OH",5,1,0,1,0,1,-84.35565948,41.28461838
225,"DELAVAN WI",5,3,2,0,1,3,-88.644104,42.6329422
225,"DELAWARE OH",5,7,1,2,4,7,-83.06757355,40.29886627
225,"DELRAY BEACH FL",5,3,1,1,1,3,-80.07209778,26.46233368
225,"DENTON NC",5,3,1,0,2,3,-80.1153183,35.63389587
225,"DENTON TX",5,18,5,8,5,18,-97.13349915,33.21514893
225,"DENVER CO",5,375,110,107,158,375,-104.9853745,39.73901749
225,"DES MOINES IA",5,8,2,4,2,8,-93.6210022,41.59817123
225,"DES PLAINES IL",5,1,0,0,1,1,-87.8833847,42.03343964
225,"DESTIN FL",5,2,1,0,1,2,-86.49551392,30.39405632
225,"DETROIT MI",5,224,61,67,96,224,-83.04567719,42.33172226
225,"DEXTER MO",5,1,0,1,0,1,-89.95834351,36.79595947
225,"DICKINSON ND",5,3,1,1,1,3,-102.7891007,46.87979889
225,"DICKINSON TX",5,2,0,2,0,2,-95.05158234,29.46142769
225,"DINUBA CA",5,1,1,0,0,1,-119.3888931,36.543293
225,"DIXON CA",5,2,2,0,0,2,-121.8243713,38.44569778
225,"DIXON MO",5,1,1,0,0,1,-92.09407043,37.99162674
225,"DONIPHAN MO",5,4,2,0,2,4,-90.82394409,36.62110138
225,"DOTHAN AL",5,1,0,0,1,1,-85.39019775,31.22351265
225,"DOUGLAS GA",5,1,0,0,1,1,-82.84980011,31.50903511
225,"DOVER DE",5,1,1,0,0,1,-75.52090454,39.15853882
225,"DOVER NH",5,1,0,1,0,1,-70.88840485,43.2059021
225,"DOYLESTOWN OH",5,1,0,0,1,1,-81.69629669,40.96931458
225,"DOYLESTOWN PA",5,3,1,1,1,3,-75.1292038,40.31054688
225,"DREW MS",5,4,1,1,2,4,-90.53083038,33.81049728
225,"DUBLIN CA",5,3,0,2,1,3,-121.9383392,37.70181274
225,"DUBUQUE IA",5,6,1,2,3,6,-90.67155457,42.51130295
225,"DULUTH MN",5,2,2,0,0,2,-92.10697174,46.78300858
225,"DUNCANVILLE TX",5,6,2,3,1,6,-96.9091568,32.65229034
225,"DUNMORE PA",5,1,1,0,0,1,-75.63155365,41.42010117
225,"DURANGO CO",5,8,4,1,3,8,-107.8810043,37.27463913
225,"DURHAM NC",5,103,37,30,36,103,-78.89787292,35.99412918
225,"EAGAN MN",5,1,0,1,0,1,-93.16746521,44.80387878
225,"EASLEY SC",5,1,0,1,0,1,-82.60394287,34.82990646
225,"EAST HARTFORD CT",5,2,0,1,1,2,-72.64693451,41.77160263
225,"EAST HELENA MT",5,8,3,1,4,8,-111.9177475,46.58939743
225,"EAST LANSING MI",5,14,7,1,6,14,-84.48403931,42.73703384
225,"EAST ORANGE NJ",5,18,6,2,10,18,-74.21418762,40.76618958
225,"EAST PEORIA IL",5,2,0,1,1,2,-89.58027649,40.66614151
225,"EAST POINT GA",5,2,0,0,2,2,-84.43933868,33.67996979
225,"EASTON PA",5,1,0,1,0,1,-75.21966553,40.68871689
225,"EATONTON GA",5,1,0,1,0,1,-83.38854218,33.32721329
225,"EAU CLAIRE WI",5,6,2,1,3,6,-91.49876404,44.81137466
225,"EDEN PRAIRIE MN",5,11,2,1,8,11,-93.48716736,44.85310745
225,"EDGAR SPRINGS MO",5,2,0,1,1,2,-91.86699677,37.70466232
225,"EDINBORO PA",5,2,0,2,0,2,-80.13100433,41.87437439
225,"EDMOND OK",5,5,1,1,3,5,-97.48453522,35.65326309
225,"EDMONDS WA",5,2,1,0,1,2,-122.3799057,47.81037521
225,"EDWARDSVILLE IL",5,22,10,3,9,22,-89.95322418,38.8115654
225,"EFFINGHAM IL",5,1,0,1,0,1,-88.54359436,39.12008667
225,"EL CERRITO CA",5,5,3,0,2,5,-122.3142548,37.91544342
225,"EL LAGO TX",5,3,1,1,1,3,-95.04547119,29.56394196
225,"EL MONTE CA",5,7,0,3,4,7,-118.0298996,34.06880569
225,"EL PASO TX",5,25,10,4,11,25,-106.4620514,31.78388405
225,"EL SEGUNDO CA",5,1,0,0,1,1,-118.4185257,33.91943741
225,"ELGIN IL",5,2,1,0,1,2,-88.28123474,42.03733444
225,"ELIZABETH CITY NC",5,1,0,1,0,1,-76.22274017,36.3025322
225,"ELIZABETHTON TN",5,6,1,0,5,6,-82.21013641,36.34902954
225,"ELIZABETHTOWN PA",5,1,0,0,1,1,-76.60209656,40.15314865
225,"ELK GROVE CA",5,46,10,12,24,46,-121.3743591,38.40848923
225,"ELMHURST IL",5,1,0,1,0,1,-87.9407196,41.89970398
225,"ELMIRA NY",5,3,0,1,2,3,-76.80737305,42.08998108
225,"ELSBERRY MO",5,1,0,0,1,1,-90.78118896,39.16703796
225,"ENCINITAS CA",5,2,0,0,2,2,-117.2937012,33.0371666
225,"ENFIELD NH",5,1,1,0,0,1,-72.14303589,43.65077209
225,"ENGLEWOOD NJ",5,2,1,1,0,2,-73.97172546,40.8928833
225,"ENTERPRISE AL",5,1,0,1,0,1,-85.85494995,31.31528282
225,"EPHRAIM WI",5,2,0,2,0,2,-87.16837311,45.15630341
225,"EPHRATA PA",5,1,0,0,1,1,-76.17801666,40.17980194
225,"ERIE PA",5,13,1,2,10,13,-80.08492279,42.12926483
225,"ERLANGER KY",5,1,0,0,1,1,-84.60089111,39.01673508
225,"ERWIN TN",5,1,0,0,1,1,-82.41162109,36.15189362
225,"ESCONDIDO CA",5,3,0,2,1,3,-117.0886231,33.11952591
225,"EUGENE OR",5,33,15,8,10,33,-123.0898361,44.05194855
225,"EULESS TX",5,1,0,0,1,1,-97.08273315,32.83728409
225,"EVANS CITY PA",5,1,0,0,1,1,-80.06215668,40.76942062
225,"EVANSTON IL",5,13,2,4,7,13,-87.69037628,42.04132843
225,"EVANSTON WY",5,1,0,1,0,1,-110.9652634,41.26803589
225,"EVANSVILLE IN",5,17,4,6,7,17,-87.56850433,37.97795486
225,"EVERETT MA",5,5,2,3,0,5,-71.05252075,42.40878296
225,"EVERETT WA",5,4,0,1,3,4,-122.2045441,47.97843552
225,"EVERMAN TX",5,1,0,0,1,1,-97.28966522,32.63102341
225,"FAIR HAVEN NJ",5,2,0,1,1,2,-74.03659821,40.35977936
225,"FAIRBANKS AK",5,2,1,0,1,2,-147.7185669,64.83367157
225,"FAIRBORN OH",5,1,0,0,1,1,-84.01902771,39.82121658
225,"FAIRFAX VA",5,7,1,1,5,7,-77.30588531,38.84661865
225,"FAIRFIELD CA",5,2,1,1,0,2,-122.0420914,38.24917603
225,"FAIRMONT CITY IL",5,1,0,0,1,1,-90.09365845,38.65008545
225,"FALLS CHURCH VA",5,2,0,2,0,2,-77.17056274,38.88268661
225,"FARGO ND",5,4,1,0,3,4,-96.79805756,46.87498474
225,"FARMINGTON HILLS MI",5,2,1,1,0,2,-83.3771286,42.48558807
225,"FARMINGTON MI",5,3,0,0,3,3,-83.37620544,42.46465302
225,"FARMINGTON MO",5,1,0,0,1,1,-90.4220047,37.78110504
225,"FARMINGTON NH",5,2,2,0,0,2,-71.07139587,43.38951111
225,"FARMVILLE VA",5,1,0,0,1,1,-78.39121246,37.30234909
225,"FAYETTEVILLE AR",5,5,1,2,2,5,-94.15759277,36.06256104
225,"FAYETTEVILLE NC",5,3,1,0,2,3,-78.87771606,35.05313873
225,"FAYETTEVILLE NY",5,1,1,0,0,1,-76.0059433,43.02997971
225,"FEDERAL WAY WA",5,10,4,2,4,10,-122.314415,47.32177734
225,"FENTON MO",5,19,9,8,2,19,-90.43593597,38.51305771
225,"FERGUSON MO",5,74,25,12,37,74,-90.306633,38.74429321
225,"FERNDALE MI",5,7,1,4,2,7,-83.13441467,42.46089172
225,"FESTUS MO",5,6,3,1,2,6,-90.39609528,38.22088623
225,"FILLMORE CA",5,1,1,0,0,1,-118.919754,34.39930344
225,"FISHERS IN",5,6,0,2,4,6,-86.0140152,39.95565414
225,"FITCHBURG WI",5,1,0,0,1,1,-89.47031403,42.96075439
225,"FLAGSTAFF AZ",5,6,0,0,6,6,-111.6533051,35.19802475
225,"FLINT MI",5,14,3,2,9,14,-83.68744659,43.01246643
225,"FLORENCE AL",5,2,1,0,1,2,-87.67726898,34.7997818
225,"FLORENCE SC",5,3,1,0,2,3,-79.76351166,34.19935226
225,"FLORISSANT MO",5,69,22,14,33,69,-90.32299042,38.78946304
225,"FLOSSMOOR IL",5,1,0,0,1,1,-87.68474579,41.54309845
225,"FOND DU LAC WI",5,1,1,0,0,1,-88.44734955,43.77285004
225,"FONTANA CA",5,1,0,0,1,1,-117.4363785,34.09202576
225,"FOREST PARK IL",5,2,0,2,0,2,-87.81355286,41.87948608
225,"FORREST CITY AR",5,1,0,1,0,1,-90.79021454,35.00848389
225,"FORT ATKINSON WI",5,1,0,1,0,1,-88.83695984,42.92907715
225,"FORT COLLINS CO",5,18,2,7,9,18,-105.0858688,40.58546066
225,"FORT LAUDERDALE FL",5,30,10,3,17,30,-80.14283752,26.12309074
225,"FORT LUPTON CO",5,1,0,1,0,1,-104.8086929,40.07614517
225,"FORT MYERS FL",5,17,2,8,7,17,-81.87184143,26.64133644
225,"FORT SCOTT KS",5,1,0,1,0,1,-94.70889282,37.83989716
225,"FORT SMITH AR",5,1,1,0,0,1,-94.39919281,35.3862114
225,"FORT WALTON BEACH FL",5,1,0,0,1,1,-86.61834717,30.40767479
225,"FORT WAYNE IN",5,32,7,9,16,32,-85.13967896,41.07278061
225,"FORT WORTH TX",5,287,74,78,135,287,-97.32135773,32.72562027
225,"FOSTER CITY CA",5,1,1,0,0,1,-122.2733917,37.55817413
225,"FRANKFORT KY",5,3,0,2,1,3,-84.87322235,38.20124054
225,"FRANKLIN LA",5,6,2,3,1,6,-91.50192261,29.79652786
225,"FRANKLIN TN",5,1,1,0,0,1,-86.87760162,35.92164993
225,"FREDERICK MD",5,13,7,5,1,13,-77.40981293,39.41444397
225,"FREDERICKSBURG VA",5,4,1,1,2,4,-77.45996094,38.30348969
225,"FREDERICKTOWN MO",5,2,2,0,0,2,-90.29403687,37.5598793
225,"FREEPORT IL",5,3,1,1,1,3,-89.62126923,42.29691696
225,"FREMONT CA",5,6,3,0,3,6,-121.9740372,37.55101776
225,"FREMONT NE",5,1,0,0,1,1,-96.49893188,41.43340683
225,"FRESNO CA",5,15,5,6,4,15,-119.7739868,36.74755478
225,"FRIENDSWOOD TX",5,1,0,0,1,1,-95.20127106,29.53010368
225,"FRISCO CO",5,1,1,0,0,1,-106.0990143,39.57444763
225,"FRISCO TX",5,12,4,3,5,12,-96.82434082,33.15098572
225,"FULLERTON CA",5,5,0,3,2,5,-117.9268646,33.87014771
225,"GADSDEN AL",5,1,0,0,1,1,-86.00675201,34.01457596
225,"GAINESVILLE FL",5,20,6,5,9,20,-82.32462311,29.65203285
225,"GAINESVILLE GA",5,18,6,6,6,18,-83.82389832,34.29787827
225,"GAITHERSBURG MD",5,7,0,5,2,7,-77.20072174,39.14352417
225,"GALESBURG IL",5,9,2,3,4,9,-90.37152863,40.9480629
225,"GARDEN GROVE CA",5,1,1,0,0,1,-117.943718,33.77397156
225,"GARDENA CA",5,1,0,1,0,1,-118.3105164,33.88837814
225,"GARDNER KS",5,1,0,0,1,1,-94.92789459,38.81066132
225,"GARLAND TX",5,5,1,3,1,5,-96.63926697,32.91297531
225,"GARNER NC",5,2,0,0,2,2,-78.61359406,35.71166992
225,"GARY IN",5,4,3,0,1,4,-87.33873749,41.59325409
225,"GENEVA NY",5,2,0,1,1,2,-76.97723389,42.86890793
225,"GEORGETOWN KY",5,2,0,0,2,2,-84.55860138,38.21012115
225,"GEORGETOWN SC",5,1,0,0,1,1,-79.28886414,33.37522888
225,"GEORGETOWN TX",5,4,1,2,1,4,-97.67801666,30.6329689
225,"GIG HARBOR WA",5,15,4,10,1,15,-122.590683,47.32983398
225,"GILBERT AZ",5,9,1,1,7,9,-111.7899933,33.35302353
225,"GILLESPIE IL",5,1,1,0,0,1,-89.81998444,39.12971115
225,"GILROY CA",5,1,0,1,0,1,-121.570343,37.00583267
225,"GLADSTONE MO",5,4,2,0,2,4,-94.55509186,39.20398331
225,"GLASGOW KY",5,7,3,2,2,7,-85.91189575,36.99584961
225,"GLASSBORO NJ",5,3,1,1,1,3,-75.11103058,39.70306778
225,"GLENDALE AZ",5,2,0,1,1,2,-112.1871796,33.5386467
225,"GLENDALE CA",5,31,7,13,11,31,-118.2566681,34.1423645
225,"GLENS FALLS NY",5,1,0,1,0,1,-73.64286041,43.30945969
225,"GLOUCESTER CITY NJ",5,1,0,0,1,1,-75.11563873,39.89209747
225,"GLOUCESTER MA",5,1,0,1,0,1,-70.66117096,42.61589432
225,"GODFREY IL",5,1,0,0,1,1,-90.18669891,38.95780182
225,"GOLDEN CO",5,1,0,0,1,1,-105.2226791,39.75567627
225,"GOODRICH TX",5,2,0,2,0,2,-94.9467926,30.60574341
225,"GRAMBLING LA",5,1,0,0,1,1,-92.71523285,32.52869415
225,"GRAND BLANC MI",5,1,0,1,0,1,-83.62955475,42.92750168
225,"GRAND FORKS ND",5,7,2,1,4,7,-97.03855133,47.92044067
225,"GRAND HAVEN MI",5,2,0,2,0,2,-86.22866058,43.06328964
225,"GRAND JUNCTION CO",5,2,1,1,0,2,-108.5520706,39.06374741
225,"GRAND PRAIRIE TX",5,2,0,1,1,2,-96.99823761,32.74625015
225,"GRAND RAPIDS MI",5,30,6,8,16,30,-85.66797638,42.96317291
225,"GRANITE CITY IL",5,20,7,4,9,20,-90.14891815,38.70147705
225,"GRANITE FALLS NC",5,4,2,2,0,4,-81.43023682,35.79683304
225,"GRAPEVINE TX",5,4,3,1,0,4,-97.07859802,32.93464279
225,"GRAYSON KY",5,1,0,1,0,1,-82.94855499,38.33277512
225,"GREAT BARRINGTON MA",5,1,1,0,0,1,-73.36142731,42.19623566
225,"GREAT BEND KS",5,2,0,1,1,2,-98.76521301,38.36428452
225,"GREAT NECK NY",5,1,1,0,0,1,-73.72780609,40.80078125
225,"GREELEY CO",5,5,0,2,3,5,-104.7104645,40.42345047
225,"GREEN BAY WI",5,22,3,8,11,22,-88.01370239,44.51335907
225,"GREENBELT MD",5,14,2,4,8,14,-76.87561035,39.00544357
225,"GREENSBORO NC",5,60,19,15,26,60,-79.79152679,36.0729599
225,"GREENSBURG IN",5,2,0,1,1,2,-85.48336792,39.33731842
225,"GREENVILLE IL",5,1,0,0,1,1,-89.41333008,38.89213562
225,"GREENVILLE NC",5,3,2,1,0,3,-77.37215424,35.61170959
225,"GREENVILLE SC",5,77,19,30,28,77,-82.39870453,34.84753418
225,"GREENWICH CT",5,2,1,1,0,2,-73.62783051,41.02645111
225,"GREENWOOD IN",5,3,1,0,2,3,-86.10647583,39.61371994
225,"GREENWOOD SC",5,1,0,0,1,1,-82.16146088,34.19546509
225,"GRESHAM OR",5,4,0,2,2,4,-122.4333954,45.4980278
225,"GRETNA LA",5,1,0,1,0,1,-90.05435181,29.91518021
225,"GRINNELL IA",5,3,0,1,2,3,-92.72964478,41.7466507
225,"GROTON CT",5,1,1,0,0,1,-72.07763672,41.3502121
225,"GULF SHORES AL",5,3,1,2,0,3,-87.70103455,30.24625969
225,"GULFPORT FL",5,1,0,0,1,1,-82.70953369,27.74733734
225,"GULFPORT MS",5,2,1,0,1,2,-89.09369659,30.37276649
225,"GUSTINE CA",5,1,1,0,0,1,-121.001297,37.25769043
225,"GUTHRIE OK",5,1,0,1,0,1,-97.42609406,35.87893677
225,"GYPSUM CO",5,2,0,1,1,2,-106.9528198,39.64703369
225,"HADDONFIELD NJ",5,6,2,3,1,6,-75.03710937,39.89155197
225,"HAGERSTOWN IN",5,1,0,1,0,1,-85.16162872,39.91140747
225,"HAGERSTOWN MD",5,1,0,1,0,1,-77.71956635,39.641819
225,"HALF MOON BAY CA",5,3,2,1,0,3,-122.4299774,37.46336365
225,"HALLSTEAD PA",5,8,5,2,1,8,-75.74239349,41.96153259
225,"HAMILTON NJ",5,1,0,0,1,1,-74.0803299,40.20712662
225,"HAMILTON OH",5,2,0,1,1,2,-84.56098175,39.39949799
225,"HAMMOND IN",5,1,1,0,0,1,-87.50006104,41.58346558
225,"HAMMOND LA",5,2,1,0,1,2,-90.46140289,30.50458908
225,"HAMMONTON NJ",5,1,1,0,0,1,-74.801651,39.63666153
225,"HAMPTON GA",5,1,0,0,1,1,-84.28277588,33.3870697
225,"HAMPTON VA",5,24,5,10,9,24,-76.34473419,37.03002548
225,"HANOVER PARK IL",5,1,0,0,1,1,-88.14541626,41.99964905
225,"HARBOR SPRINGS MI",5,1,0,1,0,1,-84.99181366,45.43172455
225,"HARKER HEIGHTS TX",5,10,3,2,5,10,-97.66394806,31.08788109
225,"HARLINGEN TX",5,12,1,6,5,12,-97.69669342,26.19152069
225,"HARRISBURG PA",5,16,4,5,7,16,-76.88382721,40.27407455
225,"HARRISONBURG VA",5,13,4,1,8,13,-78.86815643,38.44975281
225,"HARTFORD CT",5,47,13,13,21,47,-72.68445587,41.76383591
225,"HARTSVILLE SC",5,1,0,0,1,1,-80.07303619,34.37445068
225,"HASTINGS-ON-HUDSON NY",5,3,2,1,0,3,-73.87804413,41.00286102
225,"HATTIESBURG MS",5,1,0,1,0,1,-89.29040527,31.32738686
225,"HAVANA FL",5,1,0,0,1,1,-84.41448975,30.62413788
225,"HAVERFORD PA",5,2,0,0,2,2,-75.29338837,40.01327896
225,"HAWTHORNE CA",5,1,0,1,0,1,-118.3549194,33.91656113
225,"HAYDEN ID",5,3,1,1,1,3,-116.7890625,47.76594925
225,"HAYWARD CA",5,8,1,2,5,8,-122.0832672,37.66890335
225,"HAYWARD WI",5,1,1,0,0,1,-91.48522949,46.01277161
225,"HAZELWOOD MO",5,1,1,0,0,1,-90.37133789,38.77171707
225,"HEADLAND AL",5,1,0,1,0,1,-85.34181213,31.35177422
225,"HEALDSBURG CA",5,1,1,0,0,1,-122.8713226,38.6101799
225,"HEARNE TX",5,1,0,0,1,1,-96.59375763,30.87876701
225,"HEBRON IN",5,3,0,1,2,3,-87.20029449,41.31857681
225,"HELENA MT",5,11,2,3,6,11,-112.0374527,46.59269333
225,"HELOTES TX",5,4,1,2,1,4,-98.69043732,29.57864761
225,"HEMPSTEAD NY",5,2,1,1,0,2,-73.61798096,40.70619965
225,"HENDERSON NC",5,2,1,0,1,2,-78.39831543,36.3300705
225,"HENDERSON NV",5,20,8,5,7,20,-114.9741058,36.03540421
225,"HENDERSON TN",5,1,0,1,0,1,-88.64147949,35.43937683
225,"HENDERSONVILLE NC",5,11,1,1,9,11,-82.46079254,35.31912994
225,"HENDERSONVILLE TN",5,1,0,1,0,1,-86.61997986,36.30472565
225,"HEPHZIBAH GA",5,2,0,1,1,2,-82.0966568,33.31433105
225,"HERCULES CA",5,1,0,1,0,1,-122.2900772,38.01711655
225,"HERMANN MO",5,3,2,0,1,3,-91.43791199,38.70432281
225,"HERMISTON OR",5,1,0,1,0,1,-119.2915268,45.84025192
225,"HERMOSA BEACH CA",5,1,1,0,0,1,-118.401619,33.86245728
225,"HERNANDO MS",5,1,0,0,1,1,-89.99411774,34.82405853
225,"HERNDON VA",5,2,0,0,2,2,-77.38563538,38.96995544
225,"HIALEAH FL",5,3,2,1,0,3,-80.27757263,25.85853386
225,"HIGHLAND BEACH FL",5,1,0,1,0,1,-80.06530762,26.40010643
225,"HIGHLAND CA",5,4,0,2,2,4,-117.2105789,34.12824631
225,"HIGHLAND PARK IL",5,2,0,1,1,2,-87.80068207,42.18181992
225,"HIGHWOOD IL",5,1,0,0,1,1,-87.80953979,42.19964218
225,"HILLSBORO OR",5,8,1,2,5,8,-122.9927826,45.52270508
225,"HILTON HEAD ISLAND SC",5,1,0,0,1,1,-80.75251007,32.21665573
225,"HOBOKEN NJ",5,13,6,1,6,13,-74.0316925,40.7443428
225,"HOKES BLUFF AL",5,1,0,0,1,1,-85.86613464,33.99843979
225,"HOLLAND MI",5,1,0,0,1,1,-86.10916138,42.78744507
225,"HOLLY SPRINGS MS",5,2,1,1,0,2,-89.44177246,34.77593994
225,"HOLLYWOOD FL",5,15,5,7,3,15,-80.14926147,26.01175499
225,"HOLMDEL NJ",5,2,0,0,2,2,-74.18328857,40.34526443
225,"HOLYOKE MA",5,3,1,1,1,3,-72.61522675,42.20437241
225,"HOMESTEAD FL",5,4,0,4,0,4,-80.47710419,25.46927071
225,"HOOD RIVER OR",5,4,2,2,0,4,-121.5108719,45.70785141
225,"HOT SPRINGS AR",5,7,2,5,0,7,-93.05556488,34.5039978
225,"HOUGHTON MI",5,1,0,0,1,1,-88.56951141,47.12665558
225,"HOUMA LA",5,1,0,1,0,1,-90.71982574,29.59630585
225,"HOUSTON TX",5,744,203,205,336,744,-95.36399841,29.76376343
225,"HUDSON NY",5,1,1,0,0,1,-73.7900238,42.25299454
225,"HUDSONVILLE MI",5,1,0,0,1,1,-85.86483002,42.87105942
225,"HUMBLE TX",5,7,3,3,1,7,-95.26166534,29.99774551
225,"HUNTERSVILLE NC",5,5,1,2,2,5,-80.83785248,35.41359711
225,"HUNTINGTON BEACH CA",5,9,5,2,2,9,-118.0006027,33.66012955
225,"HUNTINGTON WV",5,12,2,5,5,12,-82.44620514,38.4181366
225,"HUNTSVILLE AL",5,43,16,14,13,43,-86.58609772,34.73073959
225,"HUNTSVILLE TX",5,2,0,0,2,2,-95.55122375,30.72374153
225,"HUNTSVILLE UT",5,1,0,0,1,1,-111.7737732,41.26464844
225,"HURRICANE UT",5,1,0,0,1,1,-113.2914887,37.17508316
225,"HURST TX",5,1,1,0,0,1,-97.17115021,32.82357407
225,"HUTCHINSON KS",5,3,0,1,2,3,-97.93050385,38.06093216
225,"HYATTSVILLE MD",5,210,1,160,49,210,-76.94467163,38.95636749
225,"IDA LA",5,2,0,2,0,2,-93.89510345,33.00457001
225,"IMPERIAL CA",5,2,0,1,1,2,-115.5716705,32.84782791
225,"INDEPENDENCE MO",5,9,5,2,2,9,-94.41611481,39.09104538
225,"INDIAN TRAIL NC",5,6,4,0,2,6,-80.66901398,35.07696915
225,"INDIANAPOLIS IN",5,83,27,27,29,83,-86.15828705,39.76844788
225,"INDIO CA",5,4,0,0,4,4,-116.2173004,33.72047043
225,"INGLEWOOD CA",5,29,5,5,19,29,-118.354805,33.96157074
225,"INVER GROVE HEIGHTS MN",5,1,0,0,1,1,-93.02364349,44.85364151
225,"IOWA CITY IA",5,15,6,5,4,15,-91.53023529,41.66130066
225,"IRON RIDGE WI",5,1,0,0,1,1,-88.53308105,43.39979553
225,"IRVINE CA",5,13,2,9,2,13,-117.8243942,33.66952515
225,"IRVING TX",5,7,0,3,4,7,-96.94924927,32.81419754
225,"ISLAND LAKE IL",5,2,0,1,1,2,-88.19213104,42.27630615
225,"ISSAQUAH WA",5,1,0,1,0,1,-122.0345993,47.52977753
225,"ITHACA NY",5,12,2,6,4,12,-76.49575043,42.44075775
225,"JACKSON MI",5,1,0,0,1,1,-84.40149689,42.24575043
225,"JACKSON MS",5,33,8,6,19,33,-90.19654846,32.298172
225,"JACKSON TN",5,21,3,6,12,21,-88.81397247,35.61472321
225,"JACKSONVILLE AL",5,1,0,0,1,1,-85.76148987,33.81370163
225,"JACKSONVILLE AR",5,3,1,2,0,3,-92.11023712,34.86617279
225,"JACKSONVILLE BEACH FL",5,8,3,2,3,8,-81.39300537,30.29505539
225,"JACKSONVILLE FL",5,91,19,32,40,91,-81.65545654,30.33253288
225,"JACKSONVILLE NC",5,3,3,0,0,3,-77.42939758,34.75283813
225,"JANESVILLE WI",5,13,5,2,6,13,-89.01893616,42.68303299
225,"JAY FL",5,6,1,2,3,6,-87.15126801,30.95347977
225,"JEFFERSON CITY MO",5,15,4,4,7,15,-92.17385864,38.57698441
225,"JERSEY CITY NJ",5,34,7,15,12,34,-74.07667542,40.72816849
225,"JERSEYVILLE IL",5,2,1,0,1,2,-90.32881165,39.12010956
225,"JOHNSON CITY TN",5,6,1,2,3,6,-82.35308075,36.31352615
225,"JOLIET IL",5,11,5,2,4,11,-88.08213043,41.52493668
225,"JONESBORO AR",5,10,0,4,6,10,-90.70430756,35.84226608
225,"JOPLIN MO",5,3,1,1,1,3,-94.5140686,37.08442688
225,"JUPITER FL",5,4,2,0,2,4,-80.09382629,26.9349556
225,"KALAMAZOO MI",5,24,5,10,9,24,-85.58725739,42.29179764
225,"KALISPELL MT",5,4,1,2,1,4,-114.3166199,48.20161438
225,"KANSAS CITY KS",5,2,1,0,1,2,-94.62808228,39.1141777
225,"KANSAS CITY MO",5,419,121,122,176,419,-94.57884979,39.09976578
225,"KATY TX",5,11,1,5,5,11,-95.82484436,29.78606224
225,"KEARNEY NE",5,1,0,1,0,1,-99.08208466,40.69932938
225,"KEIZER OR",5,1,0,0,1,1,-123.0285339,44.98967743
225,"KELLER TX",5,1,0,1,0,1,-97.25247192,32.93486786
225,"KENNER LA",5,1,0,1,0,1,-90.24167633,29.99442101
225,"KENNESAW GA",5,5,0,4,1,5,-84.61528015,34.02365875
225,"KENNEWICK WA",5,4,1,1,2,4,-119.1395264,46.2107811
225,"KENSINGTON MD",5,1,0,0,1,1,-77.07564545,39.02577972
225,"KENT OH",5,6,3,1,2,6,-81.35736084,41.15368271
225,"KENT WA",5,21,7,6,8,21,-122.2377701,47.38068008
225,"KENTWOOD MI",5,2,0,1,1,2,-85.64472198,42.86936569
225,"KERMAN CA",5,2,0,0,2,2,-120.0621414,36.723423
225,"KETCHIKAN AK",5,2,1,0,1,2,-131.6417084,55.34326935
225,"KEY WEST FL",5,9,5,1,3,9,-81.78218079,24.556427
225,"KILLEEN TX",5,4,1,2,1,4,-97.72832489,31.11753464
225,"KINGSPORT TN",5,1,1,0,0,1,-82.56182861,36.54841232
225,"KINGSTON NY",5,1,1,0,0,1,-73.99665833,41.92714691
225,"KINLOCH MO",5,6,2,1,3,6,-90.32682037,38.74011612
225,"KIRKLAND WA",5,10,3,4,3,10,-122.2108688,47.6813736
225,"KIRKSVILLE MO",5,1,0,0,1,1,-92.58364105,40.19476318
225,"KIRKWOOD MO",5,29,9,11,9,29,-90.40686798,38.5832901
225,"KISSIMMEE FL",5,6,1,5,0,6,-81.40729523,28.29271317
225,"KITTY HAWK NC",5,2,0,2,0,2,-75.70478058,36.06485367
225,"KLAMATH FALLS OR",5,1,1,0,0,1,-121.7844772,42.2244873
225,"KNOXVILLE TN",5,47,2,21,24,47,-83.92067719,35.96077728
225,"KOKOMO IN",5,3,1,0,2,3,-86.12706757,40.48566818
225,"KUTZTOWN PA",5,1,1,0,0,1,-75.77677917,40.51739502
225,"KYLE TX",5,2,1,1,0,2,-97.87797546,29.9895649
225,"LA CROSSE WI",5,4,2,1,1,4,-91.23967743,43.80151367
225,"LA MESA CA",5,1,0,0,1,1,-117.0447464,32.76841354
225,"LA PINE OR",5,1,0,1,0,1,-121.5054627,43.67027664
225,"LA VERGNE TN",5,2,0,2,0,2,-86.58178711,36.01600266
225,"LA VERNE CA",5,3,0,2,1,3,-117.7696304,34.1006546
225,"LACEY WA",5,5,1,1,3,5,-122.8096161,47.03732681
225,"LACONIA NH",5,4,1,0,1,2,-71.46888733,43.52740097
225,"LADY LAKE FL",5,1,0,0,1,1,-81.92842865,28.92837715
225,"LAFAYETTE CA",5,1,1,0,0,1,-122.1200104,37.88574982
225,"LAFAYETTE CO",5,1,0,1,0,1,-105.0904388,39.99370956
225,"LAFAYETTE IN",5,3,1,1,1,3,-86.88406372,40.42077255
225,"LAFAYETTE LA",5,33,11,8,14,33,-92.01987457,30.22468185
225,"LAFAYETTE OR",5,1,0,0,1,1,-123.1177979,45.24378967
225,"LAGUNA BEACH CA",5,7,3,1,3,7,-117.7847061,33.54205322
225,"LAKE CHARLES LA",5,2,0,1,1,2,-93.21766663,30.22713852
225,"LAKE HAVASU CITY AZ",5,2,2,0,0,2,-114.3244324,34.48379517
225,"LAKE OSWEGO OR",5,1,0,0,1,1,-122.6727066,45.42033005
225,"LAKE STEVENS WA",5,1,0,0,1,1,-122.0684662,48.01782227
225,"LAKE WORTH FL",5,1,0,0,1,1,-80.05649567,26.61662102
225,"LAKELAND FL",5,3,0,1,2,3,-81.95620728,28.04432487
225,"LAKEMOOR IL",5,1,0,0,1,1,-88.19921875,42.32862854
225,"LAKEWOOD CA",5,3,2,1,0,3,-118.1357193,33.85370636
225,"LAKEWOOD CO",5,2,0,0,2,2,-105.0827332,39.70486069
225,"LAKEWOOD NJ",5,1,0,1,0,1,-74.21684265,40.09822845
225,"LAKEWOOD OH",5,10,2,4,4,10,-81.79773712,41.48223114
225,"LAMBERTVILLE NJ",5,1,1,0,0,1,-74.94231415,40.36618423
225,"LANCASTER CA",5,1,1,0,0,1,-118.1386871,34.69804001
225,"LANCASTER OH",5,1,1,0,0,1,-82.59890747,39.71387482
225,"LANCASTER PA",5,6,1,2,3,6,-76.30498505,40.03824234
225,"LANDOVER HILLS MD",5,1,0,1,0,1,-76.89152527,38.94342804
225,"LANSDOWNE PA",5,4,1,0,3,4,-75.27108765,39.93852234
225,"LANSING MI",5,21,7,4,10,21,-84.55532074,42.73265839
225,"LAPEER MI",5,1,1,0,0,1,-83.31890869,43.05135345
225,"LARAMIE WY",5,1,0,1,0,1,-105.592804,41.3115387
225,"LAREDO TX",5,4,0,1,3,4,-99.50824738,27.50720978
225,"LARGO FL",5,23,3,11,9,23,-82.78675079,27.91026115
225,"LAS CRUCES NM",5,2,0,2,0,2,-106.7798538,32.31209564
225,"LAS VEGAS NV",5,240,56,84,100,240,-115.1382141,36.17488098
225,"LATROBE PA",5,1,0,1,0,1,-79.37892914,40.32139206
225,"LAUDERDALE LAKES FL",5,2,1,0,1,2,-80.20793915,26.1671524
225,"LAWRENCE KS",5,57,16,17,24,57,-95.23565674,38.97153091
225,"LAWRENCEVILLE GA",5,4,1,2,1,4,-83.98753357,33.95662308
225,"LAWTON OK",5,1,0,1,0,1,-98.39124298,34.60861969
225,"LEAGUE CITY TX",5,2,2,0,0,2,-95.09550476,29.50793457
225,"LEANDER TX",5,2,1,1,0,2,-97.85368347,30.57936287
225,"LEAVENWORTH KS",5,1,0,0,1,1,-94.92282867,39.31124115
225,"LEBANON IN",5,1,0,1,0,1,-86.46936035,40.0486412
225,"LEBANON NH",5,1,0,0,1,1,-72.251091,43.64245987
225,"LEBANON PA",5,2,1,0,1,2,-76.41091156,40.34118652
225,"LEESBURG VA",5,2,0,1,1,2,-77.56890869,39.11256027
225,"LENEXA KS",5,3,0,1,2,3,-94.73374176,38.95368576
225,"LEWES DE",5,3,1,2,0,3,-75.1359024,38.77365494
225,"LEWISVILLE TX",5,1,0,1,0,1,-96.99449921,33.04630661
225,"LEXINGTON MA",5,3,2,0,1,3,-71.22381592,42.44742584
225,"LEXINGTON SC",5,1,0,1,0,1,-81.23597717,33.98204041
225,"LEXINGTON VA",5,2,1,0,1,2,-79.4422226,37.78420639
225,"LIBERTY MO",5,6,2,1,3,6,-94.4196167,39.24604034
225,"LICKING MO",5,8,0,6,2,8,-91.85713959,37.49972916
225,"LILLINGTON NC",5,2,0,1,1,2,-78.81506348,35.39981079
225,"LIMA OH",5,3,2,0,1,3,-84.10490417,40.74259186
225,"LINCOLN NE",5,14,4,2,8,14,-96.6674118,40.80001068
225,"LINDALE TX",5,2,0,1,1,2,-95.40984344,32.51585007
225,"LITTLE ROCK AR",5,17,4,7,6,17,-92.28178406,34.7369194
225,"LITTLETON CO",5,4,1,2,1,4,-105.0176163,39.6132431
225,"LIVE OAK FL",5,3,0,3,0,3,-82.98397064,30.29559708
225,"LIVERMORE CA",5,1,0,1,0,1,-121.7701416,37.68147659
225,"LIVINGSTON MT",5,1,1,0,0,1,-110.5622253,45.66219711
225,"LIVINGSTON TX",5,2,0,0,2,2,-94.93333435,30.71132088
225,"LIVONIA MI",5,3,0,1,2,3,-83.35256958,42.36862564
225,"LODI CA",5,1,1,0,0,1,-121.2742386,38.12984467
225,"LOGAN UT",5,1,1,0,0,1,-111.8171616,41.73900604
225,"LOGANSPORT IN",5,1,0,1,0,1,-86.36410522,40.75329208
225,"LOGANVILLE GA",5,2,0,1,1,2,-83.90035248,33.83914948
225,"LOMBARD IL",5,1,0,0,1,1,-88.00775909,41.8800621
225,"LOMIRA WI",5,22,4,9,9,22,-88.44380188,43.59117126
225,"LONG BEACH CA",5,43,10,17,16,43,-118.1908112,33.7670517
225,"LONG BEACH NY",5,1,0,1,0,1,-73.6654129,40.58349991
225,"LONGMEADOW MA",5,2,1,0,1,2,-72.5818634,42.05022812
225,"LONGMONT CO",5,1,1,0,0,1,-105.1026764,40.16700745
225,"LONGVIEW WA",5,1,1,0,0,1,-122.9404221,46.1375885
225,"LOS ALTOS CA",5,1,1,0,0,1,-122.1163025,37.38525772
225,"LOS ANGELES CA",5,1154,310,322,522,1154,-118.2459106,34.05225754
225,"LOS GATOS CA",5,2,2,0,0,2,-121.9771652,37.22674561
225,"LOUISA KY",5,1,0,0,1,1,-82.60322571,38.11429596
225,"LOUISA VA",5,1,0,0,1,1,-78.00349426,38.0253067
225,"LOVELAND CO",5,2,2,0,0,2,-105.0755997,40.39763641
225,"LOWELL IN",5,2,1,0,1,2,-87.42073059,41.29130173
225,"LOWELL MA",5,3,1,1,1,3,-71.31530762,42.63344574
225,"LUBBOCK TX",5,6,3,1,2,6,-101.8544312,33.59677505
225,"LYNCHBURG VA",5,2,0,0,2,2,-79.14174652,37.41383362
225,"LYNDEN WA",5,6,2,2,2,6,-122.455101,48.94639969
225,"LYNN MA",5,1,0,1,0,1,-70.94833374,42.46699905
225,"LYNNWOOD WA",5,4,0,2,2,4,-122.3175736,47.82042313
225,"LYNWOOD CA",5,5,1,2,2,5,-118.2135544,33.93053055
225,"LYNWOOD IL",5,1,1,0,0,1,-87.53853607,41.52642059
225,"MADELIA MN",5,2,0,2,0,2,-94.42191315,44.05470276
225,"MADISON AL",5,4,2,0,0,2,-86.487213135,33.561834335
225,"MADISON IL",5,2,2,0,0,2,-90.15700531,38.68284988
225,"MADISON MS",5,3,0,0,3,3,-90.11543274,32.46231079
225,"MADISON WI",5,73,17,25,31,73,-89.40128326,43.07303619
225,"MALDEN MA",5,1,0,1,0,1,-71.06546783,42.42518234
225,"MALDEN MO",5,2,1,1,0,2,-89.96641541,36.55708313
225,"MANASSAS VA",5,1,1,0,0,1,-77.47459412,38.75112534
225,"MANCHESTER MO",5,1,1,0,0,1,-90.50953674,38.597229
225,"MANCHESTER NH",5,9,3,2,4,9,-71.45406342,42.99581528
225,"MANHATTAN BEACH CA",5,1,0,0,1,1,-118.4129181,33.88484192
225,"MANHATTAN KS",5,6,2,1,3,6,-96.57228851,39.18354034
225,"MANKATO MN",5,5,0,2,3,5,-94.02125549,44.15895462
225,"MANNING SC",5,28,6,12,10,28,-80.21025085,33.69546509
225,"MANOR TX",5,1,0,0,1,1,-97.55760193,30.34129524
225,"MANSFIELD AR",5,1,1,0,0,1,-94.2530365,35.05989456
225,"MANSFIELD OH",5,1,0,0,1,1,-82.51545715,40.75864792
225,"MANSFIELD TX",5,1,1,0,0,1,-97.14230347,32.56362152
225,"MANTECA CA",5,1,0,0,1,1,-121.2179031,37.79747391
225,"MAPLE SHADE NJ",5,8,2,3,3,8,-74.9913559,39.95294571
225,"MAPLEWOOD MO",5,12,7,2,3,12,-90.32471466,38.6126976
225,"MAPLEWOOD NJ",5,4,2,1,1,4,-74.27243805,40.77401733
225,"MAQUOKETA IA",5,3,1,0,2,3,-90.66600037,42.06900024
225,"MARICOPA AZ",5,1,0,1,0,1,-112.0491562,33.05832672
225,"MARIETTA GA",5,6,1,0,5,6,-84.54958344,33.9527359
225,"MARINGOUIN LA",5,1,0,0,1,1,-91.51993561,30.49166107
225,"MARION AR",5,1,1,0,0,1,-90.19646454,35.21472931
225,"MARION IA",5,4,1,3,0,4,-91.60752869,42.032547
225,"MARION IL",5,3,0,2,1,3,-88.93344116,37.73056412
225,"MARION OH",5,1,0,0,1,1,-83.12861633,40.58881378
225,"MARION VA",5,1,0,0,1,1,-81.51425934,36.83526993
225,"MARISSA IL",5,1,1,0,0,1,-89.7505188,38.25014496
225,"MARKHAM IL",5,1,0,1,0,1,-87.69510651,41.59363937
225,"MARKS MS",5,1,0,1,0,1,-90.27207947,34.25684357
225,"MARQUETTE MI",5,1,0,1,0,1,-87.39571381,46.54323196
225,"MARS HILL NC",5,1,1,0,0,1,-82.54877472,35.82659912
225,"MARSHALL MN",5,2,2,0,0,2,-95.78921509,44.4466362
225,"MARTIN TN",5,3,2,1,0,3,-88.85335541,36.34902573
225,"MARTINEZ CA",5,1,1,0,0,1,-122.1364365,38.01914597
225,"MARYLAND HEIGHTS MO",5,3,2,1,0,3,-90.43025208,38.71334076
225,"MARYSVILLE CA",5,1,0,0,1,1,-121.5933762,39.14567947
225,"MASCOUTAH IL",5,1,0,1,0,1,-89.79308319,38.49026489
225,"MASON CITY IA",5,1,0,0,1,1,-93.20175934,43.15355301
225,"MASON OH",5,6,3,1,2,6,-84.30989075,39.36032104
225,"MAULDIN SC",5,1,1,0,0,1,-82.30957794,34.77907562
225,"MAYNARD MA",5,1,0,0,1,1,-71.44880676,42.43361664
225,"MAYWOOD IL",5,3,0,2,1,3,-87.84314728,41.87941742
225,"MCALLEN TX",5,1,0,0,1,1,-98.23077393,26.20433426
225,"MCCOMB MS",5,1,1,0,0,1,-90.45623016,31.2437973
225,"MCINTOSH FL",5,1,0,1,0,1,-82.22186279,29.44919586
225,"MCKINNEY TX",5,5,1,2,2,5,-96.6155777,33.19782257
225,"MCMINNVILLE OR",5,3,1,0,2,3,-123.2019272,45.20968628
225,"MCPHERSON KS",5,1,0,0,1,1,-97.66510773,38.37078094
225,"MEBANE NC",5,1,0,1,0,1,-79.26649475,36.09629059
225,"MEDFORD MA",5,2,0,1,1,2,-71.10526276,42.41849518
225,"MEDFORD OR",5,4,0,3,1,4,-122.8773193,42.32625961
225,"MEDIA PA",5,3,2,1,0,3,-75.38693237,39.91692734
225,"MEDICAL LAKE WA",5,3,0,3,0,3,-117.682518,47.57226944
225,"MEDINA OH",5,3,1,1,1,3,-81.86336517,41.13858795
225,"MELBOURNE FL",5,3,1,1,1,3,-80.60625458,28.07838249
225,"MELROSE MA",5,1,1,0,0,1,-71.07271576,42.45837784
225,"MEMPHIS TN",5,145,37,47,61,145,-90.01696014,35.1194191
225,"MENTOR-ON-THE-LAKE OH",5,1,1,0,0,1,-81.36006927,41.70515442
225,"MERCED CA",5,6,3,0,3,6,-120.4848785,37.30197525
225,"MERCEDES TX",5,2,1,1,0,2,-97.91394043,26.15032959
225,"MERIDEN CT",5,2,1,0,1,2,-72.80596161,41.5384407
225,"MERIDIAN ID",5,1,1,0,0,1,-116.3941193,43.611866
225,"MERIDIAN MS",5,3,0,1,2,3,-88.70374298,32.36473846
225,"MERRIAM KS",5,1,0,0,1,1,-94.69395447,39.02367401
225,"MERRILLVILLE IN",5,1,0,0,1,1,-87.33312988,41.48298645
225,"MESA AZ",5,23,6,11,6,23,-111.8239059,33.42222214
225,"MESQUITE TX",5,14,3,2,9,14,-96.59959412,32.76692581
225,"METUCHEN NJ",5,1,0,0,1,1,-74.36269379,40.543293
225,"MIAMI BEACH FL",5,7,2,4,1,7,-80.12982178,25.79146576
225,"MIAMI FL",5,205,41,60,104,205,-80.19329071,25.77483749
225,"MIAMI SHORES FL",5,4,2,0,2,4,-80.19244385,25.8637619
225,"MIAMISBURG OH",5,1,0,0,1,1,-84.28652191,39.643116
225,"MIDDLEBURY VT",5,4,1,1,2,4,-73.16629028,44.01540756
225,"MIDDLETOWN CT",5,1,0,0,1,1,-72.64955902,41.56232071
225,"MIDDLETOWN DE",5,2,2,0,0,2,-75.71700287,39.44935226
225,"MIDLAND MI",5,3,1,0,2,3,-84.24700928,43.61585236
225,"MIDVALE UT",5,2,1,1,0,2,-111.9078598,40.61109924
225,"MIFFLINBURG PA",5,1,0,1,0,1,-77.04728699,40.91789627
225,"MILAN TN",5,1,0,1,0,1,-88.75936127,35.91966248
225,"MILFORD DE",5,1,1,0,0,1,-75.42737579,38.9128685
225,"MILFORD MA",5,1,0,0,1,1,-71.51522064,42.14015198
225,"MILFORD NY",5,2,0,1,1,2,-74.94455719,42.59064865
225,"MILL VALLEY CA",5,1,0,0,1,1,-122.5473328,37.90579224
225,"MILPITAS CA",5,1,0,1,0,1,-121.9090805,37.42808533
225,"MILWAUKEE WI",5,157,39,50,68,157,-87.90684509,43.03887939
225,"MINDEN LA",5,18,10,2,6,18,-93.28716278,32.61589432
225,"MINNEAPOLIS MN",5,153,39,41,73,153,-93.26397705,44.97980118
225,"MIRAMAR FL",5,1,0,0,1,1,-80.23181915,25.98794746
225,"MISSION KS",5,3,2,0,1,3,-94.65638733,39.02796173
225,"MISSION SD",5,1,1,0,0,1,-100.6579437,43.30659866
225,"MISSION TX",5,5,1,1,3,5,-98.32580566,26.21655273
225,"MISSOULA MT",5,9,1,4,4,9,-113.9832687,46.87278366
225,"MISSOURI CITY TX",5,1,1,0,0,1,-95.5381012,29.61878204
225,"MOBILE AL",5,19,5,4,10,19,-88.04309845,30.69476128
225,"MODESTO CA",5,5,1,2,2,5,-120.9991455,37.63897324
225,"MOLINE IL",5,1,0,1,0,1,-90.51522064,41.5069809
225,"MONROE LA",5,1,1,0,0,1,-92.11960602,32.50980759
225,"MONROE MI",5,1,0,0,1,1,-83.39758301,41.91663742
225,"MONROVIA CA",5,1,1,0,0,1,-118.0006485,34.14796829
225,"MONTCLAIR NJ",5,1,1,0,0,1,-74.20848083,40.82605362
225,"MONTEREY CA",5,3,2,0,1,3,-121.8974838,36.6002388
225,"MONTGOMERY AL",5,26,8,6,12,26,-86.29966736,32.36724472
225,"MONTGOMERY TX",5,1,0,1,0,1,-95.69664001,30.38855171
225,"MOORE OK",5,5,1,2,2,5,-97.48735046,35.33969498
225,"MOORPARK CA",5,2,0,0,2,2,-118.8839111,34.28554535
225,"MOREHEAD KY",5,2,1,0,1,2,-83.43223572,38.18409348
225,"MORGAN HILL CA",5,1,0,0,1,1,-121.6563797,37.1303978
225,"MORGANTOWN WV",5,5,3,0,2,5,-79.95038605,39.63131714
225,"MORRIS MN",5,2,2,0,0,2,-95.91436005,45.58617401
225,"MORRISTOWN NJ",5,1,1,0,0,1,-74.48057556,40.79689789
225,"MORRO BAY CA",5,1,0,0,1,1,-120.8519135,35.36568451
225,"MORROW GA",5,2,1,0,1,2,-84.33943939,33.58339691
225,"MORTON IL",5,1,0,0,1,1,-89.45970917,40.61309433
225,"MOSCOW ID",5,1,0,1,0,1,-117.0021973,46.73223877
225,"MOUNT PLEASANT SC",5,2,0,1,1,2,-79.86242676,32.79427719
225,"MOUNT RAINIER MD",5,2,0,2,0,2,-76.96430206,38.9414978
225,"MOUNTAIN HOME AR",5,1,1,0,0,1,-92.38542175,36.33543015
225,"MOUNTAIN HOME ID",5,2,1,0,1,2,-115.6928406,43.13270187
225,"MOUNTAIN VIEW CA",5,9,0,3,6,9,-122.0861969,37.3859024
225,"MOWEAQUA IL",5,1,1,0,0,1,-89.01890564,39.62461472
225,"MUKWONAGO WI",5,3,0,2,1,3,-88.33354187,42.86693192
225,"MUNCIE IN",5,8,4,2,2,8,-85.38398743,40.18970871
225,"MUNDELEIN IL",5,1,0,0,1,1,-88.00391388,42.26291275
225,"MUNISING MI",5,1,0,0,1,1,-86.64807892,46.410923
225,"MURFREESBORO TN",5,7,1,1,5,7,-86.39038086,35.84575653
225,"MURRAY KY",5,10,2,1,7,10,-88.31504059,36.61037827
225,"MUSCLE SHOALS AL",5,1,0,0,1,1,-87.6674881,34.74491882
225,"MUSKOGEE OK",5,9,1,1,7,9,-95.36999512,35.74824142
225,"MYRTLE BEACH SC",5,2,1,0,1,2,-78.88601685,33.69656372
225,"NAMPA ID",5,9,4,2,3,9,-116.5658188,43.54054642
225,"NAPA CA",5,3,1,1,1,3,-122.2872086,38.29692841
225,"NAPERVILLE IL",5,2,1,0,1,2,-88.14768219,41.78578949
225,"NAPLES FL",5,8,3,0,5,8,-81.79434204,26.14280128
225,"NASHUA NH",5,2,2,0,0,2,-71.46669769,42.76576996
225,"NATCHITOCHES LA",5,1,0,0,1,1,-93.08662415,31.76096535
225,"NATICK MA",5,4,2,2,0,4,-71.3484726,42.2836113
225,"NAUGATUCK CT",5,7,3,3,1,7,-73.04972076,41.4863205
225,"NAZARETH PA",5,2,0,2,0,2,-75.30902863,40.74064255
225,"NEEDHAM MA",5,1,0,1,0,1,-71.21767426,42.27159119
225,"NEVADA MO",5,1,1,0,0,1,-94.3551178,37.83953476
225,"NEW BEDFORD MA",5,2,1,1,0,2,-70.93328857,41.63626862
225,"NEW BRAUNFELS TX",5,5,1,1,3,5,-98.12486267,29.70325089
225,"NEW BRITAIN CT",5,1,0,1,0,1,-72.77884674,41.6615181
225,"NEW CARROLLTON MD",5,4,1,1,2,4,-76.8794632,38.97011185
225,"NEW CASTLE DE",5,8,2,0,6,8,-75.56227875,39.66440964
225,"NEW HAVEN CT",5,63,19,19,25,63,-72.92726898,41.3084259
225,"NEW LONDON CT",5,2,0,0,2,2,-72.09841156,41.35572815
225,"NEW ORLEANS LA",5,189,49,62,78,189,-90.07525635,29.95483589
225,"NEW PALTZ NY",5,3,0,0,3,3,-74.08605194,41.74787903
225,"NEW ROCHELLE NY",5,3,1,0,2,3,-73.78160858,40.91175842
225,"NEW YORK NY",5,1014,277,316,421,1014,-74.00528717,40.7145195
225,"NEWARK DE",5,10,2,4,4,10,-75.74462128,39.68774414
225,"NEWARK NJ",5,50,13,15,22,50,-74.17185211,40.73570633
225,"NEWARK OH",5,2,0,1,1,2,-82.40110779,40.05843353
225,"NEWBERG OR",5,1,1,0,0,1,-122.9754334,45.29994202
225,"NEWBURGH IN",5,2,0,0,2,2,-87.40516663,37.94437027
225,"NEWBURGH NY",5,1,0,0,1,1,-74.00939941,41.50367737
225,"NEWMARKET NH",5,6,2,3,1,6,-70.94036102,43.07514191
225,"NEWNAN GA",5,1,0,0,1,1,-84.79645538,33.37108231
225,"NEWPORT AR",5,1,0,0,1,1,-91.28199768,35.60486221
225,"NEWPORT NEWS VA",5,8,3,1,4,8,-76.42758942,36.97909927
225,"NEWPORT RI",5,2,0,0,2,2,-71.31213379,41.49024963
225,"NEWTON KS",5,1,0,0,1,1,-97.3455658,38.04684067
225,"NEWTON MA",5,3,1,0,2,3,-71.20809937,42.33743286
225,"NEWTON NC",5,1,0,1,0,1,-81.22117615,35.67030334
225,"NIAGARA FALLS NY",5,1,1,0,0,1,-79.05632019,43.09456253
225,"NIXA MO",5,1,0,1,0,1,-93.29502869,37.04324341
225,"NOBLESVILLE IN",5,1,0,1,0,1,-86.01766205,40.03728104
225,"NORCROSS GA",5,5,2,1,2,5,-84.21324158,33.94129181
225,"NORFOLK VA",5,43,14,15,14,43,-76.28334045,36.84831619
225,"NORMAL IL",5,4,1,1,2,4,-88.99052429,40.51409912
225,"NORMAN OK",5,4,1,2,1,4,-97.44689178,35.22203827
225,"NORTH ANDOVER MA",5,2,1,0,1,2,-71.13425446,42.69897079
225,"NORTH AUGUSTA SC",5,3,0,1,2,3,-81.96509552,33.5021019
225,"NORTH BEND WA",5,7,2,0,5,7,-121.7899017,47.49547195
225,"NORTH BERGEN NJ",5,1,0,0,1,1,-74.0112381,40.8045845
225,"NORTH CANTON OH",5,1,0,0,1,1,-81.40194702,40.87594223
225,"NORTH HAVEN ME",5,1,0,1,0,1,-68.87295532,44.13141251
225,"NORTH LAS VEGAS NV",5,6,2,1,3,6,-115.1192093,36.19900131
225,"NORTH LITTLE ROCK AR",5,2,0,1,1,2,-92.26677704,34.76465988
225,"NORTH MANCHESTER IN",5,1,0,0,1,1,-85.76879883,41.00079346
225,"NORTH MIAMI BEACH FL",5,26,8,10,8,26,-80.16223907,25.93397713
225,"NORTH MIAMI FL",5,1,0,0,1,1,-80.18624115,25.8908596
225,"NORTH OGDEN UT",5,1,1,0,0,1,-111.9736023,41.30478668
225,"NORTH PORT FL",5,1,1,0,0,1,-82.23706055,27.04372597
225,"NORTH SYRACUSE NY",5,2,0,2,0,2,-76.12913513,43.13497543
225,"NORTHAMPTON MA",5,4,0,0,4,4,-72.64012146,42.32544708
225,"NORTHBROOK IL",5,1,1,0,0,1,-87.82922363,42.12767792
225,"NORTHFIELD NH",5,1,0,1,0,1,-71.59122467,43.43339157
225,"NORTHVILLE MI",5,1,0,1,0,1,-83.48340607,42.4312706
225,"NORWALK CT",5,1,0,0,1,1,-73.40729523,41.11759949
225,"NORWICH CT",5,1,1,0,0,1,-72.07475281,41.52449036
225,"NORWOOD OH",5,1,0,1,0,1,-84.45967865,39.15586853
225,"NOVI MI",5,1,0,1,0,1,-83.47566223,42.48064423
225,"NYACK NY",5,6,2,0,4,6,-73.91687012,41.09091568
225,"O'FALLON MO",5,31,8,8,15,31,-90.69979095,38.8109436
225,"OAK BLUFFS MA",5,2,2,0,0,2,-70.56096649,41.45436859
225,"OAK CREEK WI",5,1,0,0,1,1,-87.86346436,42.88599014
225,"OAK HARBOR WA",5,2,0,1,1,2,-122.6395798,48.29240036
225,"OAK PARK IL",5,2,2,0,0,2,-87.78443909,41.88500595
225,"OAK PARK MI",5,4,0,1,1,2,-84.21956253,42.40898132
225,"OAKDALE CA",5,2,0,2,0,2,-120.8491745,37.76628113
225,"OAKLAND CA",5,354,90,120,144,354,-122.2733154,37.80438614
225,"OBLONG IL",5,2,1,0,1,2,-87.90914154,39.00207138
225,"OCALA FL",5,1,1,0,0,1,-82.13973236,29.18780708
225,"OCEANSIDE CA",5,12,4,2,6,12,-117.3814011,33.19587326
225,"ODESSA TX",5,2,0,1,1,2,-102.3682938,31.84587097
225,"OGALLALA NE",5,25,5,8,12,25,-101.7200775,41.1279068
225,"OGDEN AR",5,2,1,1,0,2,-94.04294586,33.58304214
225,"OGDEN UT",5,5,2,0,3,5,-111.9730225,41.22582626
225,"OGDENSBURG NY",5,1,0,1,0,1,-75.48552704,44.69423294
225,"OHIO IL",5,2,0,0,2,2,-89.46100616,41.55773544
225,"OJAI CA",5,1,0,0,1,1,-119.2175903,34.4372139
225,"OKLAHOMA CITY OK",5,46,15,10,21,46,-97.51699829,35.46761322
225,"OLATHE KS",5,3,1,2,0,3,-94.81970215,38.88142395
225,"OLEAN NY",5,1,0,1,0,1,-78.42921448,42.07747269
225,"OLIVE BRANCH MS",5,1,0,0,1,1,-89.82355499,34.96377563
225,"OLYMPIA WA",5,19,8,7,4,19,-122.8909378,47.04053497
225,"OMAHA NE",5,59,22,17,20,59,-95.93825531,41.25878906
225,"ONEONTA NY",5,1,0,1,0,1,-75.0631485,42.45296097
225,"ONTARIO CA",5,6,1,1,4,6,-117.6528702,34.06340408
225,"OPELOUSAS LA",5,3,0,2,1,3,-92.08177948,30.53403282
225,"ORANGE CA",5,16,4,4,8,16,-117.8544846,33.7877388
225,"ORANGE TX",5,1,0,0,1,1,-93.73699951,30.09343147
225,"OREM UT",5,1,0,0,1,1,-111.6960449,40.29695892
225,"ORLANDO FL",5,151,30,53,68,151,-81.3789978,28.53886795
225,"ORMOND BEACH FL",5,19,5,7,7,19,-81.05541992,29.28623772
225,"ORTONVILLE MI",5,2,1,1,0,2,-83.44315338,42.852314
225,"OSHKOSH WI",5,1,1,0,0,1,-88.54268646,44.02453613
225,"OSSINING NY",5,6,3,1,2,6,-73.86093903,41.16327286
225,"OVERLAND PARK KS",5,12,5,4,3,12,-94.67124939,38.98216248
225,"OWATONNA MN",5,1,0,1,0,1,-93.22633362,44.08358383
225,"OWENSBORO KY",5,1,0,0,1,1,-87.11345673,37.77421188
225,"OXFORD AL",5,1,0,0,1,1,-85.83503723,33.6145134
225,"OXFORD MS",5,10,5,1,4,10,-89.52319336,34.37203979
225,"OXFORD OH",5,2,0,0,2,2,-84.74536133,39.50694275
225,"OXFORD PA",5,1,0,1,0,1,-75.97814178,39.78580856
225,"OXNARD CA",5,1,0,1,0,1,-119.1790085,34.19766998
225,"OZARK MO",5,1,0,1,0,1,-93.20661163,37.02112198
225,"PACIFICA CA",5,1,1,0,0,1,-122.4893951,37.61383438
225,"PADUCAH KY",5,4,0,1,3,4,-88.60009766,37.08333206
225,"PAGELAND SC",5,1,1,0,0,1,-80.39112091,34.77358246
225,"PALESTINE TX",5,1,0,1,0,1,-95.6313324,31.76263046
225,"PALISADES PARK NJ",5,3,2,1,0,3,-73.9969635,40.84852982
225,"PALM BAY FL",5,1,0,0,1,1,-80.58313751,28.03806496
225,"PALM BEACH FL",5,4,1,0,3,4,-80.03616333,26.70643616
225,"PALM DESERT CA",5,5,2,3,0,5,-116.3907166,33.72164154
225,"PALM SPRINGS CA",5,10,4,2,4,10,-116.5467758,33.83036423
225,"PALO ALTO CA",5,13,4,5,4,13,-122.1449661,37.44177628
225,"PANAMA CITY BEACH FL",5,2,0,1,1,2,-85.80211639,30.1792717
225,"PANAMA CITY FL",5,2,1,0,1,2,-85.65970612,30.16412926
225,"PARAMOUNT CA",5,5,2,1,2,5,-118.161644,33.88947678
225,"PARIS IL",5,6,1,3,2,6,-87.69623566,39.61117172
225,"PARIS KY",5,5,3,0,2,5,-84.25283051,38.21011353
225,"PARIS TX",5,1,0,0,1,1,-95.55589294,33.66113663
225,"PARK CITY UT",5,13,5,6,2,13,-111.5018539,40.65143204
225,"PARKER CO",5,3,1,1,1,3,-104.7624359,39.51849365
225,"PARKERSBURG WV",5,1,0,1,0,1,-81.54850006,39.28261948
225,"PARLIER CA",5,1,1,0,0,1,-119.5286789,36.61136627
225,"PARMA OH",5,2,0,0,2,2,-81.72257996,41.40510178
225,"PASADENA CA",5,49,10,17,22,49,-118.1466675,34.14794922
225,"PASADENA TX",5,1,0,0,1,1,-95.20979309,29.69150162
225,"PASCAGOULA MS",5,1,0,1,0,1,-88.55257416,30.36789703
225,"PASCO WA",5,1,1,0,0,1,-119.1023636,46.2282753
225,"PASSAIC NJ",5,1,1,0,0,1,-74.12754822,40.8571434
225,"PATERSON NJ",5,9,3,1,5,9,-74.17102051,40.91714478
225,"PAYETTE ID",5,1,0,0,1,1,-116.9361572,44.07813263
225,"PEARLAND TX",5,1,0,1,0,1,-95.28644562,29.56411743
225,"PEMBROKE PINES FL",5,2,0,1,1,2,-80.22357941,26.00384903
225,"PENDLETON OR",5,1,0,0,1,1,-118.7900848,45.67152786
225,"PENDLETON SC",5,1,0,0,1,1,-82.78354645,34.65194321
225,"PENSACOLA FL",5,8,5,3,0,8,-87.21669006,30.42154694
225,"PEORIA AZ",5,6,2,3,1,6,-112.2390747,33.58084106
225,"PEORIA IL",5,11,4,4,3,11,-89.59487152,40.70241928
225,"PERTH AMBOY NJ",5,15,2,5,8,15,-74.26480103,40.5068779
225,"PERU IN",5,4,1,1,2,4,-86.06684875,40.74810028
225,"PETALUMA CA",5,5,3,0,2,5,-122.6394272,38.23221207
225,"PETERSBURG VA",5,3,1,1,1,3,-77.40148926,37.2280426
225,"PHARR TX",5,1,0,1,0,1,-98.1840744,26.19566154
225,"PHILADELPHIA PA",5,536,148,156,232,536,-75.16322327,39.95243835
225,"PHILADELPHIA TN",5,1,1,0,0,1,-84.40354156,35.67960358
225,"PHOENIX AZ",5,158,45,49,64,158,-112.0752716,33.44825363
225,"PICO RIVERA CA",5,1,0,0,1,1,-118.0985489,33.983284
225,"PISMO BEACH CA",5,2,1,0,1,2,-120.6432953,35.1427269
225,"PITTSBURG CA",5,15,5,3,7,15,-121.8871613,38.02787781
225,"PITTSBURG KS",5,2,1,1,0,2,-94.70526123,37.41111374
225,"PITTSBURGH PA",5,336,94,98,144,336,-79.99537659,40.44091415
225,"PITTSFIELD MA",5,4,2,1,1,4,-73.24451447,42.45004272
225,"PLACERVILLE CA",5,7,2,1,4,7,-120.8002701,38.72951508
225,"PLAINFIELD IL",5,4,0,2,2,4,-88.20417786,41.62700653
225,"PLAINFIELD NJ",5,1,1,0,0,1,-74.40673065,40.63404083
225,"PLANO TX",5,7,3,3,1,7,-96.69931793,33.01993942
225,"PLANTATION FL",5,1,0,0,1,1,-80.23281097,26.12825966
225,"PLATTEVILLE WI",5,1,0,1,0,1,-90.47890472,42.73428726
225,"PLATTSBURGH NY",5,1,0,0,1,1,-73.45239258,44.69951248
225,"PLEASANT HILL CA",5,1,1,0,0,1,-122.0632401,37.94770813
225,"PLEASANT VALLEY MO",5,2,0,2,0,2,-94.48001099,39.21652985
225,"PLYMOUTH IN",5,1,0,1,0,1,-86.31345367,41.33988953
225,"PLYMOUTH MA",5,2,1,1,0,2,-70.67458344,41.95769882
225,"PLYMOUTH MN",5,1,1,0,0,1,-93.45163727,45.02838898
225,"POMONA CA",5,2,2,0,0,2,-117.7534485,34.05541611
225,"POMPANO BEACH FL",5,3,1,2,0,3,-80.12407684,26.23855591
225,"PONCA CITY OK",5,1,0,1,0,1,-97.08611298,36.70682907
225,"PONTIAC MI",5,1,0,0,1,1,-83.29104614,42.63900757
225,"POPLAR BLUFF MO",5,2,1,0,1,2,-90.3928833,36.75717545
225,"PORT ANGELES WA",5,1,0,0,1,1,-123.4329224,48.11795044
225,"PORT ARTHUR TX",5,11,2,5,4,11,-93.93045807,29.90067863
225,"PORT HURON MI",5,2,0,2,0,2,-82.42453766,42.97105026
225,"PORT ORCHARD WA",5,1,1,0,0,1,-122.6369019,47.53696823
225,"PORT ORFORD OR",5,1,1,0,0,1,-124.4993668,42.74531555
225,"PORT WASHINGTON WI",5,1,0,1,0,1,-87.876091,43.3874321
225,"PORTAGE MI",5,1,0,1,0,1,-85.57974243,42.20133972
225,"PORTAGEVILLE MO",5,2,1,1,0,2,-89.69967651,36.42550278
225,"PORTLAND ME",5,24,8,6,10,24,-70.25403595,43.6618576
225,"PORTLAND MI",5,1,0,1,0,1,-84.90298462,42.86923599
225,"PORTLAND OR",5,452,114,126,212,452,-122.6786423,45.52309418
225,"PORTSMOUTH NH",5,3,2,1,0,3,-70.76164246,43.07198334
225,"PORTSMOUTH VA",5,4,2,0,2,4,-76.29769135,36.83554077
225,"POUGHKEEPSIE NY",5,3,2,1,0,3,-73.92034149,41.70055771
225,"POWDER SPRINGS GA",5,1,0,0,1,1,-84.68379974,33.8599205
225,"PRAIRIE VILLAGE KS",5,2,2,0,0,2,-94.63400269,38.99189377
225,"PRATTVILLE AL",5,6,1,3,2,6,-86.45972443,32.46446228
225,"PRESCOTT AZ",5,1,0,1,0,1,-112.4702301,34.54008102
225,"PRICHARD AL",5,2,0,1,1,2,-88.07904053,30.739048
225,"PRINCETON NJ",5,6,0,2,4,6,-74.65805817,40.34872055
225,"PROVIDENCE RI",5,50,12,18,20,50,-71.40118408,41.82990265
225,"PROVINCETOWN MA",5,36,7,13,16,36,-70.17770386,42.05849075
225,"PROVO UT",5,4,3,1,0,4,-111.6589813,40.23337936
225,"PUEBLO CO",5,5,1,2,2,5,-104.6108551,38.25450516
225,"PULASKI TN",5,1,0,0,1,1,-87.03085327,35.19976807
225,"PULLMAN WA",5,50,18,11,21,50,-117.180481,46.73068619
225,"PUYALLUP WA",5,2,0,1,1,2,-122.2927628,47.19064331
225,"QUAPAW OK",5,1,1,0,0,1,-94.7911377,36.95119095
225,"QUINCY IL",5,8,3,2,3,8,-91.41021729,39.9356575
225,"QUINCY MA",5,1,0,0,1,1,-71.00706482,42.24961472
225,"QUINCY MI",5,1,0,1,0,1,-84.88388824,41.94426727
225,"RACINE WI",5,10,5,3,2,10,-87.78296661,42.72628021
225,"RALEIGH NC",5,176,45,48,83,176,-78.63800049,35.77230835
225,"RAMSEY NJ",5,1,1,0,0,1,-74.13990021,41.05768967
225,"RANCHO CORDOVA CA",5,3,1,0,2,3,-121.3053742,38.58900452
225,"RANTOUL IL",5,1,1,0,0,1,-88.15558624,40.31206131
225,"RAPID CITY SD",5,1,0,1,0,1,-103.2325821,44.08078766
225,"RAYMOND NE",5,1,0,1,0,1,-96.783638,40.95689011
225,"RAYTOWN MO",5,2,0,1,1,2,-94.46369934,39.00871277
225,"RED BANK NJ",5,1,1,0,0,1,-74.06324768,40.3471756
225,"RED BUD IL",5,1,0,1,0,1,-89.99465179,38.21178436
225,"RED WING MN",5,1,0,1,0,1,-92.53401184,44.56221771
225,"REDDING CA",5,9,5,1,3,9,-122.3944626,40.58649826
225,"REDLANDS CA",5,4,1,0,3,4,-117.21064,34.0318718
225,"REDMOND OR",5,2,0,1,1,2,-121.1761093,44.27230453
225,"REDMOND WA",5,19,6,5,8,19,-122.1240006,47.67367172
225,"REDONDO BEACH CA",5,16,5,5,6,16,-118.3907471,33.84916687
225,"REDWOOD CITY CA",5,5,2,0,3,5,-122.2364655,37.48601151
225,"RENO NV",5,19,5,4,10,19,-119.8160934,39.5294838
225,"RENTON WA",5,7,2,1,4,7,-122.2197342,47.48252487
225,"REPUBLIC MO",5,1,0,1,0,1,-93.48056793,37.12031555
225,"REYNOLDSBURG OH",5,1,0,1,0,1,-82.81163788,39.95471191
225,"RIALTO CA",5,1,1,0,0,1,-117.3716126,34.1063118
225,"RICHARDSON TX",5,4,1,2,1,4,-96.73020172,32.94840622
225,"RICHLAND WA",5,6,3,2,1,6,-119.2866592,46.28547287
225,"RICHMOND CA",5,11,1,3,7,11,-122.3500443,37.9354744
225,"RICHMOND HEIGHTS MO",5,8,1,1,6,8,-90.31951904,38.62892532
225,"RICHMOND HILL GA",5,1,1,0,0,1,-81.30295563,31.9388752
225,"RICHMOND TX",5,1,0,0,1,1,-95.76106262,29.58276558
225,"RICHMOND VA",5,83,19,19,45,83,-77.45962524,37.55412674
225,"RICHTON PARK IL",5,1,1,0,0,1,-87.70342255,41.48434448
225,"RIDGELAND MS",5,2,0,1,1,2,-90.13221741,32.42857742
225,"RIDGEWAY SC",5,1,0,0,1,1,-80.95993805,34.30814362
225,"RINGGOLD GA",5,1,0,0,1,1,-85.10852051,34.9195137
225,"RIPON WI",5,3,1,1,1,3,-88.83634186,43.8422966
225,"RIVERDALE GA",5,4,1,1,2,4,-84.4131012,33.57296371
225,"RIVERDALE IL",5,1,0,1,0,1,-87.633255,41.6336174
225,"RIVERSIDE CA",5,39,15,11,13,39,-117.3973999,33.95311737
225,"ROANOKE VA",5,7,2,2,3,7,-79.94111633,37.27119827
225,"ROBINSON IL",5,3,2,0,1,3,-87.73912048,39.00521469
225,"ROCHESTER MN",5,16,7,1,8,16,-92.47042084,44.02156448
225,"ROCHESTER NY",5,70,19,20,31,70,-77.61522675,43.15487671
225,"ROCK HILL MO",5,1,0,0,1,1,-90.37846375,38.60773849
225,"ROCK HILL SC",5,4,3,1,0,4,-81.02463531,34.92498779
225,"ROCK ISLAND IL",5,1,0,1,0,1,-90.5790329,41.50963593
225,"ROCKFORD IL",5,6,2,1,3,6,-89.09428406,42.27135086
225,"ROCKVILLE MD",5,4,1,2,1,4,-77.15235901,39.08402252
225,"ROCKY MOUNT NC",5,1,0,0,1,1,-77.78997803,35.93837738
225,"ROCKY RIVER OH",5,3,0,1,2,3,-81.83889008,41.4756279
225,"ROGERS AR",5,1,1,0,0,1,-94.11903381,36.33228683
225,"ROLLA MO",5,1,0,0,1,1,-91.77151489,37.95161438
225,"ROME GA",5,1,0,1,0,1,-85.16900635,34.24008942
225,"ROSEBURG OR",5,1,0,0,1,1,-123.3444519,43.21644974
225,"ROSEVILLE CA",5,1,1,0,0,1,-121.2899246,38.75195694
225,"ROSWELL GA",5,2,1,1,0,2,-84.36141205,34.02328491
225,"ROSWELL NM",5,2,1,0,1,2,-104.5282135,33.39533997
225,"ROUND ROCK TX",5,3,1,2,0,3,-97.67939758,30.50861359
225,"ROY UT",5,1,0,0,1,1,-112.035286,41.16501999
225,"ROYAL OAK MI",5,1,0,1,0,1,-83.1442337,42.48933792
225,"RUTHERFORDTON NC",5,1,0,0,1,1,-81.95639801,35.3694458
225,"RYE CO",5,2,0,2,0,2,-104.9316177,37.92366791
225,"RYE NY",5,1,1,0,0,1,-73.68312836,40.98072433
225,"SACRAMENTO CA",5,149,39,48,62,149,-121.4959793,38.58154297
225,"SAGINAW MI",5,4,0,0,4,4,-83.95076752,43.41968918
225,"SAHUARITA AZ",5,33,13,13,7,33,-110.9567032,31.95795059
225,"SALEM IL",5,2,1,1,0,2,-88.94590759,38.62715149
225,"SALEM MA",5,7,2,2,3,7,-70.89565277,42.51993179
225,"SALEM NH",5,1,0,0,1,1,-71.19998169,42.78861618
225,"SALEM OR",5,11,3,2,6,11,-123.0377197,44.94248199
225,"SALEM VA",5,2,1,1,0,2,-80.05405426,37.29384232
225,"SALINA KS",5,5,2,0,3,5,-97.61184692,38.84041977
225,"SALINAS CA",5,52,16,13,23,52,-121.6571732,36.67780304
225,"SALISBURY MD",5,2,0,0,2,2,-75.5984726,38.36100388
225,"SALISBURY NC",5,1,0,1,0,1,-80.47377014,35.67113495
225,"SALT LAKE CITY UT",5,23,9,5,9,23,-111.8912659,40.77029037
225,"SALTILLO MS",5,1,1,0,0,1,-88.68186188,34.37690353
225,"SAN ANSELMO CA",5,3,0,1,2,3,-122.5641785,37.97429276
225,"SAN ANTONIO TX",5,117,38,30,49,117,-98.49394989,29.42439651
225,"SAN BERNARDINO CA",5,5,3,0,2,5,-117.304596,34.12142563
225,"SAN CLEMENTE CA",5,1,1,0,0,1,-117.6134033,33.42698669
225,"SAN DIEGO CA",5,320,95,90,135,320,-117.1587296,32.71524429
225,"SAN DIMAS CA",5,1,0,0,1,1,-117.8088913,34.10668945
225,"SAN FRANCISCO CA",5,362,123,79,160,362,-122.4213257,37.77465057
225,"SAN JOSE CA",5,52,18,12,22,52,-121.8973846,37.33491516
225,"SAN LEANDRO CA",5,5,1,1,3,5,-122.155983,37.70180511
225,"SAN LUIS OBISPO CA",5,3,1,0,2,3,-120.6622849,35.28281021
225,"SAN MARCOS CA",5,1,0,0,1,1,-117.1673966,33.14345551
225,"SAN MARCOS TX",5,23,6,12,5,23,-97.94176483,29.88363266
225,"SAN MATEO CA",5,6,1,3,2,6,-122.3270264,37.56283569
225,"SAN RAFAEL CA",5,1,0,1,0,1,-122.5331726,37.97325134
225,"SAN RAMON CA",5,1,0,0,1,1,-121.9799347,37.77985764
225,"SANDY OR",5,1,0,0,1,1,-122.263649,45.39704132
225,"SANDY SPRINGS GA",5,1,0,1,0,1,-84.37850952,33.92443848
225,"SANTA ANA CA",5,18,3,7,8,18,-117.8697281,33.74567413
225,"SANTA BARBARA CA",5,19,7,4,8,19,-119.7056656,34.4233017
225,"SANTA CLARA CA",5,2,0,1,1,2,-121.946434,37.34754181
225,"SANTA CRUZ CA",5,19,3,12,4,19,-122.0333557,36.97389984
225,"SANTA FE NM",5,41,15,12,14,41,-105.9468155,35.68014526
225,"SANTA MARIA CA",5,1,0,1,0,1,-120.437973,34.95292664
225,"SANTA MONICA CA",5,38,17,7,14,38,-118.4925232,34.01921082
225,"SANTA ROSA CA",5,16,5,5,6,16,-122.7165146,38.44017792
225,"SAPULPA OK",5,1,0,0,1,1,-96.11476135,35.99878311
225,"SARASOTA FL",5,8,5,2,1,8,-82.53031158,27.33688736
225,"SARATOGA SPRINGS NY",5,1,0,0,1,1,-73.78382111,43.08345032
225,"SAVANNAH GA",5,48,14,15,19,48,-81.09463501,32.07280731
225,"SCARSDALE NY",5,2,1,1,0,2,-73.78360748,41.00525665
225,"SCHAUMBURG IL",5,3,2,1,0,3,-88.08359528,42.03350449
225,"SCHENECTADY NY",5,3,0,1,2,3,-73.938591,42.81433487
225,"SCOTT LA",5,1,0,1,0,1,-92.09500885,30.23620224
225,"SCOTTSBLUFF NE",5,1,0,0,1,1,-103.6682434,41.86663818
225,"SCOTTSDALE AZ",5,14,6,2,6,14,-111.9002533,33.50918579
225,"SCRANTON PA",5,6,1,2,3,6,-75.66184998,41.40919113
225,"SEAFORD DE",5,1,0,1,0,1,-75.61972809,38.64723206
225,"SEASIDE CA",5,1,1,0,0,1,-121.8542252,36.6110611
225,"SEATTLE WA",5,575,170,170,235,575,-122.3343964,47.60571289
225,"SEBASTOPOL CA",5,1,0,0,1,1,-122.8264999,38.40188217
225,"SEDONA AZ",5,1,0,0,1,1,-111.7623367,34.86959839
225,"SEGUIN TX",5,4,0,2,2,4,-97.96529388,29.56933594
225,"SENECA SC",5,1,1,0,0,1,-82.95318604,34.68600845
225,"SEWICKLEY PA",5,1,0,0,1,1,-80.18386078,40.5364151
225,"SHAKER HEIGHTS OH",5,42,11,9,22,42,-81.53669739,41.47419357
225,"SHAKOPEE MN",5,1,0,1,0,1,-93.52770233,44.79788971
225,"SHAWNEE KS",5,1,0,1,0,1,-94.7208786,39.0417366
225,"SHEBOYGAN WI",5,6,1,1,4,6,-87.71476746,43.75089264
225,"SHELBY NC",5,1,0,1,0,1,-81.53518677,35.29262543
225,"SHIVELY KY",5,5,3,0,2,5,-85.82255554,38.20013809
225,"SHOREVIEW MN",5,2,0,1,1,2,-93.1241684,45.06987762
225,"SHREVEPORT LA",5,10,2,3,5,10,-93.7507019,32.52565002
225,"SIDNEY OH",5,1,0,1,0,1,-84.15549469,40.28426743
225,"SIERRA MADRE CA",5,1,0,0,1,1,-118.0547943,34.16183853
225,"SILVER CITY NM",5,1,0,0,1,1,-108.281929,32.77336884
225,"SIMI VALLEY CA",5,1,1,0,0,1,-118.7839508,34.26951981
225,"SIOUX CITY IA",5,1,0,1,0,1,-96.40085602,42.5001564
225,"SIOUX FALLS SD",5,8,2,1,5,8,-96.73429108,43.54177475
225,"SISTER BAY WI",5,1,1,0,0,1,-87.12120819,45.19202423
225,"SLIDELL LA",5,4,1,2,1,4,-89.78143311,30.27558708
225,"SLOATSBURG NY",5,1,1,0,0,1,-74.19187164,41.15483475
225,"SMITHVILLE MO",5,1,0,0,1,1,-94.58171082,39.38669586
225,"SMYRNA DE",5,1,0,0,1,1,-75.60120392,39.30263519
225,"SMYRNA GA",5,5,2,0,3,5,-84.51447296,33.88409042
225,"SMYRNA TN",5,1,1,0,0,1,-86.51843262,35.98318863
225,"SOMERSET PA",5,1,0,1,0,1,-79.0776825,40.00854874
225,"SOMERVILLE MA",5,47,17,6,24,47,-71.09860992,42.38757324
225,"SONOMA CA",5,1,0,1,0,1,-122.4600754,38.29153061
225,"SONORA CA",5,8,3,1,4,8,-120.3842011,37.98400497
225,"SOUDERTON PA",5,1,0,0,1,1,-75.32456207,40.31177902
225,"SOUTH BEND IN",5,10,3,5,2,10,-86.25171661,41.67295837
225,"SOUTH EUCLID OH",5,1,0,0,1,1,-81.51824188,41.5230751
225,"SOUTH GATE CA",5,1,0,1,0,1,-118.213707,33.95462799
225,"SOUTH LAKE TAHOE CA",5,1,0,0,1,1,-119.972786,38.94574356
225,"SOUTH PASADENA CA",5,1,0,1,0,1,-118.1516647,34.11618805
225,"SOUTH SAN FRANCISCO CA",5,2,1,1,0,2,-122.4101868,37.65430069
225,"SOUTHAMPTON NY",5,8,0,3,5,8,-72.38861084,40.88444519
225,"SOUTHAVEN MS",5,1,0,0,1,1,-90.02496338,34.99386215
225,"SOUTHFIELD MI",5,4,0,0,4,4,-83.22153473,42.47357559
225,"SOUTHPORT NC",5,1,0,0,1,1,-78.01985931,33.9217453
225,"SOUTHWICK MA",5,1,0,0,1,1,-72.76921844,42.05488205
225,"SPARTANBURG SC",5,11,2,2,7,11,-81.93160248,34.94982529
225,"SPEEDWAY IN",5,13,3,6,4,13,-86.2671051,39.80224609
225,"SPOKANE WA",5,31,9,12,10,31,-117.4281387,47.65847015
225,"SPRING HILL TN",5,3,0,0,3,3,-86.93003845,35.75111389
225,"SPRINGDALE AR",5,3,0,1,2,3,-94.12921143,36.1869278
225,"SPRINGFIELD IL",5,14,4,5,5,14,-89.6439743,39.80184174
225,"SPRINGFIELD MA",5,6,1,1,4,6,-72.57289124,42.10980606
225,"SPRINGFIELD MO",5,62,23,23,16,62,-93.29862213,37.21548843
225,"SPRINGFIELD VT",5,1,0,0,1,1,-72.48161316,43.29873657
225,"ST LOUIS MO",5,4450,1440,1064,1946,4450,-90.19819641,38.62716675
225,"STAMFORD CT",5,7,1,4,2,7,-73.53807068,41.05353165
225,"STARKVILLE MS",5,4,0,2,2,4,-88.81492615,33.46545029
225,"STATE COLLEGE PA",5,13,6,6,1,13,-77.85973358,40.79336929
225,"STATESBORO GA",5,6,2,1,3,6,-81.78266907,32.44914246
225,"STEAMBOAT SPRINGS CO",5,3,1,1,1,3,-106.8292313,40.48627853
225,"STEILACOOM WA",5,16,5,6,5,16,-122.6048813,47.16923141
225,"STEVENS POINT WI",5,3,1,1,1,3,-89.57467651,44.52337265
225,"STILLWATER MN",5,2,1,1,0,2,-92.80657959,45.05171967
225,"STOCKTON CA",5,8,5,2,1,8,-121.293457,37.95776749
225,"STONE MOUNTAIN GA",5,6,1,2,3,6,-84.14538574,33.8065033
225,"STONEHAM MA",5,1,0,0,1,1,-71.09869385,42.48027039
225,"STOUGHTON MA",5,1,1,0,0,1,-71.10134888,42.12547302
225,"STOW OH",5,3,2,1,0,3,-81.44025421,41.1593895
225,"STUART VA",5,5,1,0,4,5,-80.26490784,36.64115906
225,"SUFFOLK VA",5,1,0,1,0,1,-76.58317566,36.72846985
225,"SUGAR HILL GA",5,1,1,0,0,1,-84.03327179,34.10667801
225,"SUGAR LAND TX",5,3,1,2,0,3,-95.6352005,29.61997795
225,"SULLIVAN MO",5,1,1,0,0,1,-91.16096497,38.20802689
225,"SUMMERVILLE SC",5,4,2,1,1,4,-80.17547607,33.01868439
225,"SUMMIT IL",5,1,0,0,1,1,-87.81018066,41.78816223
225,"SUMTER SC",5,1,1,0,0,1,-80.34135437,33.92088318
225,"SUN PRAIRIE WI",5,12,1,1,10,12,-89.21392059,43.18373108
225,"SUNNYVALE CA",5,5,0,4,1,5,-122.0380707,37.36878967
225,"SUNRISE FL",5,1,0,1,0,1,-80.2282486,26.14059067
225,"SURFSIDE FL",5,2,1,1,0,2,-80.12493134,25.87931252
225,"SYCAMORE IL",5,2,2,0,0,2,-88.68714142,41.98875427
225,"SYCAMORE OH",5,1,0,1,0,1,-83.17075348,40.94967651
225,"SYRACUSE NY",5,25,11,6,8,25,-76.14653015,43.04846191
225,"TACOMA WA",5,44,16,12,16,44,-122.4466705,47.25242233
225,"TAKOMA PARK MD",5,7,1,4,2,7,-77.00667572,38.97793198
225,"TALLAHASSEE FL",5,60,17,14,29,60,-84.27896881,30.44669914
225,"TAMARAC FL",5,1,1,0,0,1,-80.22389984,26.19458199
225,"TAMPA FL",5,221,63,68,90,221,-82.4580307,27.94833755
225,"TAOS NM",5,3,1,1,1,3,-105.5769424,36.40658188
225,"TARPON SPRINGS FL",5,18,4,10,4,18,-82.75656128,28.14682198
225,"TAUNTON MA",5,1,0,1,0,1,-71.08903503,41.900177
225,"TAVARES FL",5,1,0,1,0,1,-81.72516632,28.80491257
225,"TAYLORVILLE IL",5,6,1,0,5,6,-89.29446411,39.5492363
225,"TEA SD",5,1,0,0,1,1,-96.83795166,43.44678497
225,"TEANECK NJ",5,1,0,0,1,1,-74.01485443,40.89759064
225,"TEMECULA CA",5,1,1,0,0,1,-117.1428146,33.48790741
225,"TEMPE AZ",5,44,7,13,24,44,-111.9108276,33.41504288
225,"TEMPLE TX",5,11,1,3,7,11,-97.34354401,31.09850502
225,"TENAFLY NJ",5,1,0,0,1,1,-73.9623642,40.92551041
225,"TERRE HAUTE IN",5,3,1,1,1,3,-87.41414642,39.46681976
225,"TEWKSBURY MA",5,4,1,0,3,4,-71.23313904,42.61103439
225,"TEXARKANA TX",5,3,2,1,0,3,-94.04785156,33.42536545
225,"THIBODAUX LA",5,2,0,0,2,2,-90.82309723,29.79626465
225,"THORNTON CO",5,5,1,1,3,5,-104.9727631,39.86811829
225,"THOUSAND OAKS CA",5,3,0,2,1,3,-118.8398514,34.17078018
225,"THREE OAKS MI",5,2,1,0,1,2,-86.61090088,41.7985611
225,"THREE RIVERS MI",5,1,0,1,0,1,-85.63246918,41.94419861
225,"TIGARD OR",5,5,0,3,2,5,-122.7737198,45.4310112
225,"TOBYHANNA PA",5,1,0,1,0,1,-75.41635132,41.17760086
225,"TOLEDO OH",5,23,6,4,13,23,-83.55497742,41.66411591
225,"TOLLESON AZ",5,4,1,1,2,4,-112.2612381,33.45026016
225,"TOMBALL TX",5,1,0,0,1,1,-95.6162262,30.09776115
225,"TOMBSTONE AZ",5,1,1,0,0,1,-110.0689316,31.71310997
225,"TOOELE UT",5,5,0,3,2,5,-112.3005066,40.53457642
225,"TOPEKA KS",5,7,3,1,3,7,-95.67857361,39.04813766
225,"TOPPENISH WA",5,3,2,0,1,3,-120.3111954,46.37686539
225,"TORONTO KS",5,3,0,1,2,3,-95.94944,37.79908752
225,"TORRANCE CA",5,13,3,6,4,13,-118.3428345,33.8359642
225,"TRAVERSE CITY MI",5,2,0,2,0,2,-85.6207962,44.76324844
225,"TRENTON FL",5,1,0,1,0,1,-82.81704712,29.61356735
225,"TRENTON NJ",5,6,1,3,2,6,-74.74206543,40.21709442
225,"TROY AL",5,1,1,0,0,1,-85.97013855,31.80913544
225,"TROY MI",5,3,0,1,2,3,-83.14983368,42.60589218
225,"TROY MO",5,1,1,0,0,1,-90.98098755,38.979702
225,"TROY NY",5,4,2,1,1,4,-73.69088745,42.72839737
225,"TROY OH",5,23,6,9,8,23,-84.20330811,40.03966141
225,"TRUTH OR CONSEQUENCES NM",5,1,0,1,0,1,-107.2433853,33.13360596
225,"TUCSON AZ",5,72,23,24,25,72,-110.9277954,32.22209167
225,"TULSA OK",5,37,8,11,18,37,-95.98488617,36.1603241
225,"TUSCALOOSA AL",5,10,2,4,4,10,-87.56897736,33.21024704
225,"TUSTIN CA",5,2,1,0,1,2,-117.8277283,33.74598312
225,"TWIN FALLS ID",5,2,0,2,0,2,-114.4627686,42.56301498
225,"TYLER TX",5,3,1,0,2,3,-95.3013916,32.35176468
225,"UNION CITY CA",5,6,4,2,0,6,-122.0214462,37.59539032
225,"UNION KY",5,1,1,0,0,1,-84.68045044,38.94612122
225,"UNION NJ",5,1,0,1,0,1,-74.26235199,40.69780731
225,"UNIVERSITY CITY MO",5,42,12,10,20,42,-90.33391571,38.66000748
225,"UNIVERSITY PLACE WA",5,2,1,0,1,2,-122.5529404,47.2352562
225,"UPLAND CA",5,2,0,1,1,2,-117.6498413,34.09745026
225,"UPPER MARLBORO MD",5,1,0,1,0,1,-76.74905396,38.81620026
225,"URBANA IL",5,11,4,3,4,11,-88.20746613,40.11079025
225,"URBANA OH",5,1,0,1,0,1,-83.75213623,40.10844803
225,"URBANDALE IA",5,3,1,0,2,3,-93.71256256,41.62665176
225,"UTICA NY",5,5,3,0,2,5,-75.23220062,43.10119629
225,"VACAVILLE CA",5,3,0,2,1,3,-121.9900284,38.35633469
225,"VALDOSTA GA",5,7,1,4,2,7,-83.27806854,30.83293533
225,"VALLEJO CA",5,26,6,7,13,26,-122.2594299,38.1039505
225,"VALPARAISO IN",5,1,0,0,1,1,-87.05838013,41.46813583
225,"VANCOUVER WA",5,27,9,7,11,27,-122.6816559,45.63534164
225,"VARNADO LA",5,4,1,0,3,4,-89.82972717,30.89409256
225,"VENICE FL",5,1,0,0,1,1,-82.45388031,27.10065269
225,"VERMILLION SD",5,2,0,1,1,2,-96.92948914,42.77981949
225,"VERNAL UT",5,1,0,1,0,1,-109.5302963,40.45552444
225,"VERO BEACH FL",5,1,0,1,0,1,-80.39705658,27.63908195
225,"VERSAILLES PA",5,2,0,1,1,2,-79.83054352,40.31568146
225,"VICKSBURG MS",5,4,0,3,1,4,-90.87818909,32.35280991
225,"VICTORIA TX",5,3,0,1,2,3,-97.00409698,28.80560303
225,"VICTORVILLE CA",5,7,2,1,4,7,-117.2928162,34.53612137
225,"VIENNA VA",5,6,0,2,4,6,-77.2645874,38.90164566
225,"VIENNA WV",5,1,0,1,0,1,-81.54671478,39.33840179
225,"VILLA RICA GA",5,2,1,1,0,2,-84.91907501,33.73210907
225,"VINE GROVE KY",5,1,0,0,1,1,-85.98104858,37.81027222
225,"VIRGINIA BEACH VA",5,79,27,17,35,79,-75.97751617,36.8533783
225,"VISALIA CA",5,1,1,0,0,1,-119.2938156,36.33000946
225,"WACO TX",5,5,1,2,2,5,-97.14704895,31.54987144
225,"WAITE PARK MN",5,3,1,0,2,3,-94.224823,45.55731201
225,"WAKE FOREST NC",5,3,1,1,1,3,-78.50919342,35.98039246
225,"WAKEFIELD MA",5,1,0,1,0,1,-71.07489014,42.51018906
225,"WALLA WALLA WA",5,1,1,0,0,1,-118.3452072,46.06405258
225,"WALLINGFORD CT",5,2,1,1,0,2,-72.82215118,41.45715332
225,"WALNUT CREEK CA",5,1,1,0,0,1,-122.0670624,37.90636826
225,"WALPOLE MA",5,1,1,0,0,1,-71.2485199,42.14173889
225,"WALTHAM MA",5,4,3,0,1,4,-71.2346344,42.37656403
225,"WAREHAM MA",5,1,0,1,0,1,-70.68606567,41.76660156
225,"WARNER ROBINS GA",5,4,1,1,2,4,-83.59963989,32.62118149
225,"WARREN MI",5,92,28,22,42,92,-83.02783203,42.47764969
225,"WARRENTON MO",5,16,1,9,6,16,-91.14160919,38.81156921
225,"WARRENTON VA",5,1,0,0,1,1,-77.79475403,38.71380615
225,"WARWICK RI",5,5,1,3,1,5,-71.37738037,41.69232941
225,"WASHINGTON DC",5,2109,636,578,895,2109,-77.01257324,38.88911819
225,"WASHINGTON MO",5,56,21,16,19,56,-91.01213074,38.55807495
225,"WASHINGTON UT",5,1,0,0,1,1,-113.5095291,37.13038635
225,"WASHOUGAL WA",5,1,0,1,0,1,-122.3545303,45.58441925
225,"WASILLA AK",5,2,0,1,1,2,-149.4517059,61.58290482
225,"WATERBURY CT",5,4,1,0,3,4,-73.05029297,41.55849075
225,"WATERLOO IL",5,2,1,1,0,2,-90.14981842,38.3361702
225,"WATERTOWN NY",5,1,0,0,1,1,-75.9100647,43.97471619
225,"WATERTOWN WI",5,1,0,0,1,1,-88.72946167,43.19454193
225,"WATSONVILLE CA",5,3,1,1,1,3,-121.7594147,36.90995407
225,"WAUKESHA WI",5,4,2,2,0,4,-88.23146057,43.01194382
225,"WAUWATOSA WI",5,4,0,0,4,4,-88.00754547,43.04960632
225,"WAVERLY NE",5,1,0,0,1,1,-96.52924347,40.9175148
225,"WAXHAW NC",5,1,0,0,1,1,-80.74282074,34.92486572
225,"WAYNE NE",5,1,0,1,0,1,-97.01864624,42.23064804
225,"WAYNESVILLE NC",5,1,0,0,1,1,-82.98840332,35.48899078
225,"WEATHERFORD TX",5,1,0,0,1,1,-97.79758453,32.7595253
225,"WEAVERVILLE NC",5,1,0,0,1,1,-82.56031799,35.6974411
225,"WEED CA",5,53,14,19,20,53,-122.388382,41.42225266
225,"WEEHAWKEN NJ",5,1,1,0,0,1,-74.01938629,40.7696991
225,"WELLESLEY MA",5,1,0,0,1,1,-71.29138947,42.29670715
225,"WENTZVILLE MO",5,3,0,1,2,3,-90.85335541,38.81171036
225,"WESLACO TX",5,4,1,2,1,4,-97.99131775,26.16018867
225,"WEST ALLIS WI",5,1,0,0,1,1,-88.00700378,43.01686478
225,"WEST BEND WI",5,1,0,1,0,1,-88.18346405,43.42544556
225,"WEST CALDWELL NJ",5,1,1,0,0,1,-74.30077362,40.84119797
225,"WEST CHESTER OH",5,1,0,0,1,1,-84.40789032,39.33029938
225,"WEST CHESTER PA",5,11,1,7,3,11,-75.60475159,39.96074677
225,"WEST DES MOINES IA",5,4,2,1,1,4,-93.71179962,41.57717514
225,"WEST HARTFORD CT",5,1,0,1,0,1,-72.74108887,41.76238251
225,"WEST HOLLYWOOD CA",5,28,10,6,12,28,-118.3634567,34.08982468
225,"WEST LAFAYETTE IN",5,12,2,3,7,12,-86.9082489,40.42613983
225,"WEST MONROE LA",5,1,0,0,1,1,-92.14794922,32.5187645
225,"WEST ORANGE NJ",5,1,0,1,0,1,-74.23833466,40.7989006
225,"WEST PALM BEACH FL",5,65,19,21,25,65,-80.05298615,26.71585464
225,"WEST PLAINS MO",5,3,1,0,2,3,-91.85284424,36.72810745
225,"WEST TX",5,4,1,1,2,4,-97.09226227,31.80267906
225,"WESTCHESTER IL",5,1,0,0,1,1,-87.88202667,41.85084534
225,"WESTCLIFFE CO",5,1,0,0,1,1,-105.4663086,38.13474274
225,"WESTERLY RI",5,1,0,0,1,1,-71.82659149,41.37784958
225,"WESTERVILLE OH",5,3,1,1,1,3,-82.92906952,40.12620926
225,"WESTFIELD IN",5,1,0,0,1,1,-86.12757111,40.04309464
225,"WESTFIELD WI",5,1,0,1,0,1,-89.49338531,43.88357544
225,"WESTFORD MA",5,3,0,3,0,3,-71.43686676,42.57947159
225,"WESTMINSTER CO",5,2,1,0,1,2,-105.0385208,39.83644867
225,"WESTMONT PA",5,1,0,0,1,1,-78.95119476,40.31570435
225,"WESTPORT CT",5,2,0,0,2,2,-73.35696411,41.14154053
225,"WESTWOOD MA",5,1,1,0,0,1,-71.22348022,42.21436691
225,"WHEATON IL",5,1,1,0,0,1,-88.10729218,41.86618805
225,"WHEELING WV",5,2,0,2,0,2,-80.7192688,40.06991577
225,"WHITE BEAR LAKE MN",5,3,1,0,2,3,-93.01039886,45.08457947
225,"WHITE PLAINS NY",5,1,0,1,0,1,-73.76217651,41.03399658
225,"WHITEFISH MT",5,3,1,2,0,3,-114.3380127,48.41337967
225,"WHITEWATER WI",5,2,0,0,2,2,-88.73226166,42.83348846
225,"WHITTIER CA",5,1,0,1,0,1,-118.0349197,33.9793129
225,"WICHITA FALLS TX",5,4,0,0,4,4,-98.49403381,33.91383743
225,"WICHITA KS",5,33,8,7,18,33,-97.3383255,37.69230652
225,"WILKES-BARRE PA",5,1,0,1,0,1,-75.88058472,41.24601746
225,"WILKINSBURG PA",5,10,4,4,2,10,-79.88179016,40.44174194
225,"WILLIAMSBURG VA",5,14,3,7,4,14,-76.70659637,37.27114868
225,"WILLIAMSON WV",5,2,2,0,0,2,-82.27328491,37.67479324
225,"WILLINGBORO NJ",5,1,1,0,0,1,-74.86815643,40.02816391
225,"WILMETTE IL",5,1,1,0,0,1,-87.72296143,42.07221222
225,"WILMINGTON DE",5,14,5,6,3,14,-75.54558563,39.74601364
225,"WILMINGTON NC",5,13,4,4,5,13,-77.94431305,34.22592926
225,"WILSON NC",5,1,0,0,1,1,-77.914711,35.72143173
225,"WINDER GA",5,1,0,1,0,1,-83.71982574,33.99271393
225,"WINDSOR CT",5,3,2,0,1,3,-72.64279175,41.85288239
225,"WINDSOR MO",5,13,0,6,7,13,-93.5224762,38.53234863
225,"WINFIELD MO",5,1,0,1,0,1,-90.73840332,38.99734879
225,"WINNEMUCCA NV",5,1,0,1,0,1,-117.7377853,40.97271347
225,"WINNETKA IL",5,1,1,0,0,1,-87.73626709,42.10827255
225,"WINONA MN",5,9,3,2,4,9,-91.63965607,44.04986572
225,"WINOOSKI VT",5,1,0,1,0,1,-73.18509674,44.49157333
225,"WINSTON-SALEM NC",5,34,4,14,16,34,-80.24356842,36.1001091
225,"WINTER PARK FL",5,8,2,3,3,8,-81.33872223,28.6003685
225,"WOODBURY MN",5,4,0,1,3,4,-92.95999908,44.92368698
225,"WOODBURY NJ",5,1,1,0,0,1,-75.15171051,39.83841705
225,"WOODINVILLE WA",5,1,0,0,1,1,-122.1656876,47.75372314
225,"WOODLAND CA",5,1,0,0,1,1,-121.7751541,38.67827225
225,"WOODSTOCK GA",5,3,1,1,1,3,-84.51925659,34.10178375
225,"WOOSTER OH",5,1,0,0,1,1,-81.93497467,40.80502319
225,"WORCESTER MA",5,7,3,3,1,7,-71.801651,42.26288986
225,"WRIGHT CITY MO",5,4,1,2,1,4,-91.02021027,38.82786942
225,"WYLIE TX",5,3,0,1,2,3,-96.5396347,33.01520157
225,"WYOMING MI",5,2,0,1,1,2,-85.70549011,42.9133873
225,"YARDLEY PA",5,1,0,0,1,1,-74.8451004,40.2459259
225,"YONKERS NY",5,3,0,1,2,3,-73.89792633,40.93142319
225,"YORK PA",5,4,0,4,0,4,-76.72687531,39.96264267
225,"YORKVILLE IL",5,1,0,1,0,1,-88.44723511,41.64102936
225,"YOUNGSTOWN OH",5,12,5,3,4,12,-80.64901733,41.1000061
225,"YPSILANTI MI",5,13,3,3,7,13,-83.61315155,42.24105453
225,"YUCAIPA CA",5,2,1,0,1,2,-117.0447998,34.03347397
225,"YUCCA VALLEY CA",5,1,0,0,1,1,-116.4475403,34.11928558
225,"ZANESVILLE OH",5,4,0,2,2,4,-82.01314545,39.94056702
226,"ABBEVILLE SC",6,2,1,0,1,2,-82.37889099,34.1785202
226,"ABERDEEN MD",6,2,0,0,2,2,-76.16343689,39.50980759
226,"ABERDEEN NC",6,1,0,0,1,1,-79.42922211,35.13199615
226,"ABERDEEN SD",6,6,0,5,1,6,-98.48273468,45.46180344
226,"ABERDEEN WA",6,8,4,1,3,8,-123.8181381,46.97493744
226,"ABILENE KS",6,6,5,1,0,6,-97.21461487,38.9171524
226,"ABILENE TX",6,44,11,17,16,44,-99.73384094,32.44894028
226,"ABINGDON VA",6,1,0,1,0,1,-81.97711945,36.7100563
226,"ABINGTON MA",6,1,1,0,0,1,-70.94435883,42.1049118
226,"ABINGTON PA",6,3,1,0,2,3,-75.11743164,40.12073898
226,"ABSECON NJ",6,76,23,17,36,76,-74.49462128,39.42850494
226,"ACTON MA",6,22,5,8,9,22,-71.43197632,42.48540115
226,"ACWORTH GA",6,3,0,2,1,3,-84.67662811,34.06597519
226,"ADA OH",6,2,1,0,1,2,-83.82268524,40.76944351
226,"ADA OK",6,8,2,2,4,8,-96.67899323,34.77481842
226,"ADAMS MA",6,1,0,1,0,1,-73.1167984,42.62440872
226,"ADAMSTOWN PA",6,1,0,1,0,1,-76.05577087,40.2414856
226,"ADDISON IL",6,3,0,0,3,3,-87.98938751,41.93162155
226,"ADDISON NY",6,1,1,0,0,1,-77.23320007,42.1031456
226,"ADDISON TX",6,34,13,7,14,34,-96.82976532,32.96215057
226,"ADEL IA",6,1,0,1,0,1,-94.01776123,41.6144371
226,"ADELANTO CA",6,4,3,0,1,4,-117.4104309,34.58280563
226,"ADRIAN MI",6,6,1,1,4,6,-84.03691101,41.89771652
226,"ADRIAN MO",6,2,0,1,1,2,-94.35219574,38.39756775
226,"AHOSKIE NC",6,1,0,1,0,1,-76.98433685,36.28694534
226,"AIKEN SC",6,12,4,1,7,12,-81.71619415,33.55714417
226,"AIRMONT NY",6,4,0,3,1,4,-74.11543274,41.10093689
226,"AKRON OH",6,310,103,76,131,310,-81.51885223,41.08151627
226,"AKRON PA",6,3,1,1,1,3,-76.20130157,40.15691757
226,"ALACHUA FL",6,3,2,0,1,3,-82.49368286,29.79605484
226,"ALAMEDA CA",6,158,37,43,78,158,-122.2444763,37.76513672
226,"ALAMOGORDO NM",6,9,3,4,2,9,-105.9584656,32.90003967
226,"ALAMOSA CO",6,11,3,2,6,11,-105.8724442,37.46229935
226,"ALBANY GA",6,13,3,4,6,13,-84.15510559,31.58296013
226,"ALBANY KY",6,1,0,0,1,1,-85.13433075,36.69089127
226,"ALBANY LA",6,19,6,3,10,19,-90.58232117,30.50474739
226,"ALBANY NY",6,261,54,67,140,261,-73.75520325,42.6529007
226,"ALBANY OR",6,7,3,3,1,7,-123.1083984,44.63620758
226,"ALBERT LEA MN",6,2,0,0,2,2,-93.36846924,43.6479454
226,"ALBERTVILLE AL",6,3,0,0,3,3,-86.20863342,34.26794434
226,"ALBION PA",6,3,2,0,1,3,-80.3659668,41.88935471
226,"ALBUQUERQUE NM",6,566,165,163,238,566,-106.6517639,35.08336639
226,"ALCOA TN",6,19,4,6,9,19,-83.96761322,35.77825165
226,"ALEXANDRIA IN",6,1,0,0,1,1,-85.67569733,40.2626915
226,"ALEXANDRIA LA",6,26,5,7,14,26,-92.44517517,31.31143761
226,"ALEXANDRIA MN",6,7,1,3,3,7,-95.37786865,45.88516617
226,"ALEXANDRIA VA",6,433,151,97,185,433,-77.04605103,38.80503082
226,"ALGOMA WI",6,2,0,1,1,2,-87.43292999,44.60874557
226,"ALGONA IA",6,2,0,1,1,2,-94.2338028,43.06998444
226,"ALHAMBRA CA",6,9,2,1,6,9,-118.1287003,34.0954628
226,"ALICE TX",6,2,0,2,0,2,-98.07035828,27.7528286
226,"ALICEVILLE AL",6,1,1,0,0,1,-88.15151978,33.12960434
226,"ALIQUIPPA PA",6,2,0,1,1,2,-80.23978424,40.63685608
226,"ALLEGAN MI",6,3,2,0,1,3,-85.85546112,42.52919769
226,"ALLEN PARK MI",6,1,0,0,1,1,-83.21057892,42.25782394
226,"ALLEN TX",6,22,7,6,9,22,-96.67116547,33.10336685
226,"ALLENTOWN PA",6,67,8,24,35,67,-75.46569824,40.60851288
226,"ALLIANCE OH",6,1,0,0,1,1,-81.10575867,40.91523743
226,"ALMA AR",6,2,2,0,0,2,-94.22241974,35.47818375
226,"ALMA MI",6,1,0,1,0,1,-84.65994263,43.37918854
226,"ALMONT MI",6,2,2,0,0,2,-83.04501343,42.9206543
226,"ALPENA MI",6,1,0,0,1,1,-83.43292999,45.06164551
226,"ALPHARETTA GA",6,24,5,11,8,24,-84.29410553,34.07542419
226,"ALPINE TX",6,2,1,0,1,2,-103.6622238,30.35860062
226,"ALSIP IL",6,1,0,0,1,1,-87.73867035,41.66915894
226,"ALTA IA",6,1,0,0,1,1,-95.3097229,42.67442703
226,"ALTAMONTE SPRINGS FL",6,5,2,1,2,5,-81.39485931,28.66284752
226,"ALTON IL",6,95,35,26,34,95,-90.18429565,38.89074326
226,"ALTOONA IA",6,2,1,0,1,2,-93.46868896,41.64997482
226,"ALTOONA PA",6,21,6,6,9,21,-78.39411163,40.51860046
226,"ALTUS OK",6,1,1,0,0,1,-99.33457184,34.63834
226,"ALVA OK",6,6,3,0,3,6,-98.66719055,36.80501556
226,"ALVIN TX",6,4,1,3,0,4,-95.24459076,29.42417526
226,"AMARILLO TX",6,62,11,22,29,62,-101.8324051,35.22210312
226,"AMBLER PA",6,4,0,2,2,4,-75.2210083,40.15485382
226,"AMERICAN FORK UT",6,2,1,0,1,2,-111.8032379,40.34251022
226,"AMERICUS GA",6,1,0,0,1,1,-84.23246002,32.07291031
226,"AMES IA",6,306,71,78,157,306,-93.61370087,42.02269363
226,"AMHERST MA",6,43,11,12,20,43,-72.5192337,42.37371826
226,"AMHERST OH",6,17,4,6,7,17,-82.22229767,41.39805603
226,"AMITYVILLE NY",6,1,0,1,0,1,-73.41622162,40.67899323
226,"AMMON ID",6,1,1,0,0,1,-111.9684067,43.46959305
226,"AMORY MS",6,7,2,1,4,7,-88.48745728,33.98094559
226,"ANACORTES WA",6,11,1,4,6,11,-122.6148834,48.51247025
226,"ANADARKO OK",6,2,1,1,0,2,-98.2443161,35.07276535
226,"ANAHEIM CA",6,103,29,31,43,103,-117.9165115,33.8354454
226,"ANCHORAGE AK",6,296,108,70,118,296,-149.8811951,61.21649933
226,"ANDERSON IN",6,72,17,18,37,72,-85.68051147,40.1053772
226,"ANDERSON SC",6,19,5,8,6,19,-82.65641785,34.50934219
226,"ANDOVER KS",6,4,2,2,0,4,-97.13726807,37.71379852
226,"ANDOVER MA",6,14,4,5,5,14,-71.13011169,42.65668869
226,"ANDOVER MN",6,2,1,0,1,2,-93.29158783,45.23327637
226,"ANDREWS TX",6,1,1,0,0,1,-102.5462036,32.31894684
226,"ANGOLA NY",6,2,0,1,1,2,-79.0273056,42.63856506
226,"ANKENY IA",6,26,8,6,12,26,-93.60646057,41.72983551
226,"ANN ARBOR MI",6,718,208,184,326,718,-83.74536896,42.28347015
226,"ANNA TX",6,1,0,0,1,1,-96.5491333,33.34925842
226,"ANNAPOLIS MD",6,113,30,36,47,113,-76.49166107,38.97844696
226,"ANNISTON AL",6,4,3,0,1,4,-85.8313446,33.65997314
226,"ANNVILLE PA",6,1,0,1,0,1,-76.51483917,40.32979584
226,"ANOKA MN",6,4,1,1,2,4,-93.3874588,45.19776535
226,"ANSONIA CT",6,13,3,2,8,13,-73.0779953,41.34640884
226,"ANTIOCH CA",6,45,12,14,19,45,-121.808136,38.0049057
226,"APACHE JUNCTION AZ",6,9,3,4,2,9,-111.5511551,33.41511536
226,"APEX NC",6,12,2,5,5,12,-78.84952545,35.73279572
226,"APOLLO PA",6,1,1,0,0,1,-79.56620789,40.58155441
226,"APOPKA FL",6,6,3,1,2,6,-81.5089798,28.68117523
226,"APPLE VALLEY MN",6,12,4,0,8,12,-93.21794128,44.73189926
226,"APPLETON WI",6,107,39,26,42,107,-88.41551208,44.2618866
226,"ARAB AL",6,22,3,11,8,22,-86.49552917,34.31829453
226,"ARCADIA CA",6,8,2,2,4,8,-118.0368881,34.1397934
226,"ARCADIA FL",6,2,0,1,1,2,-81.85810089,27.21654701
226,"ARCADIA LA",6,2,0,0,2,2,-92.92064667,32.54955673
226,"ARCANUM OH",6,2,0,0,2,2,-84.55335236,39.9899826
226,"ARCATA CA",6,40,12,14,14,40,-124.08564,40.86624527
226,"ARCHDALE NC",6,2,1,1,0,2,-79.97145844,35.91481018
226,"ARDEN DE",6,1,0,1,0,1,-75.48575592,39.8094902
226,"ARDEN HILLS MN",6,1,1,0,0,1,-93.15720367,45.05033112
226,"ARDMORE OK",6,16,8,4,4,16,-97.14401245,34.17425156
226,"ARENZVILLE IL",6,1,1,0,0,1,-90.37351227,39.87685394
226,"ARKADELPHIA AR",6,4,1,2,1,4,-93.05423737,34.12095642
226,"ARKANSAS CITY KS",6,6,1,2,3,6,-97.03897858,37.06211472
226,"ARKPORT NY",6,1,0,1,0,1,-77.69580841,42.39464188
226,"ARLINGTON HEIGHTS IL",6,145,41,39,65,145,-87.98104858,42.08821106
226,"ARLINGTON MA",6,26,8,3,15,26,-71.15559387,42.41545486
226,"ARLINGTON TN",6,2,0,1,1,2,-89.66139984,35.29637527
226,"ARLINGTON TX",6,261,82,66,113,261,-97.10882568,32.73590469
226,"ARLINGTON WA",6,6,1,1,4,6,-122.1277237,48.19829941
226,"ARNOLD MO",6,13,1,1,11,13,-90.37690735,38.43906784
226,"ARROYO GRANDE CA",6,10,2,2,6,10,-120.5928879,35.11868668
226,"ARVADA CO",6,13,6,5,2,13,-105.0886612,39.8028183
226,"ARVIN CA",6,2,1,1,0,2,-118.8308792,35.20893478
226,"ASBURY PARK NJ",6,34,10,7,17,34,-74.01100159,40.22047806
226,"ASH GROVE MO",6,3,1,1,1,3,-93.58557892,37.31526566
226,"ASHBURN GA",6,5,1,1,3,5,-83.65306091,31.70657539
226,"ASHEBORO NC",6,5,1,1,3,5,-79.81291199,35.70822525
226,"ASHEVILLE NC",6,429,131,98,200,429,-82.55367279,35.60134888
226,"ASHLAND IL",6,3,0,2,1,3,-90.00800323,39.88794327
226,"ASHLAND KY",6,1,1,0,0,1,-82.63764954,38.47874069
226,"ASHLAND MO",6,4,1,1,2,4,-92.25737762,38.77433395
226,"ASHLAND OH",6,6,1,1,4,6,-82.31797028,40.86874771
226,"ASHLAND OR",6,132,32,37,63,132,-122.7111359,42.19425583
226,"ASHLAND VA",6,37,9,12,16,37,-77.47959137,37.75937653
226,"ASHLAND WI",6,6,3,1,2,6,-90.88419342,46.59241104
226,"ASHTABULA OH",6,11,2,2,7,11,-80.78971863,41.86506653
226,"ASHWAUBENON WI",6,1,0,1,0,1,-88.07009888,44.48205185
226,"ASPEN CO",6,46,16,12,18,46,-106.8185959,39.19105911
226,"ASTORIA OR",6,23,6,6,11,23,-123.8339157,46.18756866
226,"ATASCADERO CA",6,1,0,0,1,1,-120.6487961,35.47494888
226,"ATHENS AL",6,5,1,0,4,5,-86.97190857,34.80292892
226,"ATHENS IL",6,4,1,2,1,4,-89.72410583,39.96085739
226,"ATHENS OH",6,82,20,18,44,82,-82.10113525,39.32934952
226,"ATHENS PA",6,37,9,11,17,37,-76.52072906,41.9661293
226,"ATHENS TX",6,3,2,0,1,3,-95.85599518,32.20513916
226,"ATHOL MA",6,1,1,0,0,1,-72.22972107,42.59287643
226,"ATLANTA GA",6,7654,2231,1972,3451,7654,-84.38757324,33.74927521
226,"ATLANTA IN",6,3,1,2,0,3,-86.02610016,40.21550751
226,"ATLANTIC BEACH FL",6,12,3,2,7,12,-81.39808655,30.33498573
226,"ATLANTIC CITY NJ",6,80,23,24,33,80,-74.42202759,39.36457062
226,"ATLANTIC HIGHLANDS NJ",6,1,0,0,1,1,-74.03326416,40.40827942
226,"ATOKA OK",6,1,0,0,1,1,-96.12915039,34.38588333
226,"ATTALLA AL",6,1,0,0,1,1,-86.08874512,34.02215958
226,"ATTLEBORO MA",6,6,3,0,3,6,-71.28439331,41.94469833
226,"ATWATER CA",6,4,1,0,3,4,-120.6140137,37.34663773
226,"AUBREY TX",6,1,0,1,0,1,-96.98683167,33.30471039
226,"AUBURN AL",6,87,30,17,40,87,-85.48087311,32.61021423
226,"AUBURN CA",6,195,52,53,90,195,-121.0794067,38.89623642
226,"AUBURN GA",6,1,0,0,1,1,-83.82753754,34.01380157
226,"AUBURN MA",6,1,0,1,0,1,-71.84958649,42.18192291
226,"AUBURN ME",6,3,0,1,2,3,-70.23028564,44.09794235
226,"AUBURN NY",6,11,1,2,8,11,-76.56542969,42.93203735
226,"AUBURN WA",6,35,12,10,13,35,-122.2304688,47.30677795
226,"AUGUSTA KS",6,13,5,3,5,13,-96.97721863,37.68652725
226,"AUGUSTA ME",6,7,1,3,3,7,-69.7781601,44.31053925
226,"AURORA CO",6,145,42,32,71,145,-104.8693161,39.73983765
226,"AURORA IL",6,96,30,30,36,96,-88.32048798,41.76070023
226,"AURORA NC",6,2,1,1,0,2,-76.78784943,35.30578995
226,"AUSTELL GA",6,42,10,9,23,42,-84.63414001,33.81290054
226,"AUSTIN MN",6,6,3,2,1,6,-92.97491455,43.6665535
226,"AUSTIN TX",6,5442,1552,1528,2362,5442,-97.74386597,30.26748466
226,"AUSTINTOWN OH",6,39,6,12,21,39,-80.76424408,41.10162354
226,"AVA MO",6,1,0,1,0,1,-92.6605835,36.95189667
226,"AVIS PA",6,5,2,1,2,5,-77.31352997,41.1848526
226,"AVOCA NY",6,3,0,2,1,3,-77.42100525,42.40945435
226,"AVON CO",6,1,1,0,0,1,-106.5237427,39.63142395
226,"AVON PARK FL",6,1,1,0,0,1,-81.50580597,27.59641075
226,"AVONDALE AZ",6,51,19,10,22,51,-112.3513947,33.43592072
226,"AVONDALE PA",6,1,0,1,0,1,-75.78266907,39.82365036
226,"AZLE TX",6,4,1,3,0,4,-97.54621887,32.89556885
226,"AZTEC NM",6,2,1,1,0,2,-107.9938355,36.82159805
226,"AZUSA CA",6,28,9,5,14,28,-117.9098816,34.13357544
226,"BAKERSFIELD CA",6,204,53,57,94,204,-119.0206375,35.37326813
226,"BAKERSVILLE NC",6,2,1,1,0,2,-82.15859985,36.01586914
226,"BALDWIN CITY KS",6,1,0,0,1,1,-95.18656921,38.77522659
226,"BALDWIN PARK CA",6,4,2,0,2,4,-117.9624786,34.08519363
226,"BALDWINSVILLE NY",6,1,1,0,0,1,-76.33219147,43.15886307
226,"BALDWYN MS",6,6,1,0,5,6,-88.63553619,34.5099411
226,"BALLSTON SPA NY",6,16,6,3,7,16,-73.84790039,43.00103378
226,"BALLWIN MO",6,33,9,10,14,33,-90.54669189,38.5951004
226,"BALTIMORE MD",6,2617,708,704,1205,2617,-76.6115799,39.29075623
226,"BAMBERG SC",6,1,0,0,1,1,-81.03459167,33.2973938
226,"BANDERA TX",6,1,0,0,1,1,-99.07427216,29.72691536
226,"BANGOR ME",6,56,12,19,25,56,-68.77653503,44.80109406
226,"BANGOR PA",6,4,1,0,3,4,-75.20609283,40.86587524
226,"BANNING CA",6,9,2,2,5,9,-116.878746,33.92569351
226,"BAR HARBOR ME",6,11,0,1,10,11,-68.20309448,44.38752747
226,"BARABOO WI",6,17,4,4,9,17,-89.74446869,43.47089767
226,"BARBERTON OH",6,1,1,0,0,1,-81.60507965,41.0127182
226,"BARBOURVILLE KY",6,4,2,1,1,4,-83.88861084,36.86665726
226,"BARDSTOWN KY",6,14,3,4,0,7,-85.46318817,37.810512545
226,"BARGERSVILLE IN",6,1,0,0,1,1,-86.16780853,39.52098083
226,"BARNESVILLE GA",6,1,0,0,1,1,-84.15583038,33.05487442
226,"BARRINGTON IL",6,1,1,0,0,1,-88.13623047,42.15398788
226,"BARTLESVILLE OK",6,1,0,0,1,1,-95.98135376,36.74737549
226,"BARTLETT IL",6,4,1,2,1,4,-88.18564606,41.9950676
226,"BARTLETT KS",6,1,0,1,0,1,-95.21155548,37.05488205
226,"BARTLETT TN",6,4,1,1,2,4,-89.87441254,35.20460892
226,"BARTONVILLE IL",6,45,17,9,19,45,-89.65235138,40.6502037
226,"BASALT CO",6,1,1,0,0,1,-107.0336685,39.36895752
226,"BASTROP LA",6,1,1,0,0,1,-91.91439819,32.77897644
226,"BASTROP TX",6,2,0,0,2,2,-97.31572723,30.11092758
226,"BATAVIA NY",6,14,3,4,7,14,-78.18697357,42.99835587
226,"BATAVIA OH",6,3,1,1,1,3,-84.17655182,39.07704926
226,"BATESVILLE AR",6,4,1,2,1,4,-91.64100647,35.76984024
226,"BATESVILLE MS",6,22,3,10,9,22,-89.94464874,34.31167603
226,"BATH ME",6,2,0,0,2,2,-69.81929779,43.9107132
226,"BATON ROUGE LA",6,404,124,97,183,404,-91.15479279,30.45132256
226,"BATTLE CREEK MI",6,9,4,1,4,9,-85.17985535,42.32100677
226,"BATTLE GROUND WA",6,8,3,3,2,8,-122.5356064,45.78078842
226,"BAXLEY GA",6,1,0,1,0,1,-82.34827423,31.77871323
226,"BAY CITY MI",6,30,10,7,13,30,-83.8886261,43.59466171
226,"BAY LAKE FL",6,23,4,6,13,23,-81.92185974,28.45840073
226,"BAY VILLAGE OH",6,17,4,7,6,17,-81.92155457,41.48464966
226,"BAYONNE NJ",6,18,4,4,10,18,-74.10975647,40.66794968
226,"BAYTOWN TX",6,44,13,16,15,44,-94.97782135,29.73608589
226,"BEACON NY",6,34,8,14,12,34,-73.9688797,41.50502014
226,"BEAR LAKE MI",6,2,2,0,0,2,-86.14846802,44.42086029
226,"BEATRICE NE",6,1,0,1,0,1,-96.74773407,40.26797104
226,"BEAUFORT SC",6,6,2,2,2,6,-80.68718719,32.44019699
226,"BEAUMONT CA",6,2,2,0,0,2,-116.9783173,33.9292717
226,"BEAUMONT TX",6,62,16,15,31,62,-94.10238647,30.08622551
226,"BEAVER DAM WI",6,2,2,0,0,2,-88.83752441,43.45764542
226,"BEAVER FALLS PA",6,1,1,0,0,1,-80.3188858,40.75218582
226,"BEAVER PA",6,2,1,1,0,2,-80.30450439,40.69532776
226,"BEAVERCREEK OH",6,15,3,5,7,15,-84.06332397,39.70913696
226,"BEAVERTON OR",6,154,48,39,67,154,-122.8055344,45.48670197
226,"BECKLEY WV",6,5,1,3,1,5,-81.18963623,37.77680588
226,"BEDFORD MA",6,2,1,1,0,2,-71.27526855,42.49069214
226,"BEDFORD NY",6,9,4,2,3,9,-73.64318085,41.204319
226,"BEDFORD OH",6,3,0,2,1,3,-81.53594208,41.39339828
226,"BEDFORD PA",6,4,2,0,2,4,-78.50319672,40.01898575
226,"BEDFORD TX",6,15,6,4,5,15,-97.14364624,32.8442955
226,"BEDFORD VA",6,1,0,1,0,1,-79.52242279,37.33457184
226,"BEDMINSTER NJ",6,4,0,2,2,4,-74.64486694,40.68070602
226,"BEECH GROVE IN",6,2,1,0,1,2,-86.08973694,39.72201157
226,"BEECHER CITY IL",6,2,0,0,2,2,-88.78668976,39.18835068
226,"BEEVILLE TX",6,3,1,1,1,3,-97.7488327,28.40157127
226,"BEL AIR MD",6,23,7,7,9,23,-76.34788513,39.53611374
226,"BELCHERTOWN MA",6,1,0,1,0,1,-72.40000153,42.27737427
226,"BELL CA",6,12,2,3,7,12,-118.1889572,33.97753906
226,"BELL GARDENS CA",6,2,0,0,2,2,-118.1536942,33.96530914
226,"BELLE GLADE FL",6,5,2,1,2,5,-80.66747284,26.68785477
226,"BELLEFONTE PA",6,20,3,5,12,20,-77.77765656,40.91333389
226,"BELLEVIEW FL",6,4,0,4,0,4,-82.06185913,29.05568314
226,"BELLEVILLE IL",6,132,42,33,57,132,-89.98438263,38.52002716
226,"BELLEVILLE MI",6,2,1,0,1,2,-83.48514557,42.20495987
226,"BELLEVILLE NJ",6,1,0,1,0,1,-74.14912415,40.79369736
226,"BELLEVUE KY",6,6,3,1,2,6,-84.47879791,39.10644531
226,"BELLEVUE NE",6,16,4,3,9,16,-95.89156342,41.13648224
226,"BELLEVUE WA",6,119,41,34,44,119,-122.2029648,47.61014557
226,"BELLFLOWER CA",6,22,3,5,14,22,-118.1186295,33.88169479
226,"BELLINGHAM WA",6,155,52,40,63,155,-122.4727402,48.76121521
226,"BELLMAWR NJ",6,7,0,0,7,7,-75.09385681,39.86771774
226,"BELLPORT NY",6,9,1,3,5,9,-72.93808746,40.75737
226,"BELLVILLE TX",6,2,0,1,1,2,-96.25782776,29.95071411
226,"BELLWOOD IL",6,1,1,0,0,1,-87.88317108,41.88128662
226,"BELMAR NJ",6,2,1,1,0,2,-74.02155304,40.17336273
226,"BELMONT CA",6,36,15,7,14,36,-122.2783508,37.51996613
226,"BELMONT MA",6,1,0,0,1,1,-71.1774292,42.39597321
226,"BELMONT NC",6,7,1,1,5,7,-81.0369873,35.24316406
226,"BELOIT WI",6,9,2,3,4,9,-89.03194427,42.50856781
226,"BELTON MO",6,6,1,3,2,6,-94.53222656,38.81176376
226,"BELTON TX",6,19,4,7,8,19,-97.46511841,31.05611229
226,"BELVIDERE IL",6,3,1,1,1,3,-88.84451294,42.26396942
226,"BEMIDJI MN",6,21,5,7,9,21,-94.88105774,47.47352982
226,"BEND OR",6,106,30,27,49,106,-121.3171387,44.0577774
226,"BENICIA CA",6,25,7,7,11,25,-122.1603012,38.04900742
226,"BENNETT CO",6,3,0,1,2,3,-104.4285889,39.75864792
226,"BENSENVILLE IL",6,8,1,4,3,8,-87.94012451,41.95510483
226,"BENSON NC",6,2,1,1,0,2,-78.54795074,35.38231659
226,"BENTON HARBOR MI",6,7,1,3,3,7,-86.45429993,42.11692429
226,"BENTON LA",6,1,0,1,0,1,-93.74242401,32.69527817
226,"BENTONVILLE AR",6,15,4,6,5,15,-94.20933533,36.3728447
226,"BEREA KY",6,5,4,1,0,5,-84.29612732,37.5687027
226,"BEREA OH",6,7,2,2,3,7,-81.85396576,41.36633301
226,"BERKELEY CA",6,753,222,197,334,753,-122.2752533,37.87145615
226,"BERKELEY HEIGHTS NJ",6,1,0,1,0,1,-74.44181824,40.68349838
226,"BERKELEY MO",6,9,5,2,2,9,-90.33169556,38.75470734
226,"BERKLEY MI",6,9,0,4,5,9,-83.18341827,42.50307083
226,"BERLIN MD",6,1,0,0,1,1,-75.21686554,38.32276917
226,"BERLIN NJ",6,1,0,0,1,1,-74.9280014,39.79132462
226,"BERNALILLO NM",6,7,3,3,1,7,-106.5516357,35.30175781
226,"BERRIEN SPRINGS MI",6,7,3,1,3,7,-86.33900452,41.94654846
226,"BERRYVILLE VA",6,1,0,1,0,1,-77.9814682,39.15181732
226,"BERWICK PA",6,5,3,0,2,5,-76.23230743,41.05486679
226,"BERWYN IL",6,17,7,4,6,17,-87.79390717,41.85061646
226,"BESSEMER AL",6,7,1,1,5,7,-86.95465851,33.40222549
226,"BESSEMER CITY NC",6,1,0,0,1,1,-81.28375244,35.28520966
226,"BETHALTO IL",6,1,0,0,1,1,-90.04077911,38.90911865
226,"BETHEL PARK PA",6,1,1,0,0,1,-80.01592255,40.33843613
226,"BETHLEHEM PA",6,114,30,24,60,114,-75.36949921,40.62598801
226,"BETTENDORF IA",6,5,1,1,3,5,-90.51612854,41.52465439
226,"BEVERLY HILLS CA",6,96,24,25,47,96,-118.4019775,34.07383347
226,"BEVERLY HILLS MI",6,1,1,0,0,1,-83.22288513,42.52407837
226,"BEVERLY MA",6,10,3,2,5,10,-70.87913513,42.55848312
226,"BEXLEY OH",6,4,3,1,0,4,-82.93772888,39.96929932
226,"BIDDEFORD ME",6,2,0,1,1,2,-70.45225525,43.49275208
226,"BIG LAKE MN",6,1,0,0,1,1,-93.7464447,45.33234787
226,"BIG RAPIDS MI",6,16,3,6,7,16,-85.48376465,43.69808578
226,"BIG SANDY TX",6,4,1,3,0,4,-95.10948181,32.58401871
226,"BIG SPRING TX",6,11,4,5,2,11,-101.4811173,32.25181198
226,"BIGGS CA",6,1,0,1,0,1,-121.7154388,39.41196823
226,"BILLERICA MA",6,1,0,0,1,1,-71.26820374,42.55883408
226,"BILLINGS MT",6,15,2,4,9,15,-108.504631,45.7833786
226,"BILOXI MS",6,28,6,9,13,28,-88.89369202,30.40021133
226,"BINGHAMTON NY",6,85,25,27,33,85,-75.91755676,42.0986557
226,"BIRMINGHAM AL",6,1025,268,283,474,1025,-86.80226898,33.52098846
226,"BIRMINGHAM MI",6,34,9,8,17,34,-83.21121216,42.54697418
226,"BISBEE AZ",6,81,21,27,33,81,-109.9298477,31.44821548
226,"BISHOP CA",6,1,1,0,0,1,-118.3968735,37.36342239
226,"BISHOPVILLE SC",6,2,0,0,2,2,-80.24495697,34.21529007
226,"BISMARCK ND",6,13,2,2,9,13,-100.7789612,46.80673981
226,"BIXBY OK",6,5,1,2,2,5,-95.88382721,35.94215775
226,"BLACK MOUNTAIN NC",6,20,7,7,6,20,-82.32103729,35.61796188
226,"BLACKFOOT ID",6,1,1,0,0,1,-112.3463059,43.1905098
226,"BLACKSBURG VA",6,116,37,28,51,116,-80.41369629,37.22999573
226,"BLACKSTONE VA",6,7,2,0,5,7,-77.99647522,37.08090591
226,"BLACKVILLE SC",6,1,0,0,1,1,-81.27037048,33.35803604
226,"BLADENSBURG MD",6,4,1,1,2,4,-76.9335556,38.93954849
226,"BLAINE MN",6,3,0,1,2,3,-93.23551178,45.171978
226,"BLAINE WA",6,2,0,2,0,2,-122.7500839,48.99335098
226,"BLAIRSVILLE GA",6,1,0,0,1,1,-83.95786285,34.87645721
226,"BLISSFIELD MI",6,1,0,0,1,1,-83.86232758,41.83250046
226,"BLOOMFIELD HILLS MI",6,7,2,2,3,7,-83.24560547,42.58376312
226,"BLOOMFIELD NJ",6,1,1,0,0,1,-74.18488312,40.8069458
226,"BLOOMINGDALE IL",6,1,0,1,0,1,-88.08078766,41.95762634
226,"BLOOMINGTON IL",6,27,8,10,9,27,-88.99375916,40.48418045
226,"BLOOMINGTON IN",6,283,89,78,116,283,-86.53382874,39.16920471
226,"BLOOMINGTON MN",6,11,2,5,4,11,-93.29154205,44.82648849
226,"BLOOMSBURG PA",6,7,2,2,3,7,-76.45426178,41.00380325
226,"BLOWING ROCK NC",6,1,0,1,0,1,-81.67708588,36.13526535
226,"BLUE ISLAND IL",6,4,1,2,1,4,-87.67993927,41.657444
226,"BLUE RIDGE GA",6,2,1,0,1,2,-84.32199097,34.86791229
226,"BLUE SPRINGS MO",6,31,8,10,13,31,-94.2820816,39.01689148
226,"BLUEFIELD WV",6,2,0,1,1,2,-81.21854401,37.27106094
226,"BLUFF CITY TN",6,5,0,1,4,5,-82.26051331,36.47451019
226,"BLUFFTON GA",6,2,1,1,0,2,-84.86750031,31.5231266
226,"BLUFFTON IN",6,3,0,0,3,3,-85.17154694,40.73873138
226,"BLUFFTON OH",6,1,1,0,0,1,-83.88886261,40.89531326
226,"BLYTHEVILLE AR",6,2,1,1,0,2,-89.91928101,35.92730713
226,"BLYTHEWOOD SC",6,2,1,0,1,2,-80.97387695,34.21453476
226,"BOARDMAN OH",6,2,0,1,1,2,-80.66256714,41.02441788
226,"BOAZ AL",6,1,1,0,0,1,-86.16611481,34.20103073
226,"BOCA RATON FL",6,86,25,20,41,86,-80.08280182,26.35960197
226,"BOERNE TX",6,1,0,0,1,1,-98.73278046,29.79491997
226,"BOGALUSA LA",6,1,1,0,0,1,-89.84885406,30.79155159
226,"BOILING SPRINGS NC",6,1,0,0,1,1,-81.66678619,35.25450516
226,"BOLINGBROOK IL",6,81,35,18,28,81,-88.06878662,41.69866562
226,"BOLIVAR MO",6,2,0,1,1,2,-93.41101074,37.61450195
226,"BONHAM TX",6,1,0,0,1,1,-96.17896271,33.57743454
226,"BONITA SPRINGS FL",6,4,2,1,1,4,-81.77822876,26.34039497
226,"BONNE TERRE MO",6,1,0,1,0,1,-90.55574036,37.92339325
226,"BONNERS FERRY ID",6,1,1,0,0,1,-116.3183136,48.69117737
226,"BONNEY LAKE WA",6,16,7,5,4,16,-122.1883698,47.17679596
226,"BOONE IA",6,1,0,1,0,1,-93.88450623,42.06530762
226,"BOONE NC",6,67,24,16,27,67,-81.67436218,36.21696472
226,"BOONTON NJ",6,2,0,0,2,2,-74.4063797,40.90301514
226,"BOONVILLE MO",6,1,1,0,0,1,-92.74378967,38.97373962
226,"BORDENTOWN NJ",6,6,1,3,2,6,-74.7159729,40.15003586
226,"BOSCOBEL WI",6,2,1,0,1,2,-90.70555115,43.13436127
226,"BOSSIER CITY LA",6,27,9,6,12,27,-93.73249817,32.51643753
226,"BOSTON MA",6,4744,1422,1258,2064,4744,-71.05905151,42.35883713
226,"BOTHELL WA",6,42,8,11,23,42,-122.2075424,47.75966263
226,"BOULDER CO",6,467,138,126,203,467,-105.2715302,40.01483917
226,"BOUND BROOK NJ",6,4,1,2,1,4,-74.53753662,40.5687561
226,"BOUNTIFUL UT",6,2,0,0,2,2,-111.8825684,40.88913345
226,"BOWBELLS ND",6,1,0,0,1,1,-102.2465668,48.80357361
226,"BOWIE MD",6,141,37,45,59,141,-76.77848816,39.00718689
226,"BOWLING GREEN KY",6,63,24,16,23,63,-86.4437027,36.99057388
226,"BOWLING GREEN OH",6,31,5,11,15,31,-83.65102386,41.37505341
226,"BOYERTOWN PA",6,2,1,0,1,2,-75.63640594,40.33397675
226,"BOYNTON BEACH FL",6,26,7,5,14,26,-80.066185,26.52592087
226,"BOZEMAN MT",6,107,22,32,53,107,-111.0471649,45.6803093
226,"BRADDOCK PA",6,1,0,0,1,1,-79.86782837,40.4034462
226,"BRADENTON FL",6,43,14,13,16,43,-82.57459259,27.49969101
226,"BRADFORD PA",6,2,1,1,0,2,-78.64337921,41.95611572
226,"BRADLEY IL",6,2,1,0,1,2,-87.86099243,41.14196014
226,"BRAINERD MN",6,1,0,0,1,1,-94.20135498,46.35787582
226,"BRANCHVILLE SC",6,3,2,0,1,3,-80.81507111,33.25175858
226,"BRANDON MS",6,2,0,1,1,2,-89.98616028,32.27327728
226,"BRANDON SD",6,5,2,3,0,5,-96.58744049,43.58988571
226,"BRANFORD FL",6,1,1,0,0,1,-82.92802429,29.95959473
226,"BRANSON MO",6,10,5,2,3,10,-93.21912384,36.64381409
226,"BRANTLEY AL",6,1,0,0,1,1,-86.25697327,31.5824852
226,"BRATTLEBORO VT",6,1,0,1,0,1,-72.55673981,42.85120392
226,"BRAWLEY CA",6,3,0,2,1,3,-115.5312119,32.97854614
226,"BRAZIL IN",6,1,0,0,1,1,-87.12501526,39.52391434
226,"BRAZORIA TX",6,5,3,0,2,5,-95.56978607,29.04499435
226,"BREA CA",6,10,2,0,8,10,-117.9015732,33.91663361
226,"BRECKENRIDGE CO",6,1,0,1,0,1,-106.0398636,39.48156357
226,"BRECKSVILLE OH",6,2,2,0,0,2,-81.62625122,41.32006836
226,"BREESE IL",6,2,1,1,0,2,-89.52734375,38.61071396
226,"BREMERTON WA",6,23,4,10,9,23,-122.6345291,47.56690598
226,"BRENHAM TX",6,5,2,0,3,5,-96.39807129,30.16748047
226,"BRENT AL",6,1,1,0,0,1,-87.16462708,32.9375
226,"BRENTWOOD CA",6,13,5,2,6,13,-121.6984329,37.93167496
226,"BRENTWOOD MO",6,6,3,0,3,6,-90.34931183,38.61766052
226,"BRENTWOOD PA",6,1,0,0,1,1,-79.97418213,40.37056351
226,"BRENTWOOD TN",6,13,5,5,3,13,-86.78275299,36.03345108
226,"BREVARD NC",6,10,3,4,3,10,-82.73400116,35.23363113
226,"BREWSTER OH",6,5,1,2,2,5,-81.5980072,40.70691681
226,"BREWSTER WA",6,2,0,1,1,2,-119.7827835,48.09584427
226,"BRIDGEPORT CT",6,38,10,9,19,38,-73.2040863,41.16743088
226,"BRIDGEPORT TX",6,2,0,0,2,2,-97.75536346,33.21035767
226,"BRIDGETON MO",6,1,0,0,1,1,-90.41161346,38.76696396
226,"BRIDGETON NJ",6,9,3,4,2,9,-75.23321533,39.42769623
226,"BRIDGEWATER MA",6,2,0,0,2,2,-70.97428894,41.99058914
226,"BRIGHAM CITY UT",6,1,1,0,0,1,-112.0170517,41.50990677
226,"BRIGHTON IL",6,1,0,0,1,1,-90.14067841,39.03963089
226,"BRIGHTON MI",6,4,2,1,1,4,-83.78043365,42.52965546
226,"BRIGHTON NY",6,2,0,1,1,2,-77.57167816,43.12691116
226,"BRISBANE CA",6,3,0,1,2,3,-122.402504,37.68077469
226,"BRISTOL CT",6,38,20,8,10,38,-72.94853973,41.67193222
226,"BRISTOL PA",6,3,0,1,2,3,-74.85106659,40.10090637
226,"BRISTOL RI",6,6,1,0,5,6,-71.26984406,41.67538452
226,"BRISTOL TN",6,54,11,19,24,54,-82.17338562,36.58886719
226,"BRISTOL VA",6,8,3,1,4,8,-82.18840027,36.59663391
226,"BRISTOL VT",6,1,0,0,1,1,-73.07827759,44.133358
226,"BRISTOW OK",6,1,1,0,0,1,-96.39189148,35.83086395
226,"BROADVIEW HEIGHTS OH",6,15,4,4,7,15,-81.68503571,41.31410217
226,"BROADVIEW IL",6,1,0,1,0,1,-87.85337067,41.86410522
226,"BROADWAY VA",6,1,0,0,1,1,-78.7984314,38.61343002
226,"BROCKPORT NY",6,19,7,2,10,19,-77.93889618,43.213871
226,"BROCKTON MA",6,18,5,6,7,18,-71.01748657,42.08340454
226,"BRODHEAD WI",6,1,0,1,0,1,-89.37636566,42.61840057
226,"BROKEN ARROW OK",6,48,16,12,20,48,-95.79160309,36.05273056
226,"BRONXVILLE NY",6,4,0,0,4,4,-73.83145905,40.93828583
226,"BROOKFIELD IL",6,6,3,2,1,6,-87.85184479,41.82412338
226,"BROOKFIELD WI",6,2,0,1,1,2,-88.10640717,43.06070328
226,"BROOKHAVEN MS",6,1,0,1,0,1,-90.44090271,31.57933807
226,"BROOKINGS OR",6,4,1,0,3,4,-124.2865219,42.05229187
226,"BROOKINGS SD",6,14,5,2,7,14,-96.79450989,44.3097229
226,"BROOKLINE MA",6,21,9,6,6,21,-71.12002563,42.33176804
226,"BROOKLYN CENTER MN",6,1,1,0,0,1,-93.28692627,45.07069016
226,"BROOKLYN PARK MN",6,16,4,4,8,16,-93.35662079,45.09407043
226,"BROOKSIDE VILLAGE TX",6,2,0,0,2,2,-95.32555389,29.58737183
226,"BROOKSVILLE FL",6,10,0,4,6,10,-82.38734436,28.55600739
226,"BROOMFIELD CO",6,35,9,13,13,35,-105.0877686,39.92069244
226,"BROUSSARD LA",6,1,0,0,1,1,-91.96131134,30.14761353
226,"BROWN DEER WI",6,4,0,2,2,4,-87.96490479,43.16327667
226,"BROWNFIELD TX",6,1,1,0,0,1,-102.2751923,33.18150711
226,"BROWNSTOWN IN",6,2,0,0,2,2,-86.04185486,38.87921143
226,"BROWNSVILLE PA",6,3,1,2,0,3,-79.88352966,40.02396393
226,"BROWNSVILLE TN",6,2,0,0,2,2,-89.27153778,35.59300232
226,"BROWNSVILLE TX",6,17,3,2,12,17,-97.4977951,25.90228081
226,"BROWNWOOD TX",6,1,1,0,0,1,-98.99180603,31.70943642
226,"BRUNSWICK GA",6,11,3,2,6,11,-81.49102783,31.1502285
226,"BRUNSWICK ME",6,3,1,2,0,3,-69.96412659,43.91474533
226,"BRUNSWICK OH",6,14,5,4,5,14,-81.84169769,41.23830795
226,"BRUSH CO",6,2,1,1,0,2,-103.6244965,40.25937271
226,"BRYAN OH",6,2,0,1,1,2,-84.54946899,41.47367859
226,"BRYAN TX",6,17,7,6,4,17,-96.3704071,30.67456818
226,"BRYANT AR",6,8,2,3,3,8,-92.48953247,34.59588242
226,"BUCHANAN GA",6,1,0,0,1,1,-85.18835449,33.80280685
226,"BUCHANAN MI",6,3,2,0,1,3,-86.3614502,41.82715225
226,"BUCKEYE AZ",6,20,6,10,4,20,-112.5852661,33.37036896
226,"BUCKHANNON WV",6,3,1,1,1,3,-80.22968292,38.99204254
226,"BUCKINGHAM PA",6,1,0,1,0,1,-75.05937195,40.32373428
226,"BUCKLEY WA",6,1,0,0,1,1,-122.0293274,47.16257095
226,"BUCYRUS OH",6,3,0,0,3,3,-82.97511292,40.80856323
226,"BUDA TX",6,12,2,5,5,12,-97.84067535,30.08543968
226,"BUENA PARK CA",6,5,2,0,3,5,-117.999939,33.86748123
226,"BUENA VISTA CO",6,23,9,5,9,23,-106.1334534,38.84151459
226,"BUFFALO GAP TX",6,2,0,1,1,2,-99.82436371,32.2901001
226,"BUFFALO MN",6,3,0,1,2,3,-93.87721252,45.17856216
226,"BUFFALO NY",6,920,257,256,407,920,-78.87787628,42.8867836
226,"BUFORD GA",6,10,1,3,6,10,-84.00788879,34.11735535
226,"BUHLER KS",6,1,0,1,0,1,-97.7707901,38.13441849
226,"BULLHEAD CITY AZ",6,5,1,2,2,5,-114.5695648,35.1478157
226,"BUNKER HILL IL",6,1,0,0,1,1,-89.95170593,39.04272842
226,"BUNKIE LA",6,1,1,0,0,1,-92.18289185,30.95348549
226,"BURBANK CA",6,183,53,46,84,183,-118.3104782,34.18065262
226,"BURGETTSTOWN PA",6,1,0,0,1,1,-80.39241791,40.38209915
226,"BURIEN WA",6,3,2,0,1,3,-122.3500137,47.47027206
226,"BURLESON TX",6,1,0,0,1,1,-97.32151794,32.54247665
226,"BURLINGAME CA",6,3,2,1,0,3,-122.3685074,37.58408737
226,"BURLINGTON CO",6,1,0,0,1,1,-102.2693558,39.30016708
226,"BURLINGTON IA",6,4,2,0,2,4,-91.11296082,40.80773544
226,"BURLINGTON MA",6,5,3,1,1,5,-71.19434357,42.50506973
226,"BURLINGTON NC",6,7,2,1,4,7,-79.43729401,36.09585953
226,"BURLINGTON NJ",6,3,2,0,1,3,-74.86417389,40.07125092
226,"BURLINGTON VT",6,212,75,53,84,212,-73.20542908,44.47687531
226,"BURLINGTON WI",6,3,2,0,1,3,-88.27623749,42.67818832
226,"BURNET TX",6,1,0,1,0,1,-98.22889709,30.75881004
226,"BURNS TN",6,1,1,0,0,1,-87.3127594,36.05329132
226,"BURNSVILLE MN",6,10,2,1,7,10,-93.27822113,44.76760483
226,"BURNSVILLE NC",6,19,8,5,6,19,-82.30067444,35.91744614
226,"BURTON MI",6,3,1,2,0,3,-83.59590912,43.02775955
226,"BUSHNELL IL",6,1,0,0,1,1,-90.50644684,40.55287933
226,"BUTLER PA",6,3,1,1,1,3,-79.89468384,40.86117172
226,"BYRAM MS",6,3,1,0,2,3,-90.25419617,32.18321609
226,"BYRON WY",6,2,0,0,2,2,-108.5082169,44.79620361
226,"CABOT AR",6,1,0,0,1,1,-92.01670837,34.9747467
226,"CADDO MILLS TX",6,1,0,0,1,1,-96.22838593,33.0659256
226,"CADILLAC MI",6,1,0,1,0,1,-85.401474,44.25179291
226,"CAHOKIA IL",6,4,1,0,3,4,-90.19016266,38.57118225
226,"CAIRO GA",6,22,6,6,10,22,-84.20102692,30.87791824
226,"CALABASAS CA",6,13,4,3,6,13,-118.6473236,34.1558876
226,"CALDWELL ID",6,5,3,2,0,5,-116.6891098,43.66285324
226,"CALDWELL NJ",6,2,2,0,0,2,-74.27587128,40.83979797
226,"CALDWELL OH",6,3,0,2,1,3,-81.51609039,39.7481575
226,"CALDWELL TX",6,1,0,1,0,1,-96.69367218,30.53148842
226,"CALEDONIA MI",6,4,1,0,3,4,-85.51702118,42.78935623
226,"CALERA AL",6,66,16,21,29,66,-86.75354004,33.10300064
226,"CALHOUN GA",6,2,0,1,1,2,-84.95102692,34.50297165
226,"CALIFORNIA MO",6,2,1,0,1,2,-92.56713104,38.62768555
226,"CALIFORNIA PA",6,12,2,4,6,12,-79.89154053,40.06599426
226,"CALIMESA CA",6,3,2,1,0,3,-117.0634689,34.00385666
226,"CALLAHAN FL",6,9,4,1,4,9,-81.83045959,30.56256294
226,"CALUMET CITY IL",6,1,0,0,1,1,-87.5293045,41.61571884
226,"CAMARILLO CA",6,97,22,29,46,97,-119.0400391,34.21628952
226,"CAMAS WA",6,14,3,6,5,14,-122.4054489,45.58965683
226,"CAMBRIDGE MA",6,538,169,142,227,538,-71.10369873,42.36532593
226,"CAMBRIDGE MD",6,1,0,1,0,1,-76.07826996,38.56329346
226,"CAMBRIDGE MN",6,1,0,1,0,1,-93.22480774,45.5726738
226,"CAMBRIDGE OH",6,8,3,2,3,8,-81.58615875,40.02525711
226,"CAMBRIDGE SPRINGS PA",6,1,1,0,0,1,-80.05628204,41.80366135
226,"CAMBRIDGE WI",6,1,1,0,0,1,-89.01670074,43.00352097
226,"CAMDEN AR",6,7,2,2,3,7,-92.83481598,33.58491898
226,"CAMDEN ME",6,1,0,1,0,1,-69.06347656,44.20983505
226,"CAMDEN NJ",6,45,10,13,22,45,-75.118927,39.92608261
226,"CAMDEN SC",6,4,1,0,3,4,-80.60647583,34.24704742
226,"CAMDEN TN",6,2,0,2,0,2,-88.09780121,36.05930328
226,"CAMDENTON MO",6,1,0,0,1,1,-92.74469757,38.00836182
226,"CAMERON NC",6,1,0,1,0,1,-79.25471497,35.32713318
226,"CAMERON SC",6,13,4,1,8,13,-80.71407318,33.5581665
226,"CAMP HILL PA",6,4,2,1,1,4,-76.9335022,40.24120331
226,"CAMPBELL CA",6,17,4,5,8,17,-121.951973,37.287117
226,"CAMPBELL MO",6,2,2,0,0,2,-90.07504272,36.49356079
226,"CAMPBELLSVILLE KY",6,6,0,2,4,6,-85.34185791,37.34331131
226,"CANAL WINCHESTER OH",6,4,1,0,3,4,-82.80456543,39.84274673
226,"CANANDAIGUA NY",6,10,4,2,4,10,-77.28107452,42.88830948
226,"CANASTOTA NY",6,3,0,0,3,3,-75.75039673,43.07939529
226,"CANBY OR",6,1,0,1,0,1,-122.6948166,45.26276779
226,"CANEY KS",6,1,0,1,0,1,-95.93595123,37.01166534
226,"CANNON FALLS MN",6,4,2,2,0,4,-92.90566254,44.50691605
226,"CANONSBURG PA",6,1,0,0,1,1,-80.1868515,40.26278687
226,"CANTON GA",6,4,0,1,3,4,-84.48571014,34.23356628
226,"CANTON IL",6,6,1,1,4,6,-90.03516388,40.55800247
226,"CANTON MS",6,4,2,1,1,4,-90.03672028,32.61313248
226,"CANTON NC",6,5,2,1,2,5,-82.83691406,35.53314209
226,"CANTON NY",6,4,1,1,2,4,-75.16870117,44.59575272
226,"CANTON OH",6,68,21,23,24,68,-81.37824249,40.79906845
226,"CANTON TX",6,1,0,1,0,1,-95.86379242,32.55702591
226,"CANYON TX",6,5,3,1,1,5,-101.9192429,34.98051834
226,"CAPE CANAVERAL FL",6,5,1,2,2,5,-80.60503387,28.4044838
226,"CAPE CORAL FL",6,15,5,3,7,15,-81.9491806,26.56343079
226,"CAPE ELIZABETH ME",6,1,1,0,0,1,-70.20044708,43.56402206
226,"CAPE GIRARDEAU MO",6,63,15,15,33,63,-89.51838684,37.30613327
226,"CAPE MAY NJ",6,3,0,2,1,3,-74.90522766,38.93513107
226,"CAPITOL HEIGHTS MD",6,21,8,6,7,21,-76.91506195,38.88552475
226,"CARBONDALE IL",6,92,25,24,43,92,-89.2168808,37.7274704
226,"CARDINGTON OH",6,1,0,0,1,1,-82.89324188,40.5008812
226,"CARENCRO LA",6,7,1,1,5,7,-92.04903412,30.31741714
226,"CARL JUNCTION MO",6,1,0,1,0,1,-94.56625366,37.17694855
226,"CARLISLE IA",6,3,1,0,2,3,-93.48899078,41.50154495
226,"CARLISLE KY",6,1,0,1,0,1,-84.02700806,38.31232452
226,"CARLISLE MA",6,1,0,0,1,1,-71.34856415,42.52941132
226,"CARLISLE PA",6,69,21,14,34,69,-77.18848419,40.20173264
226,"CARLSBAD CA",6,49,14,11,24,49,-117.3528137,33.1580162
226,"CARLSBAD NM",6,1,0,0,1,1,-104.2350617,32.41680527
226,"CARMEL IN",6,22,5,6,11,22,-86.12607574,39.97961426
226,"CARMEL NY",6,2,0,2,0,2,-73.67949677,41.43042755
226,"CARNEYS POINT NJ",6,2,0,1,1,2,-75.46931458,39.71123123
226,"CARO MI",6,3,0,1,2,3,-83.39698792,43.49111176
226,"CAROL STREAM IL",6,3,0,3,0,3,-88.13473511,41.91279221
226,"CARPINTERIA CA",6,10,3,2,5,10,-119.5201263,34.39894485
226,"CARRBORO NC",6,59,18,15,26,59,-79.07286835,35.91213989
226,"CARRIZO SPRINGS TX",6,5,1,0,4,5,-99.86119843,28.52256584
226,"CARROLL IA",6,6,2,2,2,6,-94.86740875,42.06593704
226,"CARROLL OH",6,1,1,0,0,1,-82.70081329,39.79898071
226,"CARROLLTON GA",6,10,2,2,6,10,-85.07631683,33.58019638
226,"CARROLLTON KY",6,1,0,1,0,1,-85.17919159,38.68099976
226,"CARROLLTON TX",6,31,7,10,14,31,-96.89080811,32.95380783
226,"CARSON CA",6,58,19,14,25,58,-118.2837448,33.8312645
226,"CARSON CITY NV",6,25,8,4,13,25,-119.7687988,39.16352844
226,"CARTERET NJ",6,4,0,2,2,4,-74.2276535,40.57754135
226,"CARTERSVILLE GA",6,5,1,1,3,5,-84.79982758,34.1654892
226,"CARTHAGE MO",6,13,2,5,6,13,-94.31087494,37.17650223
226,"CARTHAGE MS",6,1,0,0,1,1,-89.53627777,32.73288345
226,"CARTHAGE NY",6,1,0,0,1,1,-75.60883331,43.97806549
226,"CARTHAGE SD",6,1,0,1,0,1,-97.71016693,44.17021179
226,"CARTHAGE TX",6,3,2,0,1,3,-94.33757019,32.15785217
226,"CARY IL",6,4,1,1,2,4,-88.23856354,42.21179962
226,"CARY NC",6,46,7,15,24,46,-78.78055573,35.79200745
226,"CASA GRANDE AZ",6,22,6,6,10,22,-111.7590179,32.87965393
226,"CASCADE LOCKS OR",6,1,0,0,1,1,-121.8928452,45.66971588
226,"CASHMERE WA",6,3,2,0,1,3,-120.4727402,47.52220535
226,"CASNOVIA MI",6,2,2,0,0,2,-85.79045105,43.23496628
226,"CASPER WY",6,10,3,3,4,10,-106.3147507,42.86667633
226,"CASSOPOLIS MI",6,1,0,0,1,1,-86.00973511,41.91165924
226,"CASTILE NY",6,4,2,0,2,4,-78.05419922,42.6289978
226,"CASTLE ROCK CO",6,16,4,8,4,16,-104.857811,39.37207031
226,"CASTLE SHANNON PA",6,4,3,1,0,4,-80.021698,40.3650856
226,"CASTLEWOOD SD",6,1,0,1,0,1,-97.03081512,44.72495651
226,"CASTROVILLE TX",6,1,0,1,0,1,-98.87910461,29.35617065
226,"CATHEDRAL CITY CA",6,9,3,4,2,9,-116.4663467,33.77960205
226,"CATOOSA OK",6,1,1,0,0,1,-95.74643707,36.18903351
226,"CAZENOVIA NY",6,1,0,0,1,1,-75.85186005,42.93000031
226,"CEDAR CITY UT",6,6,4,0,2,6,-113.0635757,37.67730713
226,"CEDAR FALLS IA",6,11,2,4,5,11,-92.44594574,42.52773285
226,"CEDAR GROVE NJ",6,1,0,1,0,1,-74.22842407,40.8519516
226,"CEDAR GROVE WI",6,1,0,0,1,1,-87.82375336,43.56973648
226,"CEDAR HILL TX",6,58,9,7,13,29,-99.08098985,33.36628723
226,"CEDAR PARK TX",6,8,1,2,5,8,-97.82061005,30.50554466
226,"CEDAR RAPIDS IA",6,157,40,46,71,157,-91.66259766,41.98337555
226,"CEDAR SPRINGS MI",6,1,0,1,0,1,-85.55171967,43.22346115
226,"CEDARBURG WI",6,4,1,2,1,4,-87.9877243,43.29684067
226,"CEDARTOWN GA",6,3,1,0,2,3,-85.25636292,34.03249741
226,"CENTERVILLE OH",6,4,2,1,1,4,-84.15953064,39.6285553
226,"CENTRAL POINT OR",6,1,0,0,1,1,-122.918747,42.37548828
226,"CENTRALIA MO",6,3,2,1,0,3,-92.13832855,39.2105484
226,"CENTRALIA WA",6,4,0,2,2,4,-122.9679337,46.71740723
226,"CENTREVILLE IL",6,1,0,0,1,1,-90.12549591,38.58330154
226,"CERES CA",6,5,3,1,1,5,-120.9599075,37.59457016
226,"CERRITOS CA",6,7,0,2,5,7,-118.0665054,33.85832214
226,"CHADRON NE",6,5,0,3,2,5,-102.9998169,42.83535004
226,"CHAMBERSBURG PA",6,4,2,2,0,4,-77.66046906,39.93768692
226,"CHAMBLEE GA",6,3,2,0,1,3,-84.29881287,33.89216995
226,"CHAMPAIGN IL",6,208,72,54,82,208,-88.24346161,40.11659622
226,"CHAMPLIN MN",6,6,2,2,2,6,-93.39782715,45.18864059
226,"CHANDLER AZ",6,74,29,18,27,74,-111.8428345,33.3062439
226,"CHANUTE KS",6,2,1,0,1,2,-95.45789337,37.67946243
226,"CHAPEL HILL NC",6,283,88,75,120,283,-79.05697632,35.91110611
226,"CHARDON OH",6,2,1,1,0,2,-81.2011795,41.58335114
226,"CHARLES TOWN WV",6,14,4,4,6,14,-77.86264038,39.29033279
226,"CHARLESTON IL",6,11,3,3,5,11,-88.17610931,39.49612045
226,"CHARLESTON SC",6,602,153,182,267,602,-79.93032074,32.77671814
226,"CHARLESTON WV",6,187,43,42,102,187,-81.63149261,38.34872055
226,"CHARLESTOWN IN",6,1,0,0,1,1,-85.67014313,38.45307159
226,"CHARLEVOIX MI",6,1,0,1,0,1,-85.258255,45.31790924
226,"CHARLOTTE NC",6,2499,648,685,1166,2499,-80.84257507,35.22746277
226,"CHARLOTTESVILLE VA",6,338,103,90,145,338,-78.49123383,38.03798676
226,"CHASKA MN",6,2,0,1,1,2,-93.60231781,44.78918457
226,"CHATHAM IL",6,8,1,1,6,8,-89.70467377,39.67619324
226,"CHATHAM NY",6,3,0,1,2,3,-73.59416199,42.3643074
226,"CHATHAM VA",6,7,2,4,1,7,-79.39749146,36.82584
226,"CHATTANOOGA TN",6,320,86,71,163,320,-85.30583954,35.04058456
226,"CHECOTAH OK",6,3,1,0,2,3,-95.52338409,35.47038651
226,"CHEEKTOWAGA NY",6,6,1,2,3,6,-78.75413513,42.90357208
226,"CHEHALIS WA",6,1,1,0,0,1,-122.9765091,46.66357803
226,"CHELAN WA",6,1,0,1,0,1,-120.0186539,47.84073639
226,"CHELSEA AL",6,6,2,0,4,6,-86.63014984,33.34026718
226,"CHELSEA MA",6,6,1,2,3,6,-71.03151703,42.39189529
226,"CHELTENHAM PA",6,3,0,1,2,3,-75.09356689,40.06132126
226,"CHENEY WA",6,11,2,2,7,11,-117.5782547,47.48730087
226,"CHERRY HILL NJ",6,17,7,3,7,17,-75.03024292,39.93510437
226,"CHERRYFIELD ME",6,1,0,1,0,1,-67.92087555,44.60442734
226,"CHESANING MI",6,1,0,1,0,1,-84.1146698,43.18473816
226,"CHESAPEAKE BEACH MD",6,17,8,1,8,17,-76.53400421,38.68645096
226,"CHESAPEAKE VA",6,75,21,16,38,75,-76.27422333,36.81948853
226,"CHESHIRE CT",6,2,1,1,0,2,-72.89962006,41.50049591
226,"CHESTER PA",6,14,4,5,5,14,-75.35475159,39.84973145
226,"CHESTER SC",6,6,1,3,2,6,-81.2141037,34.7049675
226,"CHESTERFIELD MO",6,20,5,5,10,20,-90.5772934,38.6631279
226,"CHESTERTOWN MD",6,11,4,2,5,11,-76.0662384,39.20907593
226,"CHEVERLY MD",6,3,2,1,0,3,-76.91530609,38.92858505
226,"CHEVY CHASE MD",6,26,9,5,12,26,-77.07595825,38.97138977
226,"CHEWELAH WA",6,7,2,2,3,7,-117.7169418,48.27609634
226,"CHEYENNE WY",6,18,8,3,7,18,-104.8183899,41.13345718
226,"CHICAGO HEIGHTS IL",6,7,2,2,3,7,-87.63541412,41.506073
226,"CHICAGO IL",6,9418,2777,2432,4209,9418,-87.6503067,41.85000992
226,"CHICAGO RIDGE IL",6,1,0,0,1,1,-87.77906036,41.70148849
226,"CHICKAMAUGA GA",6,4,2,0,2,4,-85.29045105,34.87113571
226,"CHICKASHA OK",6,3,2,0,1,3,-97.93728638,35.05269241
226,"CHICO CA",6,201,66,55,80,201,-121.839447,39.72846222
226,"CHICOPEE MA",6,8,3,3,2,8,-72.60691071,42.14902496
226,"CHILDERSBURG AL",6,1,0,0,1,1,-86.35501862,33.27838135
226,"CHILLICOTHE IL",6,4,1,2,1,4,-89.48628998,40.92245865
226,"CHILLICOTHE MO",6,4,1,0,3,4,-93.55298615,39.79542542
226,"CHILLICOTHE OH",6,3,0,0,3,3,-82.98206329,39.33310699
226,"CHINA GROVE NC",6,3,3,0,0,3,-80.58115387,35.56945801
226,"CHINO CA",6,20,5,5,10,20,-117.6906662,34.0121727
226,"CHIPLEY FL",6,1,0,0,1,1,-85.53816223,30.78241539
226,"CHIPPEWA FALLS WI",6,2,0,1,1,2,-91.3935318,44.93660736
226,"CHOCTAW OK",6,4,1,0,3,4,-97.26795197,35.49282074
226,"CHRISTIANSBURG VA",6,8,3,4,1,8,-80.40843201,37.1302948
226,"CHRISTOPHER IL",6,1,0,0,1,1,-89.05361938,37.97265244
226,"CHULA VISTA CA",6,143,47,47,49,143,-117.0857468,32.64037704
226,"CICERO IL",6,2,0,1,1,2,-87.75395203,41.84553909
226,"CINCINNATI OH",6,1071,298,282,491,1071,-84.51939392,39.10413742
226,"CITRONELLE AL",6,1,0,1,0,1,-88.22799683,31.09094429
226,"CITRUS HEIGHTS CA",6,2,0,1,1,2,-121.2829208,38.70672607
226,"CLANTON AL",6,4,1,1,2,4,-86.62932587,32.83919907
226,"CLAREMONT CA",6,155,41,37,77,155,-117.7214508,34.09675217
226,"CLAREMONT NH",6,8,2,3,3,8,-72.33439636,43.37068939
226,"CLAREMORE OK",6,2,1,0,1,2,-95.61654663,36.31294632
226,"CLARKS SUMMIT PA",6,1,0,0,1,1,-75.70759583,41.48881531
226,"CLARKSBURG TN",6,1,0,1,0,1,-88.393013,35.87177277
226,"CLARKSBURG WV",6,5,2,1,2,5,-80.34414673,39.28092575
226,"CLARKSDALE MS",6,4,0,1,3,4,-90.57128143,34.20030212
226,"CLARKSTON GA",6,1,0,0,1,1,-84.2394104,33.80961227
226,"CLARKSTON WA",6,1,1,0,0,1,-117.0472336,46.41588593
226,"CLARKSVILLE TN",6,31,10,9,12,31,-87.35944366,36.52993011
226,"CLARKTON NC",6,1,0,0,1,1,-78.6556015,34.48762131
226,"CLAYTON CA",6,1,0,0,1,1,-121.938057,37.94074249
226,"CLAYTON IN",6,1,0,0,1,1,-86.52271271,39.68913651
226,"CLAYTON MI",6,1,0,1,0,1,-84.23601532,41.86322021
226,"CLAYTON MO",6,8,4,2,2,8,-90.32382965,38.64260101
226,"CLAYTON NC",6,13,5,3,5,13,-78.45562744,35.6511879
226,"CLAYTON NJ",6,2,0,1,1,2,-75.0915451,39.66054535
226,"CLE ELUM WA",6,1,1,0,0,1,-120.9416733,47.19517517
226,"CLEAR LAKE SHORES TX",6,79,22,27,30,79,-95.03226471,29.54773712
226,"CLEARFIELD UT",6,1,0,1,0,1,-112.0273361,41.11647415
226,"CLEARWATER FL",6,81,17,27,37,81,-82.79984283,27.9665451
226,"CLEARWATER KS",6,2,0,2,0,2,-97.50491333,37.50294876
226,"CLEBURNE TX",6,6,0,4,2,6,-97.38722992,32.34804535
226,"CLEMENTON NJ",6,1,1,0,0,1,-74.98200226,39.81152725
226,"CLEMMONS NC",6,3,2,0,1,3,-80.38154602,36.02172089
226,"CLEMSON SC",6,32,9,6,17,32,-82.83683014,34.68382645
226,"CLEVELAND HEIGHTS OH",6,19,2,5,12,19,-81.55568695,41.52017975
226,"CLEVELAND OH",6,1992,547,532,913,1992,-81.69516754,41.49978256
226,"CLEVELAND TN",6,26,4,14,8,26,-84.87675476,35.15940094
226,"CLEVELAND TX",6,1,0,0,1,1,-95.08600616,30.34188652
226,"CLIFFSIDE PARK NJ",6,3,0,2,1,3,-73.98683167,40.82172394
226,"CLIFTON NJ",6,12,1,3,8,12,-74.16278076,40.85860062
226,"CLIFTON PARK NY",6,29,5,9,15,29,-73.76983643,42.8658638
226,"CLIFTON SPRINGS NY",6,2,1,1,0,2,-77.13955688,42.96201324
226,"CLINTON CT",6,3,0,2,1,3,-72.52671814,41.27874756
226,"CLINTON IA",6,2,1,1,0,2,-90.19799042,41.84345627
226,"CLINTON IN",6,3,0,0,3,3,-87.39801025,39.65688324
226,"CLINTON MA",6,4,2,1,1,4,-71.69485474,42.42619705
226,"CLINTON MO",6,1,1,0,0,1,-93.7784729,38.36861038
226,"CLINTON MS",6,4,3,0,1,4,-90.33226776,32.34069061
226,"CLINTON NY",6,3,2,0,1,3,-75.37784576,43.04865265
226,"CLINTON SC",6,2,0,1,1,2,-81.88014984,34.47286224
226,"CLINTON TN",6,1,0,1,0,1,-84.13148499,36.10355759
226,"CLINTON WI",6,1,0,0,1,1,-88.86540985,42.5578537
226,"CLIVE IA",6,1,1,0,0,1,-93.72477722,41.60302734
226,"CLOVIS CA",6,20,5,5,10,20,-119.7047043,36.82522583
226,"CLOVIS NM",6,10,0,5,5,10,-103.2067108,34.40181732
226,"CLYDE OH",6,1,1,0,0,1,-82.97480774,41.30446243
226,"COACHELLA CA",6,16,6,3,7,16,-116.1753616,33.68059158
226,"COAL CITY IL",6,1,0,0,1,1,-88.28557587,41.28782272
226,"COALINGA CA",6,3,2,0,1,3,-120.3620071,36.13978577
226,"COATESVILLE PA",6,15,0,6,9,15,-75.82329559,39.98334885
226,"COATS NC",6,5,2,0,3,5,-78.6716156,35.40827179
226,"COCHRAN GA",6,2,0,2,0,2,-83.35463715,32.38718414
226,"COCOA BEACH FL",6,53,21,14,18,53,-80.6068573,28.3203907
226,"COCOA FL",6,5,3,1,1,5,-80.74181366,28.38667297
226,"COEUR D'ALENE ID",6,4,0,2,2,4,-116.781929,47.67768478
226,"COHASSET MA",6,4,1,1,2,4,-70.8026123,42.24186325
226,"COHOES NY",6,6,0,1,5,6,-73.6990509,42.77442169
226,"COLCHESTER CT",6,3,0,1,2,3,-72.33102417,41.5759201
226,"COLD SPRING KY",6,1,0,1,0,1,-84.43971252,39.02180862
226,"COLD SPRING NY",6,1,0,1,0,1,-73.9535675,41.42040253
226,"COLDSPRING TX",6,3,1,1,1,3,-95.12992096,30.5929203
226,"COLDWATER MI",6,1,1,0,0,1,-85.00062561,41.94022369
226,"COLDWATER OH",6,3,0,1,2,3,-84.6279068,40.47993851
226,"COLFAX CA",6,2,0,2,0,2,-120.9551468,39.10037994
226,"COLLEGE PARK GA",6,74,20,20,34,74,-84.44933319,33.65347672
226,"COLLEGE PARK MD",6,108,40,32,36,108,-76.93619537,38.98080444
226,"COLLEGE STATION TX",6,148,45,40,63,148,-96.33758545,30.62316895
226,"COLLEGEDALE TN",6,2,0,1,1,2,-85.05016327,35.0533371
226,"COLLEGEVILLE MN",6,1,0,0,1,1,-94.36388397,45.59444427
226,"COLLEGEVILLE PA",6,2,1,0,1,2,-75.4506073,40.18598557
226,"COLLEYVILLE TX",6,6,1,1,4,6,-97.15543365,32.88101959
226,"COLLIERVILLE TN",6,3,0,0,3,3,-89.66448212,35.0423317
226,"COLLINGSWOOD NJ",6,10,2,2,6,10,-75.07028961,39.9186058
226,"COLLINSVILLE AL",6,1,0,0,1,1,-85.86063385,34.26427078
226,"COLLINSVILLE IL",6,18,7,5,6,18,-89.98478699,38.67050171
226,"COLMA CA",6,7,1,2,4,7,-122.4610977,37.67665482
226,"COLONIE NY",6,2,1,0,1,2,-73.83889771,42.72444534
226,"COLORADO SPRINGS CO",6,495,139,148,208,495,-104.8225174,38.83369446
226,"COLTON CA",6,4,1,2,1,4,-117.3153687,34.0738945
226,"COLUMBIA FALLS MT",6,2,0,1,1,2,-114.1933212,48.36879349
226,"COLUMBIA HEIGHTS MN",6,5,1,1,3,5,-93.24828339,45.04322815
226,"COLUMBIA IL",6,8,1,4,3,8,-90.20130157,38.44375992
226,"COLUMBIA MO",6,832,260,195,377,832,-92.33429718,38.95169067
226,"COLUMBIA SC",6,740,203,190,347,740,-81.04045105,34.00138855
226,"COLUMBIA TN",6,7,3,3,1,7,-87.03533173,35.61502457
226,"COLUMBUS GA",6,189,34,51,104,189,-84.98313141,32.46828842
226,"COLUMBUS IN",6,12,3,4,5,12,-85.92284393,39.20959473
226,"COLUMBUS MS",6,4,2,1,1,4,-88.42742157,33.49581909
226,"COLUMBUS NE",6,3,1,1,1,3,-97.36936188,41.42973709
226,"COLUMBUS OH",6,1917,567,501,849,1917,-82.99890137,39.96136475
226,"COLVILLE WA",6,1,1,0,0,1,-117.9075775,48.54657745
226,"COMMERCE CITY CO",6,4,1,0,3,4,-104.9268341,39.81377792
226,"COMMERCE TX",6,16,7,1,8,16,-95.90060425,33.24729538
226,"COMPTON CA",6,122,25,34,63,122,-118.2218704,33.89606857
226,"CONCORD CA",6,37,11,9,17,37,-122.0333328,37.97780228
226,"CONCORD MA",6,2,1,0,1,2,-71.34809113,42.46035004
226,"CONCORD NC",6,83,19,10,54,83,-80.57880402,35.4092598
226,"CONCORD NH",6,26,5,11,10,26,-71.53688812,43.20820999
226,"CONNEAUT OH",6,1,1,0,0,1,-80.55375671,41.94755936
226,"CONNELL WA",6,7,3,4,0,7,-118.863533,46.66334534
226,"CONNELLSVILLE PA",6,1,0,0,1,1,-79.58900452,40.01786041
226,"CONNERSVILLE IN",6,9,2,4,3,9,-85.13545227,39.64817047
226,"CONOVER NC",6,68,19,17,32,68,-81.21835327,35.70663834
226,"CONROE TX",6,17,4,6,7,17,-95.45646667,30.31249237
226,"CONSHOHOCKEN PA",6,1,1,0,0,1,-75.30096436,40.07962418
226,"CONWAY AR",6,47,9,16,22,47,-92.4426651,35.08877563
226,"CONWAY SC",6,21,5,6,10,21,-79.04202271,33.83802795
226,"CONWAY SPRINGS KS",6,3,0,0,3,3,-97.64313507,37.39021683
226,"CONYERS GA",6,13,5,5,3,13,-84.0175705,33.66764832
226,"COOKEVILLE TN",6,18,4,5,9,18,-85.50189972,36.16290665
226,"COOLIDGE AZ",6,1,0,0,1,1,-111.5191727,32.9781456
226,"COOPERSBURG PA",6,1,0,0,1,1,-75.3898468,40.51155472
226,"COOPERSTOWN NY",6,1,0,0,1,1,-74.9236908,42.70100784
226,"COOPERSVILLE MI",6,1,0,1,0,1,-85.93455505,43.06417847
226,"COOS BAY OR",6,1,0,1,0,1,-124.219841,43.36757278
226,"COPLEY OH",6,1,0,0,1,1,-81.64421844,41.09919357
226,"COPPELL TX",6,7,3,2,2,7,-97.01548004,32.95487213
226,"COPPERAS COVE TX",6,10,1,1,8,10,-97.90343475,31.12462616
226,"CORAL GABLES FL",6,22,7,3,12,22,-80.26779938,25.72242165
226,"CORALVILLE IA",6,9,2,1,6,9,-91.58083344,41.6765976
226,"CORAOPOLIS PA",6,2,1,0,1,2,-80.16625214,40.51863861
226,"CORBIN KY",6,2,1,0,1,2,-84.09648132,36.94906235
226,"CORCORAN CA",6,6,0,1,5,6,-119.5620728,36.09794235
226,"CORINTH MS",6,2,0,1,1,2,-88.52302551,34.93960571
226,"CORINTH TX",6,3,1,1,1,3,-99.87008667,32.85448456
226,"CORNELIUS NC",6,2,1,0,1,2,-80.85160828,35.48339462
226,"CORNING NY",6,8,3,3,2,8,-77.05406189,42.14312744
226,"CORONA CA",6,86,17,31,38,86,-117.5688171,33.87516785
226,"CORONADO CA",6,26,8,10,8,26,-117.1846619,32.6861763
226,"CORPUS CHRISTI TX",6,95,25,26,44,95,-97.42076874,27.77859879
226,"CORRY PA",6,1,0,0,1,1,-79.63973999,41.92025375
226,"CORSICANA TX",6,1,1,0,0,1,-96.46954346,32.09554291
226,"CORTE MADERA CA",6,1,1,0,0,1,-122.5294342,37.9252739
226,"CORTEZ CO",6,1,0,1,0,1,-108.5680389,37.35043716
226,"CORTLAND NY",6,27,9,9,9,27,-76.17972565,42.60138702
226,"CORVALLIS OR",6,140,46,36,58,140,-123.2646637,44.56417084
226,"CORYDON IN",6,3,1,1,1,3,-86.12213135,38.2123642
226,"COSHOCTON OH",6,3,1,1,1,3,-81.85901642,40.27225113
226,"COSTA MESA CA",6,38,14,6,18,38,-117.9204407,33.64131927
226,"COTATI CA",6,7,2,1,4,7,-122.7091904,38.32655334
226,"COTTAGE GROVE MN",6,3,0,1,2,3,-92.88017273,44.842556
226,"COTTONWOOD AZ",6,1,0,0,1,1,-112.0110779,34.739048
226,"COTTONWOOD FALLS KS",6,2,0,0,2,2,-96.54312897,38.37212372
226,"COUNCIL BLUFFS IA",6,13,3,3,7,13,-95.86154938,41.26196289
226,"COUNCIL GROVE KS",6,33,7,9,17,33,-96.49236298,38.66096115
226,"COUNTRY CLUB HILLS IL",6,6,4,2,0,6,-87.72031403,41.56811142
226,"COUPEVILLE WA",6,4,1,1,2,4,-122.6886749,48.21968842
226,"COURTLAND AL",6,2,1,1,0,2,-87.30978394,34.66937637
226,"COVINA CA",6,17,4,4,9,17,-117.8919067,34.09014511
226,"COVINGTON GA",6,14,2,2,10,14,-83.86009216,33.59708405
226,"COVINGTON KY",6,18,4,4,10,18,-84.50816345,39.08356476
226,"COVINGTON LA",6,7,1,2,4,7,-90.10121918,30.475914
226,"COVINGTON OK",6,1,0,0,1,1,-97.58732605,36.30782318
226,"COVINGTON VA",6,4,2,0,2,4,-79.99378204,37.79362106
226,"COXSACKIE NY",6,2,0,2,0,2,-73.80188751,42.35128403
226,"CRANDALL TX",6,13,3,5,5,13,-96.45626068,32.62812042
226,"CRANFORD NJ",6,12,3,7,2,12,-74.29885101,40.65885925
226,"CRANSTON RI",6,55,15,15,25,55,-71.43634033,41.77997971
226,"CRAWFORDSVILLE IN",6,1,0,0,1,1,-86.89406586,40.04439926
226,"CRESCENT CITY CA",6,4,0,1,3,4,-124.2048645,41.75559235
226,"CRESCO IA",6,2,2,0,0,2,-92.12171173,43.37280273
226,"CREST HILL IL",6,3,0,3,0,3,-88.09871674,41.55462646
226,"CRESTON IA",6,4,1,0,3,4,-94.3616333,41.05845642
226,"CRESTVIEW FL",6,9,3,2,4,9,-86.57064819,30.76231766
226,"CRESTWOOD IL",6,6,0,5,1,6,-87.75239563,41.66117096
226,"CRESTWOOD MO",6,1,0,0,1,1,-90.38228607,38.55702972
226,"CRESWELL OR",6,1,0,0,1,1,-123.0262985,43.91783142
226,"CRETE IL",6,1,1,0,0,1,-87.63152313,41.44472885
226,"CREVE COEUR MO",6,3,1,0,2,3,-90.42288971,38.66108322
226,"CROCKETT TX",6,1,0,0,1,1,-95.45687866,31.31850815
226,"CROOKSTON MN",6,2,0,0,2,2,-96.60908508,47.77420044
226,"CROSSVILLE TN",6,26,7,6,13,26,-85.0270462,35.9490509
226,"CROTON-ON-HUDSON NY",6,29,10,9,10,29,-73.89041901,41.2085762
226,"CROWLEY TX",6,1,0,1,0,1,-97.36329651,32.57945633
226,"CROWN POINT IN",6,11,2,4,5,11,-87.36541748,41.41695023
226,"CRYSTAL CITY TX",6,1,0,0,1,1,-99.82878113,28.67775726
226,"CRYSTAL LAKE IL",6,16,7,5,4,16,-88.3161087,42.2411499
226,"CRYSTAL MN",6,10,4,4,2,10,-93.36638641,45.05664063
226,"CRYSTAL SPRINGS MS",6,6,0,2,4,6,-90.35726929,31.98783875
226,"CUBA MO",6,9,1,2,6,9,-91.40387726,38.06311035
226,"CUDAHY WI",6,1,1,0,0,1,-87.86171722,42.9596405
226,"CULLMAN AL",6,2,1,1,0,2,-86.84370422,34.17510605
226,"CULPEPER VA",6,3,1,2,0,3,-77.99610901,38.47347641
226,"CUMBERLAND MD",6,8,3,1,4,8,-78.76217651,39.65284729
226,"CUMMING GA",6,22,9,5,8,22,-84.1401825,34.2074852
226,"CUPERTINO CA",6,72,18,24,30,72,-122.0342026,37.32306671
226,"CUSHING OK",6,2,1,0,1,2,-96.76766968,35.98506546
226,"CUT AND SHOOT TX",6,7,1,3,3,7,-95.35832214,30.33357811
226,"CUYAHOGA FALLS OH",6,78,28,21,29,78,-81.48397064,41.1338768
226,"CYPRESS CA",6,6,1,2,3,6,-118.0384903,33.81704712
226,"DACULA GA",6,6,0,3,3,6,-83.89762878,33.9887352
226,"DADE CITY FL",6,1,0,0,1,1,-82.19556427,28.36546135
226,"DAHLONEGA GA",6,5,1,1,3,5,-83.98484802,34.53287125
226,"DALLAS GA",6,9,3,3,3,9,-84.84075165,33.92391586
226,"DALLAS OR",6,2,0,1,1,2,-123.3198471,44.91903687
226,"DALLAS TX",6,5009,1312,1352,2345,5009,-96.80088043,32.78369904
226,"DALTON GA",6,23,8,3,12,23,-84.97008514,34.76976776
226,"DALTON OH",6,3,0,1,2,3,-81.69519043,40.79919815
226,"DALWORTHINGTON GARDENS TX",6,1,0,0,1,1,-97.1558075,32.7033844
226,"DALY CITY CA",6,87,18,34,35,87,-122.4645081,37.70376968
226,"DANBURY CT",6,19,8,5,6,19,-73.45310974,41.39499664
226,"DANDRIDGE TN",6,5,1,2,2,5,-83.41452026,36.0157814
226,"DANFORTH ME",6,6,1,0,5,6,-67.86733246,45.66029358
226,"DANVILLE CA",6,6,3,0,3,6,-122.0023193,37.82156754
226,"DANVILLE IL",6,37,10,7,20,37,-87.62978363,40.12442398
226,"DANVILLE IN",6,2,0,1,1,2,-86.52632904,39.76076126
226,"DANVILLE KY",6,7,3,4,0,7,-84.77213287,37.6458931
226,"DANVILLE PA",6,1,1,0,0,1,-76.61188507,40.96371078
226,"DANVILLE VA",6,7,4,2,1,7,-79.39437866,36.58641434
226,"DAPHNE AL",6,2,0,2,0,2,-87.90383148,30.60381317
226,"DARIEN CT",6,1,1,0,0,1,-73.46835327,41.0790329
226,"DARIEN IL",6,3,3,0,0,3,-87.97415161,41.75206757
226,"DARLINGTON SC",6,5,0,2,3,5,-79.86645508,34.30082321
226,"DAVENPORT FL",6,2,0,0,2,2,-81.60109711,28.1620388
226,"DAVENPORT IA",6,46,15,14,17,46,-90.57814026,41.52380753
226,"DAVIDSON NC",6,4,1,0,3,4,-80.8433075,35.49843216
226,"DAVIE FL",6,39,9,9,21,39,-80.23148346,26.0657177
226,"DAVIS CA",6,80,29,16,35,80,-121.7421722,38.54467773
226,"DAVISON MI",6,1,0,0,1,1,-83.51786804,43.0346489
226,"DAWSONVILLE GA",6,2,0,1,1,2,-84.11881256,34.42126083
226,"DAYTON KY",6,56,23,11,22,56,-84.47278595,39.11274338
226,"DAYTON OH",6,471,110,144,217,471,-84.19126892,39.75915146
226,"DAYTON TN",6,7,2,1,4,7,-85.01251221,35.49424744
226,"DAYTON VA",6,1,0,0,1,1,-78.93834686,38.41519165
226,"DAYTONA BEACH FL",6,159,41,47,71,159,-81.02253723,29.21147537
226,"DE PERE WI",6,8,5,0,3,8,-88.06053925,44.4486618
226,"DE SOTO MO",6,1,0,1,0,1,-90.55529022,38.13964462
226,"DEARBORN HEIGHTS MI",6,7,2,2,3,7,-83.27328491,42.33712769
226,"DEARBORN MI",6,36,8,9,19,36,-83.1758728,42.32239914
226,"DEBARY FL",6,16,4,4,8,16,-81.30838776,28.88345909
226,"DECATUR AL",6,10,4,1,5,10,-86.98355103,34.60622406
226,"DECATUR GA",6,160,52,40,68,160,-84.29631805,33.77489471
226,"DECATUR IL",6,54,12,7,35,54,-88.95516968,39.84060287
226,"DECATUR IN",6,3,1,1,1,3,-84.93001556,40.82580566
226,"DECATUR TX",6,4,1,0,3,4,-97.58672333,33.23470306
226,"DECORAH IA",6,10,2,2,6,10,-91.78575134,43.30333328
226,"DEDHAM MA",6,12,4,1,7,12,-71.16512299,42.24193954
226,"DEER CREEK OK",6,1,1,0,0,1,-97.51993561,36.80317307
226,"DEERFIELD BEACH FL",6,40,11,8,21,40,-80.09928131,26.31905365
226,"DEERFIELD IL",6,9,3,5,1,9,-87.84490204,42.17103577
226,"DEFIANCE OH",6,13,4,3,6,13,-84.35565948,41.28461838
226,"DEL CITY OK",6,5,1,0,4,5,-97.44128418,35.44212723
226,"DEL MAR CA",6,1,0,0,1,1,-117.2663345,32.95969391
226,"DEL RIO TX",6,7,1,3,3,7,-100.8970642,29.36329842
226,"DELANCO NJ",6,3,0,0,3,3,-74.95298004,40.05101013
226,"DELAVAN IL",6,2,0,0,2,2,-89.54736328,40.37273788
226,"DELAWARE CITY DE",6,4,2,2,0,4,-75.59502411,39.57416534
226,"DELAWARE OH",6,3,1,2,0,3,-83.06757355,40.29886627
226,"DELMAR DE",6,2,0,1,1,2,-75.57416534,38.45691299
226,"DELRAY BEACH FL",6,41,12,14,15,41,-80.07209778,26.46233368
226,"DELTA CO",6,25,2,10,13,25,-108.0698395,38.74222946
226,"DEMING NM",6,1,0,0,1,1,-107.7599793,32.26507187
226,"DEMOPOLIS AL",6,1,1,0,0,1,-87.8364563,32.51809692
226,"DENHAM SPRINGS LA",6,7,2,2,3,7,-90.95632935,30.4871006
226,"DENISON IA",6,3,0,0,3,3,-95.35573578,42.01762009
226,"DENISON TX",6,1,1,0,0,1,-96.53727722,33.75577164
226,"DENTON NC",6,8,4,1,3,8,-80.1153183,35.63389587
226,"DENTON TX",6,408,101,113,194,408,-97.13349915,33.21514893
226,"DENVER CO",6,3100,844,843,1413,3100,-104.9853745,39.73901749
226,"DENVER PA",6,1,0,0,1,1,-76.13667297,40.23331451
226,"DENVILLE NJ",6,1,0,0,1,1,-74.47631836,40.89261246
226,"DEPEW NY",6,6,3,2,1,6,-78.69154358,42.90420532
226,"DERBY KS",6,23,5,9,9,23,-97.26980591,37.54567719
226,"DERRY NH",6,19,8,6,5,19,-71.32653809,42.88068008
226,"DES MOINES IA",6,300,81,85,134,300,-93.6210022,41.59817123
226,"DES MOINES WA",6,11,1,4,6,11,-122.3266525,47.40114594
226,"DES PLAINES IL",6,12,4,1,7,12,-87.8833847,42.03343964
226,"DESERT HOT SPRINGS CA",6,23,4,11,8,23,-116.5035934,33.96113586
226,"DESTIN FL",6,31,9,10,12,31,-86.49551392,30.39405632
226,"DETROIT MI",6,1950,527,502,921,1950,-83.04567719,42.33172226
226,"DETROIT TX",6,1,0,1,0,1,-95.26699829,33.66192245
226,"DEXTER ME",6,2,0,0,2,2,-69.2824173,45.02368164
226,"DEXTER MO",6,5,2,1,2,5,-89.95834351,36.79595947
226,"DIAMOND BAR CA",6,4,3,0,1,4,-117.8404999,33.97759247
226,"DICKINSON ND",6,4,2,0,2,4,-102.7891007,46.87979889
226,"DICKINSON TX",6,2,0,1,1,2,-95.05158234,29.46142769
226,"DILLON SC",6,3,1,0,2,3,-79.37909698,34.41096115
226,"DISTRICT HEIGHTS MD",6,2,2,0,0,2,-76.88869476,38.85776138
226,"DOBBS FERRY NY",6,5,2,2,1,5,-73.87168121,41.01457977
226,"DODGE CITY KS",6,2,0,1,1,2,-100.0181732,37.75279617
226,"DODGE NE",6,1,0,0,1,1,-96.88336945,41.7212944
226,"DONIPHAN MO",6,5,0,4,1,5,-90.82394409,36.62110138
226,"DONNA TX",6,2,1,0,1,2,-98.05448914,26.17434883
226,"DONORA PA",6,7,1,3,3,7,-79.85721588,40.17367935
226,"DORAVILLE GA",6,1,0,0,1,1,-84.28286743,33.89825821
226,"DOS PALOS CA",6,1,0,0,1,1,-120.6287766,36.98608398
226,"DOTHAN AL",6,12,3,5,4,12,-85.39019775,31.22351265
226,"DOUGLAS GA",6,12,3,6,3,12,-82.84980011,31.50903511
226,"DOUGLASVILLE GA",6,48,15,12,21,48,-84.74777222,33.75165939
226,"DOUSMAN WI",6,1,0,1,0,1,-88.4726944,43.01404572
226,"DOVER DE",6,17,4,6,7,17,-75.52090454,39.15853882
226,"DOVER NH",6,11,3,1,7,11,-70.88840485,43.2059021
226,"DOVER TN",6,1,0,1,0,1,-87.83837891,36.48816681
226,"DOYLESTOWN OH",6,3,1,0,2,3,-81.69629669,40.96931458
226,"DOYLESTOWN PA",6,22,5,8,9,22,-75.1292038,40.31054688
226,"DRAPER UT",6,2,1,1,0,2,-111.8741074,40.5280838
226,"DREW MS",6,1,1,0,0,1,-90.53083038,33.81049728
226,"DRIPPING SPRINGS TX",6,1,1,0,0,1,-98.08734131,30.19070816
226,"DUARTE CA",6,1,0,0,1,1,-117.9786072,34.13949966
226,"DUBLIN CA",6,65,22,15,28,65,-121.9383392,37.70181274
226,"DUBLIN GA",6,5,0,1,4,5,-82.90332794,32.540802
226,"DUBLIN TX",6,6,1,1,4,6,-98.34241486,32.08526611
226,"DUBLIN VA",6,1,1,0,0,1,-80.68517303,37.10611343
226,"DUBOIS PA",6,1,0,1,0,1,-78.75974274,41.11929321
226,"DUBUQUE IA",6,39,9,13,17,39,-90.67155457,42.51130295
226,"DULUTH MN",6,103,25,35,43,103,-92.10697174,46.78300858
226,"DUMAS AR",6,1,1,0,0,1,-91.48313904,33.88414001
226,"DUNBAR WV",6,7,2,2,3,7,-81.73683167,38.36086655
226,"DUNCAN OK",6,1,0,0,1,1,-97.95820618,34.50245667
226,"DUNCANNON PA",6,1,1,0,0,1,-77.03134155,40.38898087
226,"DUNCANVILLE TX",6,17,4,5,8,17,-96.9091568,32.65229034
226,"DUNEDIN FL",6,33,7,13,13,33,-82.77127838,28.02050591
226,"DUNMORE PA",6,1,0,0,1,1,-75.63155365,41.42010117
226,"DUNN NC",6,1,0,1,0,1,-78.60855103,35.30678558
226,"DUNNELLON FL",6,1,0,1,0,1,-82.46072388,29.04970551
226,"DUNWOODY GA",6,3,0,1,2,3,-84.33460236,33.94631958
226,"DURANGO CO",6,30,8,10,12,30,-107.8810043,37.27463913
226,"DURANT OK",6,2,0,1,1,2,-96.37478638,33.99116135
226,"DURHAM NC",6,937,249,279,409,937,-78.89787292,35.99412918
226,"DURHAM NH",6,1,1,0,0,1,-70.92732239,43.13511276
226,"DUXBURY MA",6,1,0,0,1,1,-70.66990662,42.04032516
226,"EAGAN MN",6,32,12,4,16,32,-93.16746521,44.80387878
226,"EAGLE ID",6,2,2,0,0,2,-116.3559189,43.69528198
226,"EAGLE LAKE MN",6,1,0,1,0,1,-93.88172913,44.16489792
226,"EAGLE PASS TX",6,2,0,0,2,2,-100.5002899,28.70978737
226,"EAGLE RIVER WI",6,2,1,0,1,2,-89.24466705,45.91718674
226,"EARTH TX",6,10,4,2,4,10,-102.4116135,34.23358154
226,"EASLEY SC",6,6,0,2,4,6,-82.60394287,34.82990646
226,"EAST CHICAGO IN",6,1,0,0,1,1,-87.44509125,41.64970398
226,"EAST DUBLIN GA",6,7,1,2,4,7,-82.86959839,32.54988098
226,"EAST GRAND FORKS MN",6,1,0,0,1,1,-97.02550507,47.93012619
226,"EAST GREENWICH RI",6,8,1,1,6,8,-71.45487976,41.66058731
226,"EAST HAMPTON NY",6,1,0,1,0,1,-72.18353271,40.96551895
226,"EAST HARTFORD CT",6,7,2,4,1,7,-72.64693451,41.77160263
226,"EAST HELENA MT",6,30,7,17,6,30,-111.9177475,46.58939743
226,"EAST LANSING MI",6,245,67,74,104,245,-84.48403931,42.73703384
226,"EAST LIVERPOOL OH",6,5,0,4,1,5,-80.57673645,40.61891556
226,"EAST LONGMEADOW MA",6,1,0,1,0,1,-72.51160431,42.06488037
226,"EAST MCKEESPORT PA",6,7,0,2,5,7,-79.80618286,40.38326645
226,"EAST MOLINE IL",6,2,1,1,0,2,-90.44459534,41.50070953
226,"EAST ORANGE NJ",6,83,24,29,30,83,-74.21418762,40.76618958
226,"EAST PALO ALTO CA",6,5,2,0,3,5,-122.143013,37.46857452
226,"EAST PEORIA IL",6,11,6,2,3,11,-89.58027649,40.66614151
226,"EAST POINT GA",6,14,5,1,8,14,-84.43933868,33.67996979
226,"EAST PROVIDENCE RI",6,7,3,2,2,7,-71.36916351,41.81398392
226,"EAST ROCHESTER NY",6,33,7,9,17,33,-77.48701477,43.1086731
226,"EAST TROY WI",6,2,0,2,0,2,-88.40551758,42.78525925
226,"EASTLAKE OH",6,4,3,0,1,4,-81.45001984,41.65415955
226,"EASTMAN GA",6,1,0,1,0,1,-83.17722321,32.19805527
226,"EASTON MD",6,5,3,1,1,5,-76.07592773,38.77448654
226,"EASTON PA",6,29,12,9,8,29,-75.21966553,40.68871689
226,"EATONTON GA",6,3,3,0,0,3,-83.38854218,33.32721329
226,"EAU CLAIRE WI",6,39,8,10,21,39,-91.49876404,44.81137466
226,"EDCOUCH TX",6,1,0,0,1,1,-97.96096802,26.29463768
226,"EDEN NC",6,1,0,0,1,1,-79.76634216,36.48883438
226,"EDEN PRAIRIE MN",6,43,11,15,17,43,-93.48716736,44.85310745
226,"EDGAR SPRINGS MO",6,3,0,0,3,3,-91.86699677,37.70466232
226,"EDGEFIELD SC",6,1,0,1,0,1,-81.92941284,33.78982162
226,"EDGEWATER CO",6,1,0,0,1,1,-105.065361,39.75324249
226,"EDGEWATER FL",6,3,1,2,0,3,-80.90637207,28.99158287
226,"EDGEWOOD WA",6,10,1,3,6,10,-122.2963791,47.2498703
226,"EDINA MN",6,8,3,2,3,8,-93.34928131,44.91236496
226,"EDINA MO",6,5,2,0,3,5,-92.1732254,40.16763306
226,"EDINBORO PA",6,10,2,6,2,10,-80.13100433,41.87437439
226,"EDINBURG TX",6,108,34,32,42,108,-98.16417694,26.30259705
226,"EDINBURGH IN",6,1,0,0,1,1,-85.96690369,39.35437775
226,"EDISTO BEACH SC",6,1,0,0,1,1,-80.33158112,32.48329544
226,"EDMOND OK",6,171,53,53,65,171,-97.48453522,35.65326309
226,"EDMONDS WA",6,127,30,32,65,127,-122.3799057,47.81037521
226,"EDWARDSVILLE IL",6,128,36,33,59,128,-89.95322418,38.8115654
226,"EFFINGHAM IL",6,2,1,0,1,2,-88.54359436,39.12008667
226,"EL CENTRO CA",6,4,1,2,1,4,-115.5646057,32.79199982
226,"EL CERRITO CA",6,82,26,22,34,82,-122.3142548,37.91544342
226,"EL DORADO AR",6,1,1,0,0,1,-92.66680908,33.20800018
226,"EL LAGO TX",6,1,0,0,1,1,-95.04547119,29.56394196
226,"EL MONTE CA",6,32,10,6,16,32,-118.0298996,34.06880569
226,"EL PASO TX",6,237,73,63,101,237,-106.4620514,31.78388405
226,"EL RENO OK",6,4,0,0,4,4,-97.95549011,35.53218842
226,"EL SEGUNDO CA",6,7,1,1,5,7,-118.4185257,33.91943741
226,"ELBERTON GA",6,1,0,1,0,1,-82.86587524,34.11487579
226,"ELDON MO",6,6,0,0,6,6,-92.58213806,38.34849548
226,"ELGIN IL",6,18,7,3,8,18,-88.28123474,42.03733444
226,"ELGIN SC",6,13,1,6,6,13,-80.79399872,34.17118073
226,"ELGIN TX",6,1,0,0,1,1,-97.37094879,30.34980202
226,"ELIZABETH CITY NC",6,14,6,1,7,14,-76.22274017,36.3025322
226,"ELIZABETH CO",6,1,1,0,0,1,-104.5973434,39.36034393
226,"ELIZABETH NJ",6,26,4,7,15,26,-74.21881866,40.66823578
226,"ELIZABETHTON TN",6,1,1,0,0,1,-82.21013641,36.34902954
226,"ELIZABETHTOWN KY",6,10,0,6,4,10,-85.85932159,37.69418716
226,"ELIZABETHTOWN PA",6,13,5,3,5,13,-76.60209656,40.15314865
226,"ELK GROVE CA",6,28,10,7,11,28,-121.3743591,38.40848923
226,"ELK GROVE VILLAGE IL",6,2,0,1,1,2,-87.97052765,42.00406647
226,"ELK RIVER MN",6,1,1,0,0,1,-93.56745911,45.30422974
226,"ELKHART IN",6,28,9,9,10,28,-85.97689056,41.68212128
226,"ELKHORN WI",6,1,0,1,0,1,-88.54447174,42.67270279
226,"ELKIN NC",6,8,2,2,4,8,-80.8482132,36.24475098
226,"ELKINS WV",6,1,1,0,0,1,-79.85980225,38.92602921
226,"ELKO NV",6,8,2,2,4,8,-115.7643967,40.83226395
226,"ELKTON MD",6,2,1,1,0,2,-75.83261108,39.60694122
226,"ELLENSBURG WA",6,28,10,6,12,28,-120.5507507,46.99611664
226,"ELLIJAY GA",6,1,1,0,0,1,-84.48228455,34.69475937
226,"ELLSWORTH ME",6,1,0,0,1,1,-68.41850281,44.54365921
226,"ELMHURST IL",6,28,8,9,11,28,-87.9407196,41.89970398
226,"ELMIRA NY",6,21,5,10,6,21,-76.80737305,42.08998108
226,"ELMORE AL",6,1,0,0,1,1,-86.31501007,32.53902054
226,"ELMWOOD IL",6,2,1,1,0,2,-89.96702576,40.77780151
226,"ELMWOOD PARK IL",6,1,1,0,0,1,-87.80945587,41.92121506
226,"ELMWOOD PARK NJ",6,4,0,1,3,4,-74.1175766,40.90429306
226,"ELSA TX",6,2,0,1,1,2,-97.99377441,26.29435349
226,"ELSBERRY MO",6,2,1,1,0,2,-90.78118896,39.16703796
226,"ELWOOD IN",6,1,0,0,1,1,-85.84185791,40.27725983
226,"ELY IA",6,4,1,2,1,4,-91.58531189,41.87372589
226,"ELYRIA OH",6,33,9,9,15,33,-82.10734558,41.36825562
226,"EMERSON NJ",6,1,0,0,1,1,-74.02526855,40.97657013
226,"EMERYVILLE CA",6,6,1,2,3,6,-122.2871475,37.83127975
226,"EMMAUS PA",6,18,10,4,4,18,-75.49610138,40.53958893
226,"EMPORIA KS",6,3,0,1,2,3,-96.18218994,38.40393448
226,"ENCINAL TX",6,1,0,0,1,1,-99.35529327,28.04174042
226,"ENCINITAS CA",6,12,3,4,5,12,-117.2937012,33.0371666
226,"ENGLEWOOD CO",6,20,6,9,5,20,-104.9884491,39.6479187
226,"ENGLEWOOD NJ",6,21,3,8,10,21,-73.97172546,40.8928833
226,"ENGLISHTOWN NJ",6,2,0,2,0,2,-74.35713196,40.29751205
226,"ENID OK",6,4,1,2,1,4,-97.87895203,36.39573288
226,"ENNIS TX",6,1,0,0,1,1,-96.6258316,32.32971191
226,"ENTERPRISE AL",6,5,1,1,3,5,-85.85494995,31.31528282
226,"ENTERPRISE MS",6,1,1,0,0,1,-88.82051849,32.17414474
226,"ENUMCLAW WA",6,2,1,0,1,2,-121.9936066,47.20384598
226,"EPHRAIM UT",6,2,0,0,2,2,-111.5881271,39.35956573
226,"ERIE CO",6,2,0,1,1,2,-105.0506516,40.0500946
226,"ERIE PA",6,99,26,24,49,99,-80.08492279,42.12926483
226,"ERLANGER KY",6,3,1,0,2,3,-84.60089111,39.01673508
226,"ERWIN TN",6,2,0,0,2,2,-82.41162109,36.15189362
226,"ESCANABA MI",6,2,0,0,2,2,-87.06468964,45.74517822
226,"ESCONDIDO CA",6,21,8,5,8,21,-117.0886231,33.11952591
226,"ESSEX MA",6,1,1,0,0,1,-70.78186798,42.63206863
226,"ESSEXVILLE MI",6,1,0,1,0,1,-83.84166718,43.61558151
226,"ESTACADA OR",6,2,1,1,0,2,-122.3353424,45.28915405
226,"ESTERO FL",6,4,1,1,2,4,-81.80654144,26.43899536
226,"ESTES PARK CO",6,21,8,5,8,21,-105.5249558,40.37337112
226,"ESTILL SPRINGS TN",6,1,0,0,1,1,-86.12779999,35.27093887
226,"ETNA PA",6,1,0,0,1,1,-79.94859314,40.50443268
226,"EUCLID OH",6,8,3,2,3,8,-81.52645111,41.59303284
226,"EUDORA KS",6,1,1,0,0,1,-95.09897614,38.943367
226,"EUFAULA AL",6,2,0,1,1,2,-85.1452179,31.89162636
226,"EUGENE OR",6,423,127,121,175,423,-123.0898361,44.05194855
226,"EULESS TX",6,25,6,6,13,25,-97.08273315,32.83728409
226,"EUNICE LA",6,4,2,2,0,4,-92.41770172,30.49472046
226,"EUREKA CA",6,16,7,5,4,16,-124.1653366,40.80156708
226,"EUREKA MO",6,6,2,1,3,6,-90.62799835,38.50252533
226,"EUREKA SPRINGS AR",6,1,0,1,0,1,-93.73842621,36.40146255
226,"EUSTIS FL",6,4,1,1,2,4,-81.68483734,28.85318184
226,"EUTAW AL",6,4,0,1,3,4,-87.88775635,32.84085083
226,"EVANS CO",6,2,0,0,2,2,-104.6938095,40.37656403
226,"EVANSTON IL",6,136,39,29,68,136,-87.69037628,42.04132843
226,"EVANSTON WY",6,14,3,4,7,14,-110.9652634,41.26803589
226,"EVANSVILLE IN",6,75,19,21,35,75,-87.56850433,37.97795486
226,"EVART MI",6,3,0,2,1,3,-85.25918579,43.90063477
226,"EVERETT MA",6,30,7,6,17,30,-71.05252075,42.40878296
226,"EVERETT WA",6,57,12,18,27,57,-122.2045441,47.97843552
226,"EVERGREEN PARK IL",6,5,1,1,3,5,-87.70169067,41.72086334
226,"EWING MO",6,1,0,1,0,1,-91.70560455,40.00642395
226,"EXETER CA",6,1,0,1,0,1,-119.1437607,36.29608917
226,"EXETER NH",6,17,8,1,8,17,-70.95800781,42.98471451
226,"FAIR HAVEN NJ",6,51,9,18,24,51,-74.03659821,40.35977936
226,"FAIR LAWN NJ",6,2,0,1,1,2,-74.13076019,40.94062424
226,"FAIRBANKS AK",6,33,9,14,10,33,-147.7185669,64.83367157
226,"FAIRBORN OH",6,5,3,0,2,5,-84.01902771,39.82121658
226,"FAIRFAX CA",6,1,0,0,1,1,-122.5909805,37.98677063
226,"FAIRFAX MO",6,2,0,0,2,2,-95.39389038,40.3384285
226,"FAIRFAX VA",6,252,67,88,97,252,-77.30588531,38.84661865
226,"FAIRFIELD CA",6,27,8,7,12,27,-122.0420914,38.24917603
226,"FAIRFIELD CT",6,7,2,4,1,7,-73.26300049,41.14122772
226,"FAIRFIELD IA",6,6,1,1,4,6,-91.96311188,41.00863266
226,"FAIRFIELD OH",6,4,1,0,3,4,-84.56064606,39.34600449
226,"FAIRFIELD PA",6,1,1,0,0,1,-77.36804962,39.78766632
226,"FAIRHAVEN MA",6,2,1,0,1,2,-70.902565,41.63794327
226,"FAIRHOPE AL",6,1,0,0,1,1,-87.90351105,30.52334213
226,"FAIRMONT CITY IL",6,5,1,0,4,5,-90.09365845,38.65008545
226,"FAIRMONT WV",6,12,4,1,7,12,-80.14244843,39.48347473
226,"FAIRVIEW NJ",6,3,1,0,0,1,-74.2984898866667,40.3536287933333
226,"FAIRVIEW PA",6,1,0,0,1,1,-80.25499725,42.03170013
226,"FAIRVIEW PARK OH",6,3,0,1,2,3,-81.86431885,41.44171524
226,"FAIRVIEW TX",6,1,0,1,0,1,-101.5199509,32.35611343
226,"FALL RIVER MA",6,15,4,5,6,15,-71.15414429,41.70151138
226,"FALLS CHURCH VA",6,42,13,9,20,42,-77.17056274,38.88268661
226,"FALLS CITY TX",6,1,1,0,0,1,-98.01808167,28.98327637
226,"FALMOUTH MA",6,3,0,1,2,3,-70.61294556,41.56003571
226,"FARGO ND",6,95,33,35,27,95,-96.79805756,46.87498474
226,"FARIBAULT MN",6,9,4,0,5,9,-93.26953125,44.29466248
226,"FARMERS BRANCH TX",6,1,1,0,0,1,-96.89679718,32.92665482
226,"FARMINGDALE NY",6,2,0,2,0,2,-73.44436646,40.73298645
226,"FARMINGTON HILLS MI",6,39,14,9,16,39,-83.3771286,42.48558807
226,"FARMINGTON MI",6,13,5,3,5,13,-83.37620544,42.46465302
226,"FARMINGTON MO",6,8,5,1,2,8,-90.4220047,37.78110504
226,"FARMINGTON NH",6,2,1,1,0,2,-71.07139587,43.38951111
226,"FARMINGTON NM",6,9,1,4,4,9,-108.2051544,36.73355865
226,"FARMINGTON UT",6,2,1,1,0,2,-111.8891068,40.98031616
226,"FARMVILLE VA",6,10,2,2,6,10,-78.39121246,37.30234909
226,"FAYETTE MO",6,3,2,0,1,3,-92.68386078,39.14609146
226,"FAYETTEVILLE AR",6,176,58,39,79,176,-94.15759277,36.06256104
226,"FAYETTEVILLE GA",6,1,1,0,0,1,-84.45489502,33.44916916
226,"FAYETTEVILLE NC",6,160,31,44,85,160,-78.87771606,35.05313873
226,"FAYETTEVILLE NY",6,20,7,5,8,20,-76.0059433,43.02997971
226,"FAYETTEVILLE TN",6,2,1,0,1,2,-86.57073212,35.15206146
226,"FAYETTEVILLE TX",6,1,1,0,0,1,-96.67340851,29.90643501
226,"FEDERAL HEIGHTS CO",6,1,0,0,1,1,-104.9993591,39.85155487
226,"FEDERAL WAY WA",6,63,17,15,31,63,-122.314415,47.32177734
226,"FEDERALSBURG MD",6,1,1,0,0,1,-75.77262115,38.69446945
226,"FENTON MI",6,12,2,3,7,12,-83.70490265,42.79768372
226,"FENTON MO",6,91,25,29,37,91,-90.43593597,38.51305771
226,"FERGUSON MO",6,101,40,21,40,101,-90.306633,38.74429321
226,"FERNANDINA BEACH FL",6,1,0,0,1,1,-81.46240234,30.66996193
226,"FERNDALE MI",6,61,12,17,32,61,-83.13441467,42.46089172
226,"FERNDALE WA",6,8,3,3,2,8,-122.5937119,48.84636688
226,"FERNLEY NV",6,2,0,1,1,2,-119.2542114,39.60798645
226,"FESTUS MO",6,7,5,1,1,7,-90.39609528,38.22088623
226,"FILLMORE CA",6,2,1,0,1,2,-118.919754,34.39930344
226,"FINDLAY OH",6,8,2,2,4,8,-83.64990997,41.04424286
226,"FINLEYVILLE PA",6,1,0,1,0,1,-80.00263977,40.25251389
226,"FISHERS IN",6,66,16,12,38,66,-86.0140152,39.95565414
226,"FITCHBURG MA",6,3,2,0,1,3,-71.79621124,42.58549881
226,"FITCHBURG WI",6,3,0,0,3,3,-89.47031403,42.96075439
226,"FLAGLER BEACH FL",6,33,10,10,13,33,-81.12680054,29.47527695
226,"FLAGSTAFF AZ",6,83,25,19,39,83,-111.6533051,35.19802475
226,"FLAT ROCK MI",6,1,0,0,1,1,-83.29182434,42.09670639
226,"FLATWOODS KY",6,2,0,0,2,2,-82.71713257,38.52272797
226,"FLEMINGTON NJ",6,1,0,0,1,1,-74.85857391,40.51246643
226,"FLINT MI",6,141,36,39,66,141,-83.68744659,43.01246643
226,"FLORAL PARK NY",6,3,0,1,2,3,-73.70424652,40.72377777
226,"FLORENCE AL",6,12,4,5,3,12,-87.67726898,34.7997818
226,"FLORENCE AZ",6,1,0,0,1,1,-111.3891525,33.0316925
226,"FLORENCE KY",6,18,4,5,9,18,-84.62657166,38.99923706
226,"FLORENCE SC",6,18,6,3,9,18,-79.76351166,34.19935226
226,"FLORESVILLE TX",6,1,0,1,0,1,-98.15641022,29.13393784
226,"FLORIDA CITY FL",6,6,2,2,2,6,-80.47893524,25.44846153
226,"FLORISSANT MO",6,91,42,15,34,91,-90.32299042,38.78946304
226,"FLOSSMOOR IL",6,1,1,0,0,1,-87.68474579,41.54309845
226,"FLOYD VA",6,2,0,0,2,2,-80.31944275,36.91149902
226,"FLUSHING MI",6,13,3,2,8,13,-83.85099792,43.06319427
226,"FOND DU LAC WI",6,5,1,3,1,5,-88.44734955,43.77285004
226,"FONTANA CA",6,24,8,7,9,24,-117.4363785,34.09202576
226,"FOREST CITY IA",6,1,0,1,0,1,-93.63772583,43.26252365
226,"FOREST CITY NC",6,2,0,0,2,2,-81.86473083,35.33415604
226,"FOREST GROVE OR",6,3,2,0,1,3,-123.1123581,45.51952362
226,"FOREST HILLS PA",6,1,0,0,1,1,-79.84965515,40.42011642
226,"FOREST LAKE MN",6,2,1,0,1,2,-92.98565674,45.27859497
226,"FOREST PARK IL",6,2,1,1,0,2,-87.81355286,41.87948608
226,"FOREST PARK OH",6,4,0,1,3,4,-84.50376892,39.2902565
226,"FORKS WA",6,1,0,1,0,1,-124.3879929,47.94977951
226,"FORNEY TX",6,13,4,4,5,13,-96.47270966,32.74848175
226,"FORREST CITY AR",6,1,1,0,0,1,-90.79021454,35.00848389
226,"FORSYTH GA",6,1,0,0,1,1,-83.93824768,33.03457642
226,"FORT ATKINSON WI",6,4,1,1,2,4,-88.83695984,42.92907715
226,"FORT COLLINS CO",6,238,79,58,101,238,-105.0858688,40.58546066
226,"FORT DODGE IA",6,3,1,0,2,3,-94.18049622,42.50019073
226,"FORT KENT ME",6,1,0,0,1,1,-68.58863831,47.25884247
226,"FORT LAUDERDALE FL",6,471,129,115,227,471,-80.14283752,26.12309074
226,"FORT LEE NJ",6,1,0,0,1,1,-73.96900177,40.85113907
226,"FORT LUPTON CO",6,3,0,2,1,3,-104.8086929,40.07614517
226,"FORT MILL SC",6,14,3,3,8,14,-80.94496155,35.00762558
226,"FORT MITCHELL KY",6,1,0,1,0,1,-84.54763031,39.05939865
226,"FORT MYERS FL",6,113,33,29,51,113,-81.87184143,26.64133644
226,"FORT PAYNE AL",6,3,0,1,2,3,-85.71984863,34.44424438
226,"FORT PIERCE FL",6,7,1,2,4,7,-80.32531738,27.44716644
226,"FORT SCOTT KS",6,1,1,0,0,1,-94.70889282,37.83989716
226,"FORT SMITH AR",6,30,8,7,15,30,-94.39919281,35.3862114
226,"FORT VALLEY GA",6,5,0,3,2,5,-83.88742828,32.5541687
226,"FORT WALTON BEACH FL",6,17,4,4,9,17,-86.61834717,30.40767479
226,"FORT WAYNE IN",6,207,51,49,107,207,-85.13967896,41.07278061
226,"FORT WORTH TX",6,875,254,203,418,875,-97.32135773,32.72562027
226,"FOSTER CITY CA",6,4,1,1,2,4,-122.2733917,37.55817413
226,"FOUNTAIN CO",6,5,2,0,3,5,-104.7017517,38.68201065
226,"FOUNTAIN INN SC",6,1,0,1,0,1,-82.20529175,34.69663239
226,"FRAMINGHAM MA",6,14,4,2,8,14,-71.41543579,42.27958298
226,"FRANKENMUTH MI",6,1,0,0,1,1,-83.73799896,43.33162689
226,"FRANKFORT IL",6,2,0,0,2,2,-87.8484726,41.49582291
226,"FRANKFORT KY",6,29,15,8,6,29,-84.87322235,38.20124054
226,"FRANKLIN IN",6,3,1,0,2,3,-86.05474854,39.48073578
226,"FRANKLIN KY",6,7,3,2,2,7,-86.57696533,36.72238159
226,"FRANKLIN LA",6,1,0,0,1,1,-91.50192261,29.79652786
226,"FRANKLIN NJ",6,2,1,0,1,2,-74.57991791,41.12214279
226,"FRANKLIN OH",6,1,1,0,0,1,-84.30413055,39.55898666
226,"FRANKLIN TN",6,20,5,4,11,20,-86.87760162,35.92164993
226,"FRANKLIN WI",6,2,0,1,0,1,-89.581264495,43.550542835
226,"FRANKTON IN",6,2,0,1,1,2,-85.77852631,40.2229538
226,"FRASER CO",6,1,0,0,1,1,-105.8187408,39.94474792
226,"FRASER MI",6,3,1,1,1,3,-82.94940948,42.53918457
226,"FREDERICK MD",6,119,35,36,48,119,-77.40981293,39.41444397
226,"FREDERICKSBURG TX",6,1,0,0,1,1,-98.87243652,30.27570152
226,"FREDERICKSBURG VA",6,48,9,19,20,48,-77.45996094,38.30348969
226,"FREDERICKTOWN MO",6,8,1,4,3,8,-90.29403687,37.5598793
226,"FREDONIA NY",6,3,0,2,1,3,-79.33128357,42.4403038
226,"FREEBURG IL",6,1,0,1,0,1,-89.91384888,38.42782593
226,"FREEDOM PA",6,2,0,2,0,2,-80.25327301,40.68782806
226,"FREEHOLD NJ",6,5,2,0,3,5,-74.27283478,40.26020432
226,"FREEPORT FL",6,1,0,0,1,1,-86.13587189,30.49859619
226,"FREEPORT IL",6,12,4,2,6,12,-89.62126923,42.29691696
226,"FREEPORT NY",6,4,2,0,2,4,-73.58229065,40.65803146
226,"FREEPORT TX",6,7,0,2,5,7,-95.35985565,28.95484543
226,"FREMONT CA",6,83,25,24,34,83,-121.9740372,37.55101776
226,"FREMONT NE",6,1,0,1,0,1,-96.49893188,41.43340683
226,"FREMONT OH",6,3,1,0,2,3,-83.12195587,41.35057831
226,"FRESNO CA",6,382,101,97,184,382,-119.7739868,36.74755478
226,"FRIDAY HARBOR WA",6,1,0,1,0,1,-123.0112152,48.53361893
226,"FRIDLEY MN",6,19,5,6,8,19,-93.2636261,45.08617401
226,"FRIENDSHIP WI",6,1,1,0,0,1,-89.81681061,43.97062302
226,"FRIENDSWOOD TX",6,6,2,3,1,6,-95.20127106,29.53010368
226,"FRISCO CO",6,1,0,0,1,1,-106.0990143,39.57444763
226,"FRISCO TX",6,77,28,21,28,77,-96.82434082,33.15098572
226,"FROSTBURG MD",6,1,0,1,0,1,-78.92780304,39.65832138
226,"FRUITA CO",6,2,1,1,0,2,-108.7299423,39.15882111
226,"FULLERTON CA",6,89,29,14,46,89,-117.9268646,33.87014771
226,"FULTON NY",6,1,0,0,1,1,-76.41664124,43.32299042
226,"GADSDEN AL",6,14,3,5,6,14,-86.00675201,34.01457596
226,"GAFFNEY SC",6,4,2,0,2,4,-81.64937592,35.07206345
226,"GAHANNA OH",6,2,2,0,0,2,-82.87860107,40.02072525
226,"GAINESVILLE FL",6,390,112,113,165,390,-82.32462311,29.65203285
226,"GAINESVILLE GA",6,17,4,4,9,17,-83.82389832,34.29787827
226,"GAINESVILLE TX",6,2,1,1,0,2,-97.13391113,33.62611008
226,"GAITHERSBURG MD",6,39,11,12,16,39,-77.20072174,39.14352417
226,"GALESBURG IL",6,27,12,6,9,27,-90.37152863,40.9480629
226,"GALLATIN TN",6,16,4,3,9,16,-86.44691467,36.38848495
226,"GALLUP NM",6,1,0,0,1,1,-108.7434387,35.52494812
226,"GALT CA",6,1,1,0,0,1,-121.3024445,38.25453568
226,"GALVESTON IN",6,2,0,0,2,2,-86.19012451,40.57881165
226,"GALVESTON TX",6,24,4,7,13,24,-94.79576111,29.30070114
226,"GARDEN CITY KS",6,2,1,0,1,2,-100.8735352,37.97177505
226,"GARDEN CITY MI",6,1,0,1,0,1,-83.33091736,42.32582092
226,"GARDEN CITY MO",6,2,1,0,1,2,-94.19150543,38.56124496
226,"GARDEN CITY NY",6,2,0,0,2,2,-73.63320923,40.72684097
226,"GARDEN GROVE CA",6,25,4,6,15,25,-117.943718,33.77397156
226,"GARDEN PLAIN KS",6,1,1,0,0,1,-97.68421173,37.65839767
226,"GARDENA CA",6,19,5,7,7,19,-118.3105164,33.88837814
226,"GARDINER ME",6,6,0,1,5,6,-69.77404785,44.23034286
226,"GARDNER KS",6,21,7,5,9,21,-94.92789459,38.81066132
226,"GARDNER MA",6,4,0,2,2,4,-71.99727631,42.57534027
226,"GARFIELD NJ",6,1,0,1,0,1,-74.11222839,40.88159561
226,"GARLAND TX",6,37,8,9,20,37,-96.63926697,32.91297531
226,"GARNER NC",6,16,3,4,9,16,-78.61359406,35.71166992
226,"GARRETT IN",6,1,0,0,1,1,-85.13555908,41.3495636
226,"GARY IN",6,48,16,11,21,48,-87.33873749,41.59325409
226,"GASTON OR",6,1,0,1,0,1,-123.141571,45.43574142
226,"GASTON SC",6,7,1,4,2,7,-81.10059357,33.8172226
226,"GASTONIA NC",6,36,9,10,17,36,-81.18706512,35.26216507
226,"GATESVILLE TX",6,1,1,0,0,1,-97.74459839,31.43569565
226,"GAUTIER MS",6,2,1,0,1,2,-88.628479,30.38991356
226,"GAYLORD MI",6,13,4,4,5,13,-84.67483521,45.02762222
226,"GENESEE WI",6,1,0,0,1,1,-88.35901642,42.9526329
226,"GENEVA IL",6,14,2,4,8,14,-88.30541992,41.8876915
226,"GENEVA NY",6,5,3,1,1,5,-76.97723389,42.86890793
226,"GENOA IL",6,3,1,2,0,3,-88.6933136,42.09733582
226,"GENOA NE",6,1,0,0,1,1,-97.73149109,41.44846344
226,"GEORGETOWN CO",6,3,1,0,2,3,-105.6985626,39.70604706
226,"GEORGETOWN KY",6,4,0,1,3,4,-84.55860138,38.21012115
226,"GEORGETOWN TX",6,19,4,6,9,19,-97.67801666,30.6329689
226,"GERMANTOWN TN",6,2,0,2,0,2,-89.80731201,35.08958817
226,"GERMANTOWN WI",6,1,0,0,1,1,-88.1105423,43.22859573
226,"GETTYSBURG PA",6,4,1,3,0,4,-77.23023224,39.83097076
226,"GETTYSBURG SD",6,1,0,0,1,1,-99.95274353,45.01167679
226,"GIG HARBOR WA",6,46,13,13,20,46,-122.590683,47.32983398
226,"GILBERT AZ",6,51,17,13,21,51,-111.7899933,33.35302353
226,"GILBERT WV",6,2,1,1,0,2,-81.86518097,37.61510086
226,"GILROY CA",6,6,2,0,4,6,-121.570343,37.00583267
226,"GIRARD OH",6,1,0,1,0,1,-80.70133209,41.15385056
226,"GIRARD PA",6,2,0,0,2,2,-80.31739044,42.00037003
226,"GLADSTONE MO",6,31,11,4,16,31,-94.55509186,39.20398331
226,"GLADSTONE OR",6,5,1,2,2,5,-122.597435,45.38039398
226,"GLADWIN MI",6,1,1,0,0,1,-84.48670959,43.98090744
226,"GLASGOW KY",6,29,4,10,15,29,-85.91189575,36.99584961
226,"GLASSBORO NJ",6,43,14,7,22,43,-75.11103058,39.70306778
226,"GLEN ROCK NJ",6,1,0,0,1,1,-74.13186646,40.96286011
226,"GLENCOE IL",6,1,0,1,0,1,-87.75849152,42.13492203
226,"GLENCOE MN",6,6,1,5,0,6,-94.15203094,44.76893234
226,"GLENDALE AZ",6,35,10,11,14,35,-112.1871796,33.5386467
226,"GLENDALE CA",6,206,62,47,97,206,-118.2566681,34.1423645
226,"GLENDALE HEIGHTS IL",6,1,1,0,0,1,-88.07187653,41.91030502
226,"GLENDALE OR",6,1,0,0,1,1,-123.4252319,42.73606491
226,"GLENDIVE MT",6,1,0,0,1,1,-104.7115021,47.11004257
226,"GLENDORA CA",6,11,6,1,4,11,-117.8665314,34.13615417
226,"GLENOLDEN PA",6,1,1,0,0,1,-75.28848267,39.90028
226,"GLENS FALLS NY",6,1,0,0,1,1,-73.64286041,43.30945969
226,"GLENVIEW IL",6,3,0,0,3,3,-87.78792572,42.06991196
226,"GLENWOOD SPRINGS CO",6,3,1,1,1,3,-107.3256455,39.55069733
226,"GLIDDEN IA",6,1,0,0,1,1,-94.72888184,42.06323624
226,"GLOUCESTER CITY NJ",6,5,1,2,2,5,-75.11563873,39.89209747
226,"GLOUCESTER MA",6,2,0,1,1,2,-70.66117096,42.61589432
226,"GODDARD KS",6,3,1,1,1,3,-97.57605743,37.65989304
226,"GODFREY IL",6,9,4,2,3,9,-90.18669891,38.95780182
226,"GOLD HILL OR",6,1,0,1,0,1,-123.0242615,42.44165039
226,"GOLDEN CO",6,7,3,0,4,7,-105.2226791,39.75567627
226,"GOLDEN VALLEY MN",6,6,3,2,1,6,-93.33234406,44.98583603
226,"GOLDENDALE WA",6,7,1,0,6,7,-120.8248444,45.82035828
226,"GOLDFIELD IA",6,3,1,0,2,3,-93.92066193,42.73672485
226,"GOLDSBORO NC",6,2,0,2,0,2,-77.99216461,35.38506317
226,"GOLETA CA",6,7,6,1,0,7,-119.8299332,34.43574142
226,"GONZALES CA",6,6,2,2,2,6,-121.4461136,36.50678635
226,"GOODLAND IN",6,2,0,2,0,2,-87.2937088,40.76358795
226,"GOODRICH TX",6,3,0,2,1,3,-94.9467926,30.60574341
226,"GOOSE CREEK SC",6,7,0,1,6,7,-80.03201294,32.98114395
226,"GORDONSVILLE TN",6,1,0,0,1,1,-85.92985535,36.17253113
226,"GORE OK",6,1,0,0,1,1,-95.11740875,35.52949905
226,"GORHAM NH",6,1,1,0,0,1,-71.17190552,44.38262939
226,"GOSHEN IN",6,3,1,0,2,3,-85.8345871,41.58250046
226,"GOWER MO",6,2,0,0,2,2,-94.60014343,39.61081314
226,"GOWRIE IA",6,4,2,1,1,4,-94.29121399,42.28058243
226,"GRAFTON IL",6,1,0,0,1,1,-90.43186188,38.97026443
226,"GRAFTON NH",6,1,0,0,1,1,-71.94319916,43.55873108
226,"GRAHAM NC",6,2,1,0,1,2,-79.39993286,36.06936646
226,"GRAMBLING LA",6,1,0,1,0,1,-92.71523285,32.52869415
226,"GRAND BLANC MI",6,20,4,8,8,20,-83.62955475,42.92750168
226,"GRAND FORKS ND",6,25,8,10,7,25,-97.03855133,47.92044067
226,"GRAND HAVEN MI",6,5,1,3,1,5,-86.22866058,43.06328964
226,"GRAND ISLAND NE",6,2,1,1,0,2,-98.34256744,40.92502213
226,"GRAND JUNCTION CO",6,18,5,5,8,18,-108.5520706,39.06374741
226,"GRAND LAKE CO",6,1,1,0,0,1,-105.8245697,40.25669479
226,"GRAND LEDGE MI",6,3,0,1,2,3,-84.74642944,42.7535553
226,"GRAND MARAIS MN",6,1,1,0,0,1,-90.33486176,47.75009918
226,"GRAND PRAIRIE TX",6,22,6,3,13,22,-96.99823761,32.74625015
226,"GRAND RAPIDS MI",6,490,136,150,204,490,-85.66797638,42.96317291
226,"GRANDVIEW MO",6,2,1,0,1,2,-94.53369904,38.88563538
226,"GRANDVIEW WA",6,1,0,0,1,1,-119.9046249,46.25063705
226,"GRANDVILLE MI",6,5,0,0,5,5,-85.76309204,42.90962982
226,"GRANGER WA",6,2,0,1,1,2,-120.1894989,46.34181976
226,"GRANITE CITY IL",6,74,23,21,30,74,-90.14891815,38.70147705
226,"GRANT PARK IL",6,1,0,1,0,1,-87.64607239,41.24023056
226,"GRANTHAM NH",6,3,1,2,0,3,-72.13131714,43.47785568
226,"GRANTS PASS OR",6,9,1,3,5,9,-123.3306351,42.43851471
226,"GRANVILLE OH",6,3,2,1,0,3,-82.51766205,40.06572723
226,"GRAPEVINE TX",6,31,13,6,12,31,-97.07859802,32.93464279
226,"GRASS VALLEY CA",6,2,0,1,1,2,-121.0632553,39.21873856
226,"GRAY COURT SC",6,3,1,1,1,3,-82.11286926,34.60851669
226,"GRAYLING MI",6,2,1,0,1,2,-84.71489716,44.66165161
226,"GRAYSLAKE IL",6,4,1,1,2,4,-88.04187775,42.34467697
226,"GREAT BARRINGTON MA",6,5,1,1,3,5,-73.36142731,42.19623566
226,"GREAT BEND KS",6,14,2,4,8,14,-98.76521301,38.36428452
226,"GREAT FALLS MT",6,13,3,2,8,13,-111.2823257,47.50692368
226,"GREAT NECK NY",6,1,0,0,1,1,-73.72780609,40.80078125
226,"GREECE NY",6,5,2,1,2,5,-77.69234467,43.21003342
226,"GREELEY CO",6,54,16,12,26,54,-104.7104645,40.42345047
226,"GREEN BAY WI",6,136,35,43,58,136,-88.01370239,44.51335907
226,"GREEN RIVER UT",6,1,1,0,0,1,-110.1631851,38.99538422
226,"GREEN RIVER WY",6,1,0,0,1,1,-109.4680557,41.52866745
226,"GREENBELT MD",6,51,17,8,26,51,-76.87561035,39.00544357
226,"GREENDALE WI",6,1,1,0,0,1,-87.99612427,42.94078827
226,"GREENEVILLE TN",6,21,7,5,9,21,-82.83133698,36.16376495
226,"GREENFIELD IA",6,2,1,1,0,2,-94.46188354,41.30505371
226,"GREENFIELD IN",6,6,4,1,1,6,-85.76914978,39.78491974
226,"GREENFIELD WI",6,2,1,0,1,2,-88.01258087,42.96144104
226,"GREENSBORO MD",6,1,0,0,1,1,-75.80445862,38.97415161
226,"GREENSBORO NC",6,431,122,111,198,431,-79.79152679,36.0729599
226,"GREENSBURG IN",6,1,0,0,1,1,-85.48336792,39.33731842
226,"GREENSBURG PA",6,15,5,3,7,15,-79.53821564,40.30168915
226,"GREENVILLE AL",6,1,0,1,0,1,-86.61798096,31.82992363
226,"GREENVILLE IL",6,4,1,2,1,4,-89.41333008,38.89213562
226,"GREENVILLE MS",6,3,2,1,0,3,-91.05704498,33.40253448
226,"GREENVILLE NC",6,62,15,14,33,62,-77.37215424,35.61170959
226,"GREENVILLE NY",6,4,1,0,1,2,-73.92035675,41.70439148
226,"GREENVILLE OH",6,5,2,2,1,5,-84.63294983,40.10294342
226,"GREENVILLE PA",6,26,9,6,11,26,-80.39095306,41.40464401
226,"GREENVILLE SC",6,346,105,85,156,346,-82.39870453,34.84753418
226,"GREENVILLE TX",6,2,0,1,1,2,-96.11412811,33.13861084
226,"GREENWICH CT",6,35,3,9,23,35,-73.62783051,41.02645111
226,"GREENWOOD AR",6,2,1,0,1,2,-94.2559433,35.21604156
226,"GREENWOOD IN",6,24,6,8,10,24,-86.10647583,39.61371994
226,"GREENWOOD LAKE NY",6,2,0,1,1,2,-74.28708649,41.2256546
226,"GREENWOOD MS",6,1,1,0,0,1,-90.17974091,33.51645279
226,"GREENWOOD SC",6,4,1,1,2,4,-82.16146088,34.19546509
226,"GREENWOOD VILLAGE CO",6,4,0,4,0,4,-104.9518585,39.61724091
226,"GREER SC",6,2,1,0,1,2,-82.22647095,34.9389267
226,"GRESHAM OR",6,9,3,1,5,9,-122.4333954,45.4980278
226,"GRETNA LA",6,8,3,3,2,8,-90.05435181,29.91518021
226,"GRETNA NE",6,1,0,0,1,1,-96.24054718,41.14088058
226,"GRIDLEY CA",6,2,0,1,1,2,-121.6955032,39.36335373
226,"GRIFFIN GA",6,4,1,1,2,4,-84.26403046,33.24713135
226,"GRIFFITH IN",6,9,4,2,3,9,-87.42803955,41.52181625
226,"GRIMES IA",6,3,1,0,2,3,-93.79144287,41.68823624
226,"GRINNELL IA",6,28,9,5,14,28,-92.72964478,41.7466507
226,"GROSSE POINTE PARK MI",6,2,0,1,1,2,-82.93411255,42.37599182
226,"GROSSE POINTE WOODS MI",6,4,2,1,1,4,-82.90637207,42.4438858
226,"GROTON CT",6,7,0,3,4,7,-72.07763672,41.3502121
226,"GROTON MA",6,1,1,0,0,1,-71.55770874,42.60856247
226,"GROTON NY",6,9,0,3,6,9,-76.36643982,42.58802032
226,"GROVE CITY OH",6,2,1,1,0,2,-83.09304047,39.88161087
226,"GROVE OK",6,8,5,1,2,8,-94.76986694,36.59371567
226,"GROVELAND FL",6,1,0,0,1,1,-81.8509903,28.55855179
226,"GROVEPORT OH",6,4,0,2,2,4,-82.88549805,39.8524971
226,"GUADALUPE AZ",6,1,0,1,0,1,-111.9641876,33.37094498
226,"GULF BREEZE FL",6,5,1,3,1,5,-87.16386414,30.35763931
226,"GULF SHORES AL",6,1,0,0,1,1,-87.70103455,30.24625969
226,"GULFPORT FL",6,23,7,2,14,23,-82.70953369,27.74733734
226,"GULFPORT MS",6,54,10,13,31,54,-89.09369659,30.37276649
226,"GUNNISON CO",6,2,1,0,1,2,-106.9267273,38.54576874
226,"GURNEE IL",6,8,1,5,2,8,-87.90226746,42.37029648
226,"GUSTINE CA",6,3,1,2,0,3,-121.001297,37.25769043
226,"GUTHRIE OK",6,7,3,0,4,7,-97.42609406,35.87893677
226,"GUTTENBERG IA",6,1,1,0,0,1,-91.09951782,42.7858429
226,"GUYTON GA",6,2,1,0,1,2,-81.3910675,32.3367691
226,"GYPSUM CO",6,20,7,6,7,20,-106.9528198,39.64703369
226,"HACKENSACK NJ",6,10,2,2,6,10,-74.04291534,40.88635254
226,"HACKETTSTOWN NJ",6,1,0,0,1,1,-74.82810974,40.85408401
226,"HADDON HEIGHTS NJ",6,2,1,1,0,2,-75.06397247,39.87737656
226,"HADDONFIELD NJ",6,96,20,33,43,96,-75.03710937,39.89155197
226,"HAGERSTOWN MD",6,9,3,1,5,9,-77.71956635,39.641819
226,"HAINES CITY FL",6,1,1,0,0,1,-81.61740875,28.1145668
226,"HALE CENTER TX",6,1,0,0,1,1,-101.8444977,34.0643959
226,"HALF MOON BAY CA",6,33,8,4,21,33,-122.4299774,37.46336365
226,"HALLETTSVILLE TX",6,1,0,0,1,1,-96.94178772,29.44449997
226,"HALLSTEAD PA",6,18,6,8,4,18,-75.74239349,41.96153259
226,"HALLSVILLE TX",6,6,2,0,4,6,-94.57429504,32.50448608
226,"HALTOM CITY TX",6,2,0,0,2,2,-97.26971436,32.79956055
226,"HAMBURG NY",6,1,0,0,1,1,-78.82896423,42.71609879
226,"HAMDEN CT",6,23,9,8,6,23,-72.89596558,41.39611816
226,"HAMILTON MA",6,2,1,1,0,2,-70.85491943,42.61881638
226,"HAMILTON MT",6,2,0,2,0,2,-114.1562729,46.24755859
226,"HAMILTON NJ",6,14,3,5,6,14,-74.0803299,40.20712662
226,"HAMILTON OH",6,12,4,3,5,12,-84.56098175,39.39949799
226,"HAMLET NC",6,3,2,0,1,3,-79.69393921,34.8850708
226,"HAMMOND IN",6,19,3,6,10,19,-87.50006104,41.58346558
226,"HAMMOND LA",6,26,5,6,15,26,-90.46140289,30.50458908
226,"HAMMONTON NJ",6,1,0,0,1,1,-74.801651,39.63666153
226,"HAMPSTEAD MD",6,5,2,1,2,5,-76.84955597,39.60499191
226,"HAMPTON GA",6,9,0,5,4,9,-84.28277588,33.3870697
226,"HAMPTON NH",6,2,1,0,1,2,-70.83818054,42.93779373
226,"HAMPTON VA",6,124,40,28,56,124,-76.34473419,37.03002548
226,"HAMTRAMCK MI",6,9,2,2,5,9,-83.04947662,42.39274597
226,"HANCOCK MI",6,1,0,1,0,1,-88.58083344,47.12648773
226,"HANFORD CA",6,2,0,1,1,2,-119.647934,36.32738113
226,"HANNIBAL MO",6,3,2,1,0,3,-91.35847473,39.70859146
226,"HANOVER MA",6,1,0,1,0,1,-70.81069946,42.11336899
226,"HANOVER NH",6,4,0,3,1,4,-72.28845215,43.70233917
226,"HANOVER PA",6,8,3,1,4,8,-76.98248291,39.80073929
226,"HANOVER PARK IL",6,9,2,2,5,9,-88.14541626,41.99964905
226,"HAPEVILLE GA",6,1,0,1,0,1,-84.41027069,33.66032791
226,"HAPPY TX",6,3,2,0,1,3,-101.8551788,34.74401093
226,"HARBOR SPRINGS MI",6,1,0,0,1,1,-84.99181366,45.43172455
226,"HARKER HEIGHTS TX",6,61,17,21,23,61,-97.66394806,31.08788109
226,"HARLINGEN TX",6,56,22,18,16,56,-97.69669342,26.19152069
226,"HARPERS FERRY WV",6,1,0,0,1,1,-77.7372818,39.32528687
226,"HARRIMAN TN",6,1,0,1,0,1,-84.55221558,35.93426514
226,"HARRISBURG NC",6,5,1,2,2,5,-80.65539551,35.32398224
226,"HARRISBURG PA",6,162,44,46,72,162,-76.88382721,40.27407455
226,"HARRISON NJ",6,6,2,2,2,6,-74.15542603,40.7465477
226,"HARRISON OH",6,1,1,0,0,1,-84.81867981,39.26198959
226,"HARRISONBURG VA",6,122,29,27,66,122,-78.86815643,38.44975281
226,"HARRISONVILLE MO",6,2,0,1,1,2,-94.34924316,38.65325928
226,"HARRODSBURG KY",6,3,1,0,2,3,-84.84320068,37.76233673
226,"HARROGATE TN",6,1,0,0,1,1,-83.65833282,36.57839203
226,"HART MI",6,1,0,0,1,1,-86.36416626,43.69823837
226,"HARTFORD CT",6,243,75,61,107,243,-72.68445587,41.76383591
226,"HARTFORD MI",6,1,0,0,1,1,-86.16687012,42.20689392
226,"HARTFORD WI",6,1,0,0,1,1,-88.37940979,43.31758881
226,"HARTLAND WI",6,2,2,0,0,2,-88.34208679,43.1048317
226,"HARTLEY IA",6,1,0,0,1,1,-95.4770813,43.18453598
226,"HARTSELLE AL",6,1,0,1,0,1,-86.93518066,34.44379425
226,"HARTSVILLE SC",6,44,19,10,15,44,-80.07303619,34.37445068
226,"HARTVILLE OH",6,2,1,0,1,2,-81.33060455,40.96377563
226,"HARVARD MA",6,3,2,1,0,3,-71.58187103,42.5003891
226,"HARVEY IL",6,43,10,18,15,43,-87.64677429,41.61020279
226,"HASLET TX",6,1,0,0,1,1,-97.3484726,32.97494125
226,"HASTINGS-ON-HUDSON NY",6,2,1,0,1,2,-73.87804413,41.00286102
226,"HASTINGS MI",6,1,0,0,1,1,-85.29088593,42.64608765
226,"HASTINGS MN",6,14,3,5,6,14,-92.85280609,44.7434082
226,"HASTINGS NE",6,11,3,3,5,11,-98.38917542,40.58628845
226,"HATTIESBURG MS",6,139,41,36,62,139,-89.29040527,31.32738686
226,"HAVANA FL",6,7,1,3,3,7,-84.41448975,30.62413788
226,"HAVELOCK NC",6,1,0,0,1,1,-76.90039825,34.87951279
226,"HAVERFORD PA",6,9,1,4,4,9,-75.29338837,40.01327896
226,"HAVERHILL MA",6,12,2,5,5,12,-71.07640076,42.77653122
226,"HAVRE MT",6,1,0,1,0,1,-109.6722336,48.55265808
226,"HAWKINSVILLE GA",6,1,0,1,0,1,-83.4718399,32.28422546
226,"HAWLEY PA",6,1,0,1,0,1,-75.18128204,41.47588348
226,"HAWTHORNE CA",6,30,12,9,9,30,-118.3549194,33.91656113
226,"HAWTHORNE FL",6,1,0,1,0,1,-82.08397675,29.59261322
226,"HAYDEN ID",6,8,0,4,4,8,-116.7890625,47.76594925
226,"HAYMARKET VA",6,4,1,0,3,4,-77.63591766,38.81214142
226,"HAYS KS",6,12,5,3,4,12,-99.32746887,38.87940598
226,"HAYWARD CA",6,97,30,28,39,97,-122.0832672,37.66890335
226,"HAYWARD MN",6,1,0,0,1,1,-93.24449158,43.65049744
226,"HAZEL PARK MI",6,2,1,1,0,2,-83.10384369,42.46282196
226,"HAZLEHURST GA",6,1,0,0,1,1,-82.59401703,31.87015152
226,"HAZLET NJ",6,1,0,1,0,1,-74.19022369,40.41601563
226,"HAZLETON PA",6,12,4,4,4,12,-75.97418213,40.95857239
226,"HEALDSBURG CA",6,16,3,5,8,16,-122.8713226,38.6101799
226,"HEARNE TX",6,1,0,1,0,1,-96.59375763,30.87876701
226,"HEBRON IN",6,32,5,10,17,32,-87.20029449,41.31857681
226,"HELENA AL",6,1,1,0,0,1,-86.84368134,33.29661179
226,"HELENA MT",6,52,14,21,17,52,-112.0374527,46.59269333
226,"HELOTES TX",6,24,9,7,8,24,-98.69043732,29.57864761
226,"HEMET CA",6,1,0,1,0,1,-116.9736557,33.74770737
226,"HEMPSTEAD NY",6,6,3,1,2,6,-73.61798096,40.70619965
226,"HENDERSON KY",6,3,0,1,2,3,-87.58986664,37.8363266
226,"HENDERSON NC",6,12,3,2,7,12,-78.39831543,36.3300705
226,"HENDERSON NV",6,85,21,20,44,85,-114.9741058,36.03540421
226,"HENDERSON TX",6,3,0,0,3,3,-94.79977417,32.15364456
226,"HENDERSONVILLE NC",6,29,5,11,13,29,-82.46079254,35.31912994
226,"HENDERSONVILLE TN",6,25,9,4,12,25,-86.61997986,36.30472565
226,"HENRIETTA NY",6,2,1,0,1,2,-77.61167145,43.05939865
226,"HERCULANEUM MO",6,1,1,0,0,1,-90.38007355,38.26866531
226,"HERCULES CA",6,6,1,4,1,6,-122.2900772,38.01711655
226,"HEREFORD TX",6,2,0,0,2,2,-102.3984528,34.81501007
226,"HERKIMER NY",6,3,3,0,0,3,-74.98493195,43.02587128
226,"HERMANN MO",6,10,3,4,3,10,-91.43791199,38.70432281
226,"HERMISTON OR",6,5,2,1,2,5,-119.2915268,45.84025192
226,"HERMITAGE PA",6,8,4,2,2,8,-80.44813538,41.2335434
226,"HERMOSA BEACH CA",6,7,2,3,2,7,-118.401619,33.86245728
226,"HERNANDO MS",6,42,7,13,22,42,-89.99411774,34.82405853
226,"HERNDON VA",6,12,5,3,4,12,-77.38563538,38.96995544
226,"HERRIN IL",6,1,0,0,1,1,-89.02784729,37.80303574
226,"HESPERIA CA",6,4,1,0,3,4,-117.3026352,34.42634964
226,"HIALEAH FL",6,34,6,8,20,34,-80.27757263,25.85853386
226,"HIBBING MN",6,1,0,1,0,1,-92.93714142,47.42311478
226,"HICKORY NC",6,10,5,1,4,10,-81.34054565,35.72800827
226,"HIGH POINT NC",6,16,3,2,11,16,-80.00497437,35.95609665
226,"HIGHLAND CA",6,9,3,4,2,9,-117.2105789,34.12824631
226,"HIGHLAND IL",6,1,0,0,1,1,-89.6713562,38.73976135
226,"HIGHLAND IN",6,2,0,1,1,2,-87.45178223,41.55387115
226,"HIGHLAND PARK IL",6,23,5,3,15,23,-87.80068207,42.18181992
226,"HIGHLAND PARK MI",6,2,0,0,2,2,-83.09667969,42.40581131
226,"HIGHLAND PARK NJ",6,13,1,8,4,13,-74.4232254,40.49617386
226,"HIGHLAND PARK TX",6,1,0,0,1,1,-96.80493164,32.8320961
226,"HIGHWOOD IL",6,1,0,1,0,1,-87.80953979,42.19964218
226,"HILLIARD OH",6,34,12,7,15,34,-83.15856171,40.03361511
226,"HILLSBORO IL",6,5,3,1,1,5,-89.4937439,39.16139603
226,"HILLSBORO KS",6,1,0,0,1,1,-97.20517731,38.35185242
226,"HILLSBORO MO",6,2,1,0,1,2,-90.56336975,38.23225021
226,"HILLSBORO OH",6,22,4,6,12,22,-83.61119843,39.20261765
226,"HILLSBORO OR",6,128,29,30,69,128,-122.9927826,45.52270508
226,"HILLSBORO TX",6,3,1,0,2,3,-97.13063812,32.01124573
226,"HILLSBOROUGH NC",6,29,8,6,15,29,-79.09932709,36.07565308
226,"HILLSDALE MI",6,6,1,2,3,6,-84.63027191,41.91994095
226,"HILLSDALE NJ",6,1,0,0,1,1,-74.039711,41.00293732
226,"HILLSIDE IL",6,1,0,0,1,1,-87.90297699,41.87789917
226,"HILLSIDE NJ",6,3,2,1,0,3,-74.22960663,40.70137024
226,"HILLSVILLE VA",6,2,1,0,1,2,-80.73434448,36.7628479
226,"HILTON HEAD ISLAND SC",6,2,2,0,0,2,-80.75251007,32.21665573
226,"HILTON NY",6,1,0,1,0,1,-77.79302979,43.28840256
226,"HINDMAN KY",6,1,1,0,0,1,-82.98039246,37.33594894
226,"HINESVILLE GA",6,8,2,2,4,8,-81.59757996,31.85308266
226,"HIRAM OH",6,3,0,2,1,3,-81.14317322,41.31268311
226,"HITCHCOCK TX",6,2,0,0,2,2,-95.01639557,29.34873009
226,"HO-HO-KUS NJ",6,1,1,0,0,1,-74.10064697,40.99679184
226,"HOBART IN",6,11,4,4,3,11,-87.24478912,41.53391266
226,"HOBOKEN NJ",6,82,22,27,33,82,-74.0316925,40.7443428
226,"HOFFMAN ESTATES IL",6,1,1,0,0,1,-88.07968903,42.04299927
226,"HOLBROOK MA",6,3,1,1,1,3,-71.00770569,42.15513229
226,"HOLCOMB KS",6,2,0,1,1,2,-100.9902344,37.98623276
226,"HOLDEN MA",6,2,0,0,2,2,-71.86223602,42.35177994
226,"HOLDREGE NE",6,2,0,0,2,2,-99.3705368,40.44029999
226,"HOLLAND MI",6,32,12,6,14,32,-86.10916138,42.78744507
226,"HOLLIDAY TX",6,4,0,3,1,4,-98.69548798,33.81625748
226,"HOLLIDAYSBURG PA",6,1,0,0,1,1,-78.38813782,40.42749405
226,"HOLLISTER CA",6,9,4,2,3,9,-121.4038849,36.85258865
226,"HOLLISTON MA",6,6,1,2,3,6,-71.42358398,42.2000885
226,"HOLLY MI",6,1,0,1,0,1,-83.62766266,42.79191208
226,"HOLLY SPRINGS MS",6,2,0,1,1,2,-89.44177246,34.77593994
226,"HOLLY SPRINGS NC",6,13,6,4,3,13,-78.83320618,35.65140915
226,"HOLLYWOOD FL",6,168,53,41,74,168,-80.14926147,26.01175499
226,"HOLYOKE MA",6,26,10,5,11,26,-72.61522675,42.20437241
226,"HOMER AK",6,1,0,0,1,1,-151.544632,59.64481735
226,"HOMER MI",6,5,1,2,2,5,-84.80869293,42.14587021
226,"HOMESTEAD FL",6,38,11,11,16,38,-80.47710419,25.46927071
226,"HOMEWOOD AL",6,11,1,3,7,11,-86.80097961,33.47186661
226,"HOMEWOOD IL",6,5,1,1,3,5,-87.66596222,41.55735779
226,"HONESDALE PA",6,1,0,0,1,1,-75.25775909,41.57712555
226,"HONEY GROVE TX",6,2,1,0,1,2,-95.9105835,33.58367538
226,"HOOD RIVER OR",6,4,2,0,2,4,-121.5108719,45.70785141
226,"HOPE MILLS NC",6,4,0,2,2,4,-78.94456482,34.97066498
226,"HOPEWELL VA",6,3,0,1,2,3,-77.28649139,37.30444336
226,"HOPKINS MN",6,39,10,16,13,39,-93.39242554,44.92610168
226,"HOPKINSVILLE KY",6,4,2,1,1,4,-87.48854828,36.86588287
226,"HOQUIAM WA",6,8,3,3,2,8,-123.8915939,46.98048782
226,"HORNELL NY",6,1,0,0,1,1,-77.66078949,42.3279686
226,"HORSEHEADS NY",6,2,0,1,1,2,-76.81996155,42.16708755
226,"HORSHAM PA",6,4,0,2,2,4,-75.12754822,40.17853165
226,"HOT SPRINGS AR",6,16,5,6,5,16,-93.05556488,34.5039978
226,"HOUGHTON MI",6,4,3,1,0,4,-88.56951141,47.12665558
226,"HOULTON ME",6,1,0,0,1,1,-67.83905792,46.12631607
226,"HOUMA LA",6,3,0,0,3,3,-90.71982574,29.59630585
226,"HOUSTON MO",6,1,0,0,1,1,-91.95644379,37.3261528
226,"HOUSTON TX",6,6455,1838,1657,2960,6455,-95.36399841,29.76376343
226,"HOWELL MI",6,3,0,1,2,3,-83.92946625,42.6072464
226,"HUDSON MA",6,1,0,1,0,1,-71.57429504,42.39633942
226,"HUDSON NC",6,1,1,0,0,1,-81.49536133,35.84866714
226,"HUDSON NH",6,4,3,0,1,4,-71.43859863,42.76485062
226,"HUDSON NY",6,3,1,1,1,3,-73.7900238,42.25299454
226,"HUDSON OH",6,9,3,3,3,9,-81.44026947,41.2401619
226,"HUDSON WI",6,6,2,0,4,6,-92.75721741,44.97438431
226,"HUDSONVILLE MI",6,6,2,2,2,6,-85.86483002,42.87105942
226,"HUGHSON CA",6,1,0,0,1,1,-120.8681412,37.59653854
226,"HULL MA",6,1,0,1,0,1,-70.90122223,42.304142
226,"HUMBLE TX",6,44,12,16,16,44,-95.26166534,29.99774551
226,"HUNTERSVILLE NC",6,19,6,7,6,19,-80.83785248,35.41359711
226,"HUNTINGTON BEACH CA",6,78,25,20,33,78,-118.0006027,33.66012955
226,"HUNTINGTON IN",6,1,0,1,0,1,-85.49169159,40.87822342
226,"HUNTINGTON NY",6,7,3,2,2,7,-73.42463684,40.86833191
226,"HUNTINGTON PARK CA",6,1,0,0,1,1,-118.2265549,33.98159409
226,"HUNTINGTON UT",6,2,0,0,2,2,-110.966156,39.32650757
226,"HUNTINGTON WV",6,90,31,20,39,90,-82.44620514,38.4181366
226,"HUNTLEY IL",6,2,0,2,0,2,-88.42815399,42.16807938
226,"HUNTSVILLE AL",6,434,134,110,190,434,-86.58609772,34.73073959
226,"HUNTSVILLE TX",6,30,7,6,17,30,-95.55122375,30.72374153
226,"HUNTSVILLE UT",6,4,3,0,1,4,-111.7737732,41.26464844
226,"HURLEY NY",6,1,1,0,0,1,-74.06271362,41.92608261
226,"HURON OH",6,2,1,0,1,2,-82.55414581,41.37385178
226,"HURST TX",6,7,2,1,4,7,-97.17115021,32.82357407
226,"HUTCHINSON KS",6,16,8,4,4,16,-97.93050385,38.06093216
226,"HUTCHINSON MN",6,1,1,0,0,1,-94.37024689,44.88771439
226,"HUTTO TX",6,4,0,1,3,4,-97.54733276,30.54326057
226,"HYATTSVILLE MD",6,30,7,10,13,30,-76.94467163,38.95636749
226,"HYDE PARK NY",6,3,0,2,1,3,-73.93060303,41.79148865
226,"HYDEN KY",6,1,1,0,0,1,-83.37277222,37.16115189
226,"IDA MI",6,1,0,0,1,1,-83.57371521,41.91075516
226,"IDAHO FALLS ID",6,43,13,10,20,43,-112.035408,43.46630478
226,"IMPERIAL CA",6,14,2,8,4,14,-115.5716705,32.84782791
226,"INDEPENDENCE KY",6,10,3,3,4,10,-84.54380035,38.94332886
226,"INDEPENDENCE MO",6,74,27,22,25,74,-94.41611481,39.09104538
226,"INDEPENDENCE OH",6,1,0,1,0,1,-81.64063263,41.3945961
226,"INDEPENDENCE OR",6,4,0,0,4,4,-123.1894913,44.8509407
226,"INDIALANTIC FL",6,1,0,0,1,1,-80.56504822,28.08994865
226,"INDIAN ROCKS BEACH FL",6,6,0,3,3,6,-82.85096741,27.87600517
226,"INDIAN TRAIL NC",6,14,2,6,6,14,-80.66901398,35.07696915
226,"INDIANA PA",6,25,8,4,13,25,-79.15187073,40.6216507
226,"INDIANAPOLIS IN",6,1412,392,380,640,1412,-86.15828705,39.76844788
226,"INDIANOLA IA",6,2,2,0,0,2,-93.55815887,41.35812378
226,"INDIANOLA MS",6,2,2,0,0,2,-90.65548706,33.45103073
226,"INDIO CA",6,65,19,8,38,65,-116.2173004,33.72047043
226,"INGLEWOOD CA",6,156,59,27,70,156,-118.354805,33.96157074
226,"INKSTER MI",6,6,2,0,4,6,-83.31001282,42.29439926
226,"INMAN SC",6,7,4,0,3,7,-82.09005737,35.04743958
226,"INTERNATIONAL FALLS MN",6,1,0,1,0,1,-93.41119385,48.60089493
226,"INVER GROVE HEIGHTS MN",6,2,1,0,1,2,-93.02364349,44.85364151
226,"INVERNESS MS",6,1,0,0,1,1,-90.59259033,33.35402679
226,"IOLA KS",6,2,0,1,1,2,-95.40049744,37.92469025
226,"IOWA CITY IA",6,382,92,96,194,382,-91.53023529,41.66130066
226,"IPSWICH MA",6,4,2,1,1,4,-70.84001923,42.67964554
226,"IRMO SC",6,16,7,6,3,16,-81.18247223,34.08623123
226,"IRONDEQUOIT NY",6,1,0,0,1,1,-77.57932281,43.21369171
226,"IRONTON OH",6,5,1,4,0,5,-82.68261719,38.53668976
226,"IRVINE CA",6,130,43,28,59,130,-117.8243942,33.66952515
226,"IRVING TX",6,72,19,12,41,72,-96.94924927,32.81419754
226,"IRVINGTON NY",6,5,2,1,2,5,-73.86441803,41.03897858
226,"ISLAND LAKE IL",6,3,2,0,1,3,-88.19213104,42.27630615
226,"ISLAND PARK NY",6,1,0,0,1,1,-73.64651489,40.61180496
226,"ISLE OF PALMS SC",6,1,0,0,1,1,-79.79431152,32.78720093
226,"ISLIP NY",6,1,0,0,1,1,-73.20967102,40.7298851
226,"ISSAQUAH WA",6,21,4,8,9,21,-122.0345993,47.52977753
226,"ITASCA IL",6,1,0,0,1,1,-88.00758362,41.97497559
226,"ITHACA NY",6,146,52,35,59,146,-76.49575043,42.44075775
226,"IVINS UT",6,1,0,0,1,1,-113.6812897,37.16847992
226,"JACINTO CITY TX",6,5,0,2,3,5,-95.23432159,29.76779175
226,"JACKSON AL",6,1,0,1,0,1,-87.89234924,31.51841354
226,"JACKSON GA",6,1,1,0,0,1,-83.96604919,33.29464722
226,"JACKSON LA",6,1,0,1,0,1,-91.2175827,30.83776855
226,"JACKSON MI",6,20,8,3,9,20,-84.40149689,42.24575043
226,"JACKSON MN",6,1,0,0,1,1,-94.98889923,43.62050247
226,"JACKSON MO",6,9,2,2,5,9,-89.66656494,37.38225174
226,"JACKSON MS",6,303,79,84,140,303,-90.19654846,32.298172
226,"JACKSON TN",6,87,23,17,47,87,-88.81397247,35.61472321
226,"JACKSON WI",6,2,0,0,2,2,-88.16716003,43.32381058
226,"JACKSON WY",6,6,0,0,6,6,-110.7644806,43.4798851
226,"JACKSONPORT WI",6,4,1,1,2,4,-87.1861496,44.978508
226,"JACKSONVILLE AL",6,8,1,3,4,8,-85.76148987,33.81370163
226,"JACKSONVILLE AR",6,6,1,1,4,6,-92.11023712,34.86617279
226,"JACKSONVILLE BEACH FL",6,106,44,32,30,106,-81.39300537,30.29505539
226,"JACKSONVILLE FL",6,699,222,168,309,699,-81.65545654,30.33253288
226,"JACKSONVILLE IL",6,4,1,2,1,4,-90.22943115,39.73405838
226,"JACKSONVILLE NC",6,20,8,6,6,20,-77.42939758,34.75283813
226,"JAMESTOWN ND",6,1,1,0,0,1,-98.70591736,46.90496063
226,"JAMESTOWN NY",6,5,1,3,1,5,-79.23510742,42.09712601
226,"JAMESTOWN PA",6,1,1,0,0,1,-80.43720245,41.48487091
226,"JANESVILLE WI",6,39,8,8,23,39,-89.01893616,42.68303299
226,"JASPER AL",6,2,0,2,0,2,-87.27728271,33.83164597
226,"JASPER GA",6,2,1,0,1,2,-84.42887115,34.46783829
226,"JASPER IN",6,4,2,0,2,4,-86.93096161,38.39162445
226,"JASPER TX",6,1,1,0,0,1,-93.9970932,30.92081833
226,"JEANNETTE PA",6,2,1,0,1,2,-79.61497498,40.32809448
226,"JEFFERSON CITY MO",6,132,51,28,53,132,-92.17385864,38.57698441
226,"JEFFERSON CITY TN",6,60,17,13,30,60,-83.48968506,36.11675644
226,"JEFFERSONTOWN KY",6,2,1,0,1,2,-85.56430054,38.19419861
226,"JEFFERSONVILLE IN",6,6,0,2,4,6,-85.73719788,38.27765656
226,"JENKINTOWN PA",6,2,1,0,1,2,-75.12425995,40.09637451
226,"JENNINGS MO",6,3,2,1,0,3,-90.26077271,38.71944046
226,"JEROME AZ",6,21,7,7,7,21,-112.1151428,34.74900055
226,"JERSEY CITY NJ",6,330,96,78,156,330,-74.07667542,40.72816849
226,"JERSEY VILLAGE TX",6,1,0,0,1,1,-95.56360626,29.88805389
226,"JERSEYVILLE IL",6,13,8,4,1,13,-90.32881165,39.12010956
226,"JESUP GA",6,1,1,0,0,1,-81.88517761,31.60768127
226,"JESUP IA",6,5,1,3,1,5,-92.06430054,42.47546387
226,"JIM THORPE PA",6,2,0,0,2,2,-75.73157501,40.87605667
226,"JOHNSON CITY TN",6,95,37,22,36,95,-82.35308075,36.31352615
226,"JOHNSON VT",6,1,0,1,0,1,-72.67963409,44.63550949
226,"JOHNSTON CITY IL",6,5,0,4,1,5,-88.92750549,37.82073975
226,"JOHNSTON SC",6,1,0,0,1,1,-81.80052948,33.83217621
226,"JOHNSTOWN PA",6,10,6,1,3,10,-78.92127228,40.326931
226,"JOLIET IL",6,140,30,44,66,140,-88.08213043,41.52493668
226,"JONES OK",6,6,1,2,3,6,-97.28777313,35.56618881
226,"JONESBORO AR",6,49,8,12,29,49,-90.70430756,35.84226608
226,"JONESBORO GA",6,39,8,11,20,39,-84.35381317,33.52181625
226,"JONESBORO IL",6,11,3,1,7,11,-89.26836395,37.45198059
226,"JONESBORO LA",6,6,4,0,2,6,-92.71629333,32.24162292
226,"JONESTOWN MS",6,5,2,0,3,5,-90.45589447,34.31987381
226,"JOPLIN MO",6,79,26,18,35,79,-94.5140686,37.08442688
226,"JOSEPH OR",6,1,1,0,0,1,-117.2318039,45.35386658
226,"JUNCTION CITY KS",6,1,1,0,0,1,-96.8317337,39.02863693
226,"JUNCTION CITY OR",6,1,0,0,1,1,-123.2078552,44.21871567
226,"JUPITER FL",6,37,11,10,16,37,-80.09382629,26.9349556
226,"JUSTIN TX",6,6,0,0,6,6,-97.29656219,33.08527374
226,"KAHOKA MO",6,1,1,0,0,1,-91.71973419,40.42050934
226,"KALAMAZOO MI",6,295,81,88,126,295,-85.58725739,42.29179764
226,"KALISPELL MT",6,7,2,3,2,7,-114.3166199,48.20161438
226,"KANE PA",6,1,0,0,1,1,-78.81070709,41.66299057
226,"KANKAKEE IL",6,10,2,1,7,10,-87.86149597,41.12018204
226,"KANNAPOLIS NC",6,8,2,2,4,8,-80.62119293,35.48755264
226,"KANSAS CITY KS",6,35,7,7,21,35,-94.62808228,39.1141777
226,"KANSAS CITY MO",6,2657,789,641,1227,2657,-94.57884979,39.09976578
226,"KASSON MN",6,2,0,1,1,2,-92.75143433,44.02982712
226,"KATY TX",6,61,15,19,27,61,-95.82484436,29.78606224
226,"KAUFMAN TX",6,1,0,1,0,1,-96.30930328,32.58925247
226,"KAYSVILLE UT",6,1,0,0,1,1,-111.9401856,41.03524399
226,"KEARNEY NE",6,8,1,4,3,8,-99.08208466,40.69932938
226,"KEARNY NJ",6,14,5,3,6,14,-74.14439392,40.76873398
226,"KEENE NH",6,7,3,2,2,7,-72.27714539,42.93392563
226,"KEENESBURG CO",6,1,1,0,0,1,-104.5207062,40.10844803
226,"KEIZER OR",6,8,2,3,3,8,-123.0285339,44.98967743
226,"KELLER TX",6,9,2,3,4,9,-97.25247192,32.93486786
226,"KELSO WA",6,2,1,1,0,2,-122.9105454,46.14636612
226,"KENAI AK",6,3,0,2,1,3,-151.2597809,60.55926895
226,"KENDALL NY",6,2,0,1,1,2,-78.03549957,43.32717514
226,"KENDALLVILLE IN",6,12,3,1,8,12,-85.27036285,41.44488525
226,"KENMORE WA",6,12,5,2,5,12,-122.2464905,47.7568779
226,"KENNEBUNKPORT ME",6,1,1,0,0,1,-70.47593689,43.36188126
226,"KENNEDALE TX",6,1,0,1,0,1,-97.22646332,32.64726639
226,"KENNER LA",6,28,15,7,6,28,-90.24167633,29.99442101
226,"KENNESAW GA",6,22,6,7,9,22,-84.61528015,34.02365875
226,"KENNEWICK WA",6,28,5,10,13,28,-119.1395264,46.2107811
226,"KENOSHA WI",6,16,4,3,9,16,-87.82134247,42.58494949
226,"KENSINGTON MD",6,19,4,6,9,19,-77.07564545,39.02577972
226,"KENT OH",6,42,18,9,15,42,-81.35736084,41.15368271
226,"KENT WA",6,136,41,27,68,136,-122.2377701,47.38068008
226,"KENTWOOD MI",6,3,1,1,1,3,-85.64472198,42.86936569
226,"KERMAN CA",6,2,0,0,2,2,-120.0621414,36.723423
226,"KERNERSVILLE NC",6,2,0,0,2,2,-80.07332611,36.12029266
226,"KERRVILLE TX",6,2,0,0,2,2,-99.14083099,30.04796982
226,"KETCHIKAN AK",6,1,0,0,1,1,-131.6417084,55.34326935
226,"KETTERING OH",6,10,5,2,3,10,-84.1687088,39.68964005
226,"KEWANEE IL",6,2,1,0,1,2,-89.92489624,41.24570847
226,"KEY WEST FL",6,61,23,15,23,61,-81.78218079,24.556427
226,"KEYSER WV",6,1,0,1,0,1,-78.97768402,39.44042969
226,"KEYSTONE HEIGHTS FL",6,1,0,0,1,1,-82.03114319,29.78640366
226,"KIEFER OK",6,1,0,0,1,1,-96.06565094,35.94494247
226,"KILGORE TX",6,6,1,2,3,6,-94.87643433,32.38670349
226,"KILLEEN TX",6,57,19,16,22,57,-97.72832489,31.11753464
226,"KILLEN AL",6,1,0,0,1,1,-87.53759003,34.86286545
226,"KING CITY CA",6,3,0,2,1,3,-121.1282578,36.21259689
226,"KING NC",6,4,1,1,2,4,-80.35888672,36.28079987
226,"KINGFIELD ME",6,1,1,0,0,1,-70.15326691,44.95920181
226,"KINGFISHER OK",6,4,0,0,4,4,-97.93222809,35.8614006
226,"KINGMAN AZ",6,8,2,2,4,8,-114.0542908,35.18925858
226,"KINGS MOUNTAIN NC",6,1,0,0,1,1,-81.34108734,35.24551773
226,"KINGSLAND GA",6,16,0,8,8,16,-81.68964386,30.80049896
226,"KINGSPORT TN",6,40,15,6,19,40,-82.56182861,36.54841232
226,"KINGSTON MA",6,1,0,0,1,1,-70.72354889,41.99478531
226,"KINGSTON NY",6,15,4,2,9,15,-73.99665833,41.92714691
226,"KINGSTON TN",6,1,1,0,0,1,-84.51077271,35.87340546
226,"KINGSVILLE TX",6,8,3,2,3,8,-97.86582184,27.51676559
226,"KINLOCH MO",6,1,0,1,0,1,-90.32682037,38.74011612
226,"KINSTON NC",6,3,1,0,2,3,-77.58128357,35.26295471
226,"KIRKLAND WA",6,105,41,28,36,105,-122.2108688,47.6813736
226,"KIRKSVILLE MO",6,11,6,1,4,11,-92.58364105,40.19476318
226,"KIRKWOOD MO",6,76,30,18,28,76,-90.40686798,38.5832901
226,"KISSIMMEE FL",6,63,16,16,31,63,-81.40729523,28.29271317
226,"KITTANNING PA",6,1,0,0,1,1,-79.52142334,40.81637573
226,"KITTERY ME",6,2,1,1,0,2,-70.73544312,43.08844376
226,"KITTY HAWK NC",6,2,1,1,0,2,-75.70478058,36.06485367
226,"KLAMATH FALLS OR",6,8,4,1,3,8,-121.7844772,42.2244873
226,"KNIGHTDALE NC",6,7,0,3,4,7,-78.48007202,35.78808975
226,"KNOX PA",6,1,0,0,1,1,-79.53708649,41.23451996
226,"KNOXVILLE TN",6,469,134,131,204,469,-83.92067719,35.96077728
226,"KODIAK AK",6,4,0,1,3,4,-152.3966675,57.7966423
226,"KOKOMO IN",6,19,4,7,8,19,-86.12706757,40.48566818
226,"KRUM TX",6,1,0,0,1,1,-97.23888397,33.26189804
226,"KUTTAWA KY",6,1,1,0,0,1,-88.1322937,37.05903625
226,"KUTZTOWN PA",6,3,0,0,3,3,-75.77677917,40.51739502
226,"KYLE TX",6,8,2,4,2,8,-97.87797546,29.9895649
226,"LA CROSSE WI",6,40,15,5,20,40,-91.23967743,43.80151367
226,"LA GRANDE OR",6,1,0,0,1,1,-118.090126,45.32435989
226,"LA GRANGE IL",6,4,0,0,2,2,-87.8698616,41.80437088
226,"LA GRANGE TX",6,1,0,1,0,1,-96.87730408,29.90603638
226,"LA HABRA CA",6,3,0,1,2,3,-117.9494629,33.93001556
226,"LA JUNTA CO",6,1,0,0,1,1,-103.544075,37.98753738
226,"LA MESA CA",6,15,4,7,4,15,-117.0447464,32.76841354
226,"LA MIRADA CA",6,3,2,0,1,3,-118.0295639,33.85194778
226,"LA PINE OR",6,1,1,0,0,1,-121.5054627,43.67027664
226,"LA PORTE IN",6,1,0,1,0,1,-86.7223587,41.61079025
226,"LA PORTE TX",6,2,0,0,2,2,-95.01729584,29.66588402
226,"LA VERGNE TN",6,3,1,1,1,3,-86.58178711,36.01600266
226,"LA VERNE CA",6,44,13,11,20,44,-117.7696304,34.1006546
226,"LACEY WA",6,21,4,9,8,21,-122.8096161,47.03732681
226,"LACONIA NH",6,20,1,4,5,10,-71.46888733,43.52740097
226,"LADY LAKE FL",6,1,0,0,1,1,-81.92842865,28.92837715
226,"LAFAYETTE CA",6,15,6,4,5,15,-122.1200104,37.88574982
226,"LAFAYETTE CO",6,45,8,14,23,45,-105.0904388,39.99370956
226,"LAFAYETTE IN",6,49,11,8,30,49,-86.88406372,40.42077255
226,"LAFAYETTE LA",6,160,40,44,76,160,-92.01987457,30.22468185
226,"LAFAYETTE OR",6,27,2,5,20,27,-123.1177979,45.24378967
226,"LAFAYETTE TN",6,3,0,3,0,3,-86.02629089,36.52130127
226,"LAGRANGE OH",6,2,1,1,0,2,-82.11968231,41.23716736
226,"LAGUNA BEACH CA",6,44,12,14,18,44,-117.7847061,33.54205322
226,"LAKE BLUFF IL",6,3,0,1,2,3,-87.83427429,42.2790184
226,"LAKE CHARLES LA",6,21,5,5,11,21,-93.21766663,30.22713852
226,"LAKE CITY FL",6,2,1,1,0,2,-82.6391983,30.19030762
226,"LAKE CITY MN",6,1,0,0,1,1,-92.26745605,44.44919205
226,"LAKE CITY SC",6,2,1,0,1,2,-79.75487518,33.87107086
226,"LAKE FOREST IL",6,2,1,0,1,2,-87.84095764,42.25865555
226,"LAKE GENEVA WI",6,3,1,1,1,3,-88.43348694,42.59184265
226,"LAKE GEORGE NY",6,3,0,2,1,3,-73.71913147,43.42655563
226,"LAKE HAVASU CITY AZ",6,9,4,3,2,9,-114.3244324,34.48379517
226,"LAKE JACKSON TX",6,11,0,4,7,11,-95.43475342,29.03430176
226,"LAKE MARY FL",6,8,2,5,1,8,-81.31755829,28.75924492
226,"LAKE OSWEGO OR",6,8,3,2,3,8,-122.6727066,45.42033005
226,"LAKE PLACID NY",6,1,0,0,1,1,-73.97898865,44.27967072
226,"LAKE STATION IN",6,1,0,0,1,1,-87.23908997,41.57525253
226,"LAKE STEVENS WA",6,32,8,7,17,32,-122.0684662,48.01782227
226,"LAKE TOMAHAWK WI",6,1,1,0,0,1,-89.59381866,45.81399536
226,"LAKE VILLA IL",6,1,0,0,1,1,-88.07393646,42.4168129
226,"LAKE WORTH FL",6,10,1,4,5,10,-80.05649567,26.61662102
226,"LAKE ZURICH IL",6,1,0,0,1,1,-88.09326935,42.1971283
226,"LAKELAND FL",6,106,36,27,43,106,-81.95620728,28.04432487
226,"LAKEVILLE MN",6,9,3,1,5,9,-93.24331665,44.64937973
226,"LAKEWOOD CA",6,10,3,3,4,10,-118.1357193,33.85370636
226,"LAKEWOOD CO",6,16,5,5,6,16,-105.0827332,39.70486069
226,"LAKEWOOD IL",6,2,0,1,0,1,-88.548576355,40.620773315
226,"LAKEWOOD NJ",6,7,2,2,3,7,-74.21684265,40.09822845
226,"LAKEWOOD NY",6,3,1,0,2,3,-79.33265686,42.10427094
226,"LAKEWOOD OH",6,110,32,31,47,110,-81.79773712,41.48223114
226,"LAKEWOOD WA",6,12,2,1,3,6,-122.3653679,47.661533355
226,"LAMAR CO",6,4,1,1,2,4,-102.6111527,38.08679581
226,"LAMBERTVILLE NJ",6,6,3,0,3,6,-74.94231415,40.36618423
226,"LANCASTER CA",6,41,15,12,14,41,-118.1386871,34.69804001
226,"LANCASTER KY",6,3,0,1,2,3,-84.57772064,37.61965561
226,"LANCASTER MN",6,1,1,0,0,1,-96.80472565,48.85840988
226,"LANCASTER NY",6,9,3,2,4,9,-78.67009735,42.90063477
226,"LANCASTER OH",6,2,0,1,1,2,-82.59890747,39.71387482
226,"LANCASTER PA",6,167,54,50,63,167,-76.30498505,40.03824234
226,"LANCASTER SC",6,6,1,0,5,6,-80.76622772,34.71495819
226,"LANCASTER TX",6,3,0,1,2,3,-96.75682831,32.59244156
226,"LANCASTER WI",6,1,0,0,1,1,-90.71117401,42.84736252
226,"LANDER WY",6,2,0,1,1,2,-108.7319489,42.83276749
226,"LANDOVER HILLS MD",6,19,3,2,14,19,-76.89152527,38.94342804
226,"LANGHORNE PA",6,84,20,19,45,84,-74.92177582,40.17494965
226,"LANGLEY WA",6,15,4,2,9,15,-122.4162674,48.03789139
226,"LANSDALE PA",6,7,2,3,2,7,-75.28330994,40.24167633
226,"LANSDOWNE PA",6,44,7,7,30,44,-75.27108765,39.93852234
226,"LANSING IL",6,10,2,4,4,10,-87.5393219,41.56502151
226,"LANSING MI",6,261,70,88,103,261,-84.55532074,42.73265839
226,"LAPEER MI",6,11,3,4,4,11,-83.31890869,43.05135345
226,"LARAMIE WY",6,26,7,6,13,26,-105.592804,41.3115387
226,"LARCHMONT NY",6,2,1,0,1,2,-73.7507782,40.92812729
226,"LAREDO TX",6,61,13,15,33,61,-99.50824738,27.50720978
226,"LARGO FL",6,67,15,23,29,67,-82.78675079,27.91026115
226,"LARKSPUR CA",6,5,2,0,3,5,-122.5373993,37.93414688
226,"LAS CRUCES NM",6,40,12,7,21,40,-106.7798538,32.31209564
226,"LAS VEGAS NM",6,3,0,2,1,3,-105.2182999,35.6000061
226,"LAS VEGAS NV",6,1844,499,526,819,1844,-115.1382141,36.17488098
226,"LATHROP CA",6,6,0,4,2,6,-121.2790833,37.82243729
226,"LATHRUP VILLAGE MI",6,1,1,0,0,1,-83.22232819,42.49633026
226,"LATROBE PA",6,5,1,3,1,5,-79.37892914,40.32139206
226,"LAUDERDALE LAKES FL",6,1,0,0,1,1,-80.20793915,26.1671524
226,"LAUDERDALE MN",6,2,1,0,1,2,-93.20005798,44.99473572
226,"LAUDERHILL FL",6,1,0,1,0,1,-80.21311188,26.14096451
226,"LAUREL MS",6,4,0,1,3,4,-89.13054657,31.69452286
226,"LAUREL MT",6,1,0,0,1,1,-108.7678986,45.67721939
226,"LAURINBURG NC",6,1,0,1,0,1,-79.46212769,34.77434921
226,"LAVONIA GA",6,1,0,0,1,1,-83.10657501,34.4361496
226,"LAWNDALE CA",6,14,2,3,9,14,-118.3547897,33.88746262
226,"LAWRENCE IN",6,2,0,1,1,2,-86.02498627,39.83873749
226,"LAWRENCE KS",6,477,141,123,213,477,-95.23565674,38.97153091
226,"LAWRENCE MA",6,12,2,4,6,12,-71.15792084,42.70630646
226,"LAWRENCEBURG IN",6,2,1,1,0,2,-84.85410309,39.09534454
226,"LAWRENCEBURG KY",6,6,3,0,3,6,-84.89624023,38.03728867
226,"LAWRENCEBURG TN",6,10,1,2,7,10,-87.33492279,35.24256897
226,"LAWRENCEVILLE GA",6,50,18,13,19,50,-83.98753357,33.95662308
226,"LAWRENCEVILLE VA",6,10,3,2,5,10,-77.84610748,36.75788879
226,"LAWSON MO",6,1,0,0,1,1,-94.20426941,39.43822098
226,"LAWTON OK",6,25,6,6,13,25,-98.39124298,34.60861969
226,"LAYTON UT",6,13,5,2,6,13,-111.9724808,41.06021118
226,"LE MARS IA",6,1,1,0,0,1,-96.16635132,42.79434967
226,"LE ROY IL",6,2,1,0,1,2,-88.76422882,40.35198975
226,"LEAGUE CITY TX",6,26,7,7,12,26,-95.09550476,29.50793457
226,"LEANDER TX",6,14,2,2,10,14,-97.85368347,30.57936287
226,"LEAVENWORTH KS",6,46,12,12,22,46,-94.92282867,39.31124115
226,"LEAWOOD KS",6,7,3,2,2,7,-94.61756897,38.96688461
226,"LEBANON MO",6,1,0,1,0,1,-92.66392517,37.68081284
226,"LEBANON OH",6,9,2,3,4,9,-84.20275879,39.43528748
226,"LEBANON OR",6,1,0,0,1,1,-122.9096909,44.53636551
226,"LEBANON PA",6,15,6,3,6,15,-76.41091156,40.34118652
226,"LEBANON TN",6,4,3,1,0,4,-86.29133606,36.20846939
226,"LEBANON VA",6,5,2,1,2,5,-82.07959747,36.90112305
226,"LECOMPTE LA",6,3,0,0,3,3,-92.40045929,31.09491348
226,"LEEDS AL",6,2,1,1,0,2,-86.54457092,33.54820251
226,"LEESBURG FL",6,7,4,2,1,7,-81.87727356,28.81123161
226,"LEESBURG VA",6,16,1,7,8,16,-77.56890869,39.11256027
226,"LEHI UT",6,5,0,2,3,5,-111.8519974,40.39155197
226,"LEIPSIC OH",6,1,1,0,0,1,-83.98432922,41.09840775
226,"LEITCHFIELD KY",6,1,0,0,1,1,-86.29386139,37.47995377
226,"LELAND NC",6,14,7,1,6,14,-78.04415131,34.25672913
226,"LEMON GROVE CA",6,5,2,1,2,5,-117.0335465,32.74267197
226,"LEMOORE CA",6,3,0,1,2,3,-119.7849197,36.30083084
226,"LENEXA KS",6,20,3,6,11,20,-94.73374176,38.95368576
226,"LENOIR CITY TN",6,7,0,1,6,7,-84.25585175,35.79733276
226,"LENOIR NC",6,7,3,2,2,7,-81.53869629,35.91436386
226,"LESLIE MO",6,7,0,4,3,7,-91.23233795,38.41774368
226,"LEWES DE",6,19,6,5,8,19,-75.1359024,38.77365494
226,"LEWISBURG WV",6,1,1,0,0,1,-80.44319916,37.79904556
226,"LEWISTON ID",6,14,4,2,8,14,-117.0198975,46.41637421
226,"LEWISTON ME",6,2,0,0,2,2,-70.21377563,44.10037231
226,"LEWISVILLE TX",6,33,12,8,13,33,-96.99449921,33.04630661
226,"LEXINGTON MA",6,10,6,1,3,10,-71.22381592,42.44742584
226,"LEXINGTON NC",6,2,0,1,1,2,-80.25289154,35.8242569
226,"LEXINGTON SC",6,47,11,7,29,47,-81.23597717,33.98204041
226,"LEXINGTON TN",6,3,2,1,0,3,-88.39100647,35.64579391
226,"LEXINGTON VA",6,24,5,6,13,24,-79.4422226,37.78420639
226,"LIBBY MT",6,1,0,0,1,1,-115.5511856,48.38265991
226,"LIBERAL KS",6,2,0,0,2,2,-100.9224777,37.04306412
226,"LIBERAL MO",6,3,2,1,0,3,-94.52056122,37.55810547
226,"LIBERTY HILL TX",6,4,1,2,1,4,-97.92319489,30.66527367
226,"LIBERTY ME",6,3,1,2,0,3,-69.30149841,44.389534
226,"LIBERTY MO",6,39,9,11,19,39,-94.4196167,39.24604034
226,"LIBERTY TX",6,3,2,0,1,3,-94.79598999,30.05861664
226,"LIGONIER PA",6,21,7,7,7,21,-79.23710632,40.24316025
226,"LILBURN GA",6,1,0,0,1,1,-84.14273834,33.89017868
226,"LIMA MT",6,1,0,1,0,1,-112.5906906,44.63881302
226,"LIMA OH",6,6,3,2,1,6,-84.10490417,40.74259186
226,"LINCOLN CA",6,4,2,1,1,4,-121.2951202,38.89149475
226,"LINCOLN MA",6,2,0,1,1,2,-71.30281067,42.4262085
226,"LINCOLN ME",6,1,1,0,0,1,-68.50415802,45.36241531
226,"LINCOLN NE",6,252,66,84,102,252,-96.6674118,40.80001068
226,"LINCOLN NH",6,2,1,0,1,2,-71.66905212,44.04570007
226,"LINCOLN PARK MI",6,2,0,0,2,2,-83.17868042,42.25064468
226,"LINCOLN PARK NJ",6,1,1,0,0,1,-74.30114746,40.92467117
226,"LINCOLNTON NC",6,4,2,0,2,4,-81.25417328,35.47389603
226,"LINCOLNWOOD IL",6,3,0,1,2,3,-87.73023987,42.00463104
226,"LINDALE TX",6,10,4,3,3,10,-95.40984344,32.51585007
226,"LINDEN NJ",6,4,2,0,2,4,-74.24382782,40.62202454
226,"LINDEN TN",6,1,0,0,1,1,-87.83943939,35.61751175
226,"LINDENHURST NY",6,16,2,4,10,16,-73.37233734,40.68688583
226,"LINDENWOLD NJ",6,1,1,0,0,1,-74.99706268,39.82461548
226,"LISBON OH",6,2,2,0,0,2,-80.76804352,40.77227402
226,"LISLE IL",6,4,0,2,2,4,-88.07471466,41.80134964
226,"LITITZ PA",6,10,2,2,6,10,-76.30600739,40.15749741
226,"LITTLE CHUTE WI",6,7,2,1,4,7,-88.31884003,44.27976608
226,"LITTLE FALLS NJ",6,1,0,1,0,1,-74.20709229,40.86914444
226,"LITTLE ROCK AR",6,268,74,65,129,268,-92.28178406,34.7369194
226,"LITTLESTOWN PA",6,3,1,2,0,3,-77.08756256,39.74491119
226,"LITTLETON CO",6,22,5,11,6,22,-105.0176163,39.6132431
226,"LITTLETON MA",6,1,0,0,1,1,-71.50911713,42.54176712
226,"LITTLETON NC",6,1,0,0,1,1,-77.91158295,36.4350853
226,"LIVE OAK FL",6,1,0,1,0,1,-82.98397064,30.29559708
226,"LIVERMORE CA",6,14,3,3,8,14,-121.7701416,37.68147659
226,"LIVERPOOL NY",6,8,3,0,5,8,-76.21547699,43.10769653
226,"LIVINGSTON LA",6,3,0,0,3,3,-90.74835205,30.50234604
226,"LIVINGSTON MT",6,7,1,4,2,7,-110.5622253,45.66219711
226,"LIVINGSTON NJ",6,2,1,0,1,2,-74.31424713,40.79631042
226,"LIVINGSTON TX",6,2,1,0,1,2,-94.93333435,30.71132088
226,"LIVONIA MI",6,66,16,19,31,66,-83.35256958,42.36862564
226,"LOCK HAVEN PA",6,4,1,2,1,4,-77.44603729,41.13732147
226,"LOCKHART TX",6,1,0,0,1,1,-97.67056274,29.88551712
226,"LOCKPORT IL",6,5,0,4,1,5,-88.0581131,41.58958435
226,"LOCKPORT NY",6,3,0,0,3,3,-78.69011688,43.17089081
226,"LODI CA",6,6,0,3,3,6,-121.2742386,38.12984467
226,"LODI NJ",6,3,0,2,1,3,-74.08244324,40.88240814
226,"LODI WI",6,2,0,0,2,2,-89.52679443,43.31368637
226,"LOGAN OH",6,7,4,0,3,7,-82.40658569,39.54026794
226,"LOGAN UT",6,152,34,36,82,152,-111.8171616,41.73900604
226,"LOGANSPORT IN",6,6,0,4,2,6,-86.36410522,40.75329208
226,"LOGANVILLE GA",6,8,0,2,6,8,-83.90035248,33.83914948
226,"LOMA LINDA CA",6,4,1,2,1,4,-117.2628555,34.04835129
226,"LOMBARD IL",6,10,4,2,4,10,-88.00775909,41.8800621
226,"LOMIRA WI",6,35,11,9,15,35,-88.44380188,43.59117126
226,"LOMITA CA",6,2,0,0,2,2,-118.3169556,33.79204941
226,"LOMPOC CA",6,9,3,2,4,9,-120.4598694,34.63894272
226,"LONDON KY",6,7,3,2,2,7,-84.08328247,37.12937546
226,"LONG BEACH CA",6,474,130,132,212,474,-118.1908112,33.7670517
226,"LONG BEACH MS",6,1,0,1,0,1,-89.15268707,30.35081673
226,"LONG BEACH NY",6,24,5,9,10,24,-73.6654129,40.58349991
226,"LONG BEACH WA",6,4,1,1,2,4,-124.0569916,46.35176086
226,"LONG BRANCH NJ",6,4,0,1,3,4,-73.991745,40.30428314
226,"LONGMEADOW MA",6,13,6,2,5,13,-72.5818634,42.05022812
226,"LONGMONT CO",6,45,10,15,20,45,-105.1026764,40.16700745
226,"LONGVIEW TX",6,51,14,14,23,51,-94.73707581,32.4966507
226,"LONGVIEW WA",6,9,1,4,4,9,-122.9404221,46.1375885
226,"LONGWOOD FL",6,8,2,1,5,8,-81.34702301,28.69888687
226,"LORAIN OH",6,16,5,5,6,16,-82.17118073,41.45874023
226,"LORIS SC",6,9,3,2,4,9,-78.89011383,34.05680084
226,"LOS ALTOS CA",6,23,7,5,11,23,-122.1163025,37.38525772
226,"LOS ANGELES CA",6,11451,3231,3097,5123,11451,-118.2459106,34.05225754
226,"LOS BANOS CA",6,4,2,0,2,4,-120.8519363,37.05815887
226,"LOS GATOS CA",6,25,9,6,10,25,-121.9771652,37.22674561
226,"LOUDON TN",6,6,3,0,3,6,-84.33385468,35.73310471
226,"LOUISA KY",6,3,0,2,1,3,-82.60322571,38.11429596
226,"LOUISA VA",6,20,7,6,7,20,-78.00349426,38.0253067
226,"LOUISBURG KS",6,15,8,2,5,15,-94.68140411,38.61960602
226,"LOUISVILLE AL",6,2,1,0,1,2,-85.55543518,31.78362274
226,"LOUISVILLE CO",6,8,4,1,3,8,-105.1326523,39.97768402
226,"LOUISVILLE NE",6,1,0,0,1,1,-96.16282654,40.99780273
226,"LOVELAND CO",6,26,12,7,7,26,-105.0755997,40.39763641
226,"LOVELAND OH",6,7,2,3,2,7,-84.25993347,39.26356506
226,"LOVES PARK IL",6,1,0,1,0,1,-89.05864716,42.31984711
226,"LOWELL AR",6,4,2,0,2,4,-94.13114166,36.25540161
226,"LOWELL IN",6,1,0,0,1,1,-87.42073059,41.29130173
226,"LOWELL MA",6,67,21,21,25,67,-71.31530762,42.63344574
226,"LOWELL MI",6,4,2,2,0,4,-85.34220123,42.93387604
226,"LOWER BURRELL PA",6,1,0,0,1,1,-79.75662994,40.55336761
226,"LOWVILLE NY",6,3,2,0,1,3,-75.49127197,43.78682709
226,"LUBBOCK TX",6,99,22,27,50,99,-101.8544312,33.59677505
226,"LUCEDALE MS",6,1,0,0,1,1,-88.59013367,30.92567635
226,"LUFKIN TX",6,12,3,6,3,12,-94.72932434,31.33858681
226,"LUMBERTON NC",6,6,4,2,0,6,-79.00803375,34.61832428
226,"LURAY VA",6,3,0,0,3,3,-78.45899963,38.66542816
226,"LUTHER OK",6,1,0,0,1,1,-97.19435883,35.66645432
226,"LYNCHBURG VA",6,20,7,6,7,20,-79.14174652,37.41383362
226,"LYNDEN WA",6,14,2,2,10,14,-122.455101,48.94639969
226,"LYNDHURST NJ",6,3,1,0,2,3,-74.12353516,40.81222153
226,"LYNDHURST OH",6,2,0,0,2,2,-81.48820496,41.52012253
226,"LYNN MA",6,19,5,7,7,19,-70.94833374,42.46699905
226,"LYNNWOOD WA",6,50,12,19,19,50,-122.3175736,47.82042313
226,"LYNWOOD CA",6,48,19,11,18,48,-118.2135544,33.93053055
226,"LYNWOOD IL",6,8,4,2,2,8,-87.53853607,41.52642059
226,"LYONS CO",6,2,1,0,1,2,-105.272377,40.22478485
226,"MACCLESFIELD NC",6,8,1,4,3,8,-77.66950226,35.75227356
226,"MACKINAW IL",6,11,5,1,5,11,-89.35753632,40.53728104
226,"MADELIA MN",6,1,0,1,0,1,-94.42191315,44.05470276
226,"MADERA CA",6,3,1,2,0,3,-120.0627594,36.96101379
226,"MADISON AL",6,18,3,1,5,9,-86.487213135,33.561834335
226,"MADISON CT",6,7,1,2,4,7,-72.59211731,41.28052902
226,"MADISON GA",6,1,0,1,0,1,-83.4675827,33.59574127
226,"MADISON HEIGHTS MI",6,3,1,2,0,3,-83.10519409,42.48604965
226,"MADISON IL",6,3,1,0,2,3,-90.15700531,38.68284988
226,"MADISON MS",6,21,7,3,11,21,-90.11543274,32.46231079
226,"MADISON NE",6,6,1,2,3,6,-97.45545959,41.82836151
226,"MADISON NJ",6,3,2,0,1,3,-74.41627502,40.76013184
226,"MADISON OH",6,1,1,0,0,1,-81.04933929,41.77106476
226,"MADISON SD",6,16,4,5,7,16,-97.11444855,44.00682449
226,"MADISON VA",6,5,3,1,1,5,-78.25695038,38.38075638
226,"MADISON WI",6,826,235,226,365,826,-89.40128326,43.07303619
226,"MADISON WV",6,1,0,0,1,1,-81.82273102,38.06180191
226,"MADISONVILLE LA",6,5,0,3,2,5,-90.15699005,30.40480232
226,"MADISONVILLE TX",6,1,0,0,1,1,-95.9119339,30.95035172
226,"MADRID IA",6,1,1,0,0,1,-93.82368469,41.87657166
226,"MAGNOLIA TX",6,3,0,1,2,3,-95.75150299,30.20981598
226,"MAHWAH NJ",6,2,0,1,1,2,-74.14279175,41.08900452
226,"MAIDEN NC",6,1,0,0,1,1,-81.21118164,35.57601166
226,"MALDEN MA",6,12,4,2,6,12,-71.06546783,42.42518234
226,"MALDEN MO",6,2,1,0,1,2,-89.96641541,36.55708313
226,"MALVERN OH",6,1,1,0,0,1,-81.18108368,40.69194412
226,"MALVERN PA",6,7,2,5,0,7,-75.51319885,40.03642654
226,"MAMMOTH LAKES CA",6,2,0,2,0,2,-119.0125961,37.60457611
226,"MANASQUAN NJ",6,1,0,0,1,1,-74.04832458,40.12630463
226,"MANASSAS PARK VA",6,13,2,6,5,13,-77.46895599,38.7841301
226,"MANASSAS VA",6,20,8,5,7,20,-77.47459412,38.75112534
226,"MANAWA WI",6,1,0,0,1,1,-88.91982269,44.46425247
226,"MANCHESTER CT",6,9,2,3,4,9,-72.52075958,41.77622986
226,"MANCHESTER KY",6,1,0,1,0,1,-83.76169586,37.15374756
226,"MANCHESTER MO",6,8,0,1,7,8,-90.50953674,38.597229
226,"MANCHESTER NH",6,211,54,70,87,211,-71.45406342,42.99581528
226,"MANCHESTER TN",6,2,1,0,1,2,-86.08409882,35.48292923
226,"MANDAN ND",6,15,4,7,4,15,-100.8964386,46.82664108
226,"MANDEVILLE LA",6,25,6,8,11,25,-90.06562805,30.35881805
226,"MANHATTAN BEACH CA",6,21,4,6,11,21,-118.4129181,33.88484192
226,"MANHATTAN IL",6,1,0,1,0,1,-87.98616791,41.42261124
226,"MANHATTAN KS",6,66,23,17,26,66,-96.57228851,39.18354034
226,"MANISTEE MI",6,1,1,0,0,1,-86.3241806,44.24435043
226,"MANITO IL",6,3,1,0,2,3,-89.77931213,40.42595291
226,"MANITOU SPRINGS CO",6,11,4,4,3,11,-104.9184494,38.85948944
226,"MANKATO MN",6,47,14,16,17,47,-94.02125549,44.15895462
226,"MANNING IA",6,4,1,1,2,4,-95.06541443,41.90926743
226,"MANNING SC",6,123,34,36,53,123,-80.21025085,33.69546509
226,"MANOR TX",6,2,1,1,0,2,-97.55760193,30.34129524
226,"MANSFIELD AR",6,4,1,1,2,4,-94.2530365,35.05989456
226,"MANSFIELD MA",6,2,1,1,0,2,-71.21801758,42.03358078
226,"MANSFIELD OH",6,8,1,4,3,8,-82.51545715,40.75864792
226,"MANSFIELD TX",6,8,2,3,3,8,-97.14230347,32.56362152
226,"MANTECA CA",6,1,1,0,0,1,-121.2179031,37.79747391
226,"MANTUA NJ",6,2,0,1,1,2,-75.17108917,39.79433823
226,"MANVEL TX",6,4,2,0,2,4,-95.35823822,29.46306229
226,"MAPLE GROVE MN",6,13,1,3,9,13,-93.47679138,45.14711761
226,"MAPLE SHADE NJ",6,8,3,3,2,8,-74.9913559,39.95294571
226,"MAPLE VALLEY WA",6,3,1,1,1,3,-122.0403976,47.40601349
226,"MAPLETON KS",6,1,0,0,1,1,-94.8840332,38.01527786
226,"MAPLETON UT",6,2,1,0,1,2,-111.5824585,40.13248444
226,"MAPLEWOOD MN",6,1,0,0,1,1,-93.05480194,45.01259232
226,"MAPLEWOOD MO",6,57,19,15,23,57,-90.32471466,38.6126976
226,"MAPLEWOOD NJ",6,64,24,17,23,64,-74.27243805,40.77401733
226,"MAQUOKETA IA",6,7,2,1,4,7,-90.66600037,42.06900024
226,"MARANA AZ",6,2,0,0,2,2,-111.2269363,32.43688965
226,"MARATHON FL",6,15,7,3,5,15,-81.09011841,24.71463966
226,"MARIANNA FL",6,6,0,3,3,6,-85.22673798,30.77488518
226,"MARICOPA AZ",6,15,5,3,7,15,-112.0491562,33.05832672
226,"MARIETTA GA",6,176,46,43,87,176,-84.54958344,33.9527359
226,"MARIETTA OH",6,5,0,3,2,5,-81.45451355,39.41536331
226,"MARIETTA OK",6,1,0,0,1,1,-97.11754608,33.93697739
226,"MARINA CA",6,16,2,2,12,16,-121.8042831,36.6841507
226,"MARINETTE WI",6,5,1,2,2,5,-87.63109589,45.10002518
226,"MARINGOUIN LA",6,1,0,0,1,1,-91.51993561,30.49166107
226,"MARION AL",6,4,1,1,2,4,-87.31942749,32.63277054
226,"MARION IA",6,6,1,3,2,6,-91.60752869,42.032547
226,"MARION IL",6,7,2,2,3,7,-88.93344116,37.73056412
226,"MARION IN",6,12,5,3,4,12,-85.65896606,40.55827332
226,"MARION KS",6,1,1,0,0,1,-97.018013,38.34838867
226,"MARION MS",6,3,0,0,3,3,-88.64802551,32.41785049
226,"MARION OH",6,4,0,1,3,4,-83.12861633,40.58881378
226,"MARION SC",6,4,1,1,2,4,-79.40047455,34.18493271
226,"MARKS MS",6,3,0,0,3,3,-90.27207947,34.25684357
226,"MARLBOROUGH MA",6,5,1,0,4,5,-71.55128479,42.34592819
226,"MARQUETTE MI",6,11,2,2,7,11,-87.39571381,46.54323196
226,"MARSHALL MI",6,5,1,1,3,5,-84.9631424,42.27227402
226,"MARSHALL MN",6,17,6,2,9,17,-95.78921509,44.4466362
226,"MARSHALL MO",6,1,1,0,0,1,-93.19745636,39.12294769
226,"MARSHALL TX",6,5,2,0,3,5,-94.36775208,32.5450592
226,"MARSHALLTOWN IA",6,64,14,16,34,64,-92.90861511,42.04956055
226,"MARSHFIELD MO",6,2,0,0,2,2,-92.90744781,37.33891678
226,"MARSHFIELD WI",6,1,0,1,0,1,-90.17188263,44.66900635
226,"MART TX",6,1,0,1,0,1,-96.83396149,31.5428257
226,"MARTIN TN",6,4,1,2,1,4,-88.85335541,36.34902573
226,"MARTINEZ CA",6,32,10,10,12,32,-122.1364365,38.01914597
226,"MARTINS FERRY OH",6,2,0,2,0,2,-80.72425842,40.09586716
226,"MARTINSBURG WV",6,6,0,2,4,6,-77.96557617,39.45707703
226,"MARTINSVILLE IN",6,4,0,0,4,4,-86.42851257,39.42800903
226,"MARTINSVILLE VA",6,12,3,2,7,12,-79.87229156,36.69199371
226,"MARYLAND HEIGHTS MO",6,12,5,4,3,12,-90.43025208,38.71334076
226,"MARYSVILLE CA",6,8,2,4,2,8,-121.5933762,39.14567947
226,"MARYSVILLE OH",6,3,1,0,2,3,-83.36706543,40.2364006
226,"MARYSVILLE PA",6,1,0,0,1,1,-76.92907715,40.34276199
226,"MARYSVILLE WA",6,12,5,1,6,12,-122.179451,48.05155182
226,"MARYVILLE IL",6,1,0,1,0,1,-89.95622253,38.72364044
226,"MARYVILLE MO",6,8,3,3,2,8,-94.87281036,40.34609604
226,"MARYVILLE TN",6,13,4,2,7,13,-83.96243286,35.76000977
226,"MASCOUTAH IL",6,3,0,1,2,3,-89.79308319,38.49026489
226,"MASON CITY IA",6,5,3,2,0,5,-93.20175934,43.15355301
226,"MASON MI",6,1,0,0,1,1,-84.44378662,42.57910538
226,"MASON OH",6,25,8,6,11,25,-84.30989075,39.36032104
226,"MASONTOWN PA",6,5,2,0,3,5,-79.89925385,39.84680176
226,"MASSILLON OH",6,10,4,3,3,10,-81.52096558,40.7966156
226,"MATAWAN NJ",6,1,1,0,0,1,-74.22887421,40.41519547
226,"MATFIELD GREEN KS",6,2,0,0,2,2,-96.56110382,38.15935516
226,"MATTESON IL",6,2,0,0,2,2,-87.71334839,41.50400162
226,"MATTHEWS NC",6,2,1,1,0,2,-80.72332001,35.11704254
226,"MATTOON IL",6,1,0,1,0,1,-88.37306976,39.48309326
226,"MAULDIN SC",6,1,0,0,1,1,-82.30957794,34.77907562
226,"MAUMEE OH",6,4,1,1,2,4,-83.65665436,41.56746292
226,"MAYETTA KS",6,3,0,1,2,3,-95.72317505,39.33889008
226,"MAYFIELD HEIGHTS OH",6,1,0,1,0,1,-81.45755005,41.51942062
226,"MAYFIELD KY",6,38,12,8,18,38,-88.63654327,36.74169922
226,"MAYFIELD OH",6,2,0,0,1,1,-82.905773165,40.52344513
226,"MAYNARD MA",6,2,1,1,0,2,-71.44880676,42.43361664
226,"MAYSVILLE NC",6,3,1,1,1,3,-77.23084259,34.90504074
226,"MAYVILLE WI",6,24,9,6,9,24,-88.54499817,43.49409103
226,"MAYWOOD CA",6,1,0,1,0,1,-118.1865921,33.98660278
226,"MAYWOOD IL",6,1,0,0,1,1,-87.84314728,41.87941742
226,"MCALLEN TX",6,64,11,17,36,64,-98.23077393,26.20433426
226,"MCCOMB MS",6,1,1,0,0,1,-90.45623016,31.2437973
226,"MCCORMICK SC",6,3,0,1,2,3,-82.29341125,33.91360855
226,"MCDONOUGH GA",6,21,7,7,7,21,-84.1467514,33.44765472
226,"MCFARLAND CA",6,1,1,0,0,1,-119.2310333,35.67798996
226,"MCHENRY IL",6,26,9,5,12,26,-88.2740097,42.34480286
226,"MCKENZIE TN",6,1,0,0,1,1,-88.51866913,36.13283157
226,"MCKINNEY TX",6,56,15,14,27,56,-96.6155777,33.19782257
226,"MCLEANSBORO IL",6,3,0,0,3,3,-88.53587341,38.09341049
226,"MCMINNVILLE OR",6,29,10,7,12,29,-123.2019272,45.20968628
226,"MCMINNVILLE TN",6,1,1,0,0,1,-85.77684784,35.68649673
226,"MCPHERSON KS",6,5,1,0,4,5,-97.66510773,38.37078094
226,"MEADVILLE PA",6,11,4,1,6,11,-80.15116119,41.64140701
226,"MEBANE NC",6,15,8,3,4,15,-79.26649475,36.09629059
226,"MECHANICSBURG PA",6,6,3,1,2,6,-77.00779724,40.21432114
226,"MECHANICSVILLE IA",6,1,0,0,1,1,-91.25505829,41.90429306
226,"MEDFORD LAKES NJ",6,2,0,2,0,2,-74.80196381,39.85878754
226,"MEDFORD MA",6,41,10,13,18,41,-71.10526276,42.41849518
226,"MEDFORD NJ",6,4,0,1,3,4,-74.82254791,39.90135193
226,"MEDFORD OR",6,27,9,3,15,27,-122.8773193,42.32625961
226,"MEDIA PA",6,3,0,0,3,3,-75.38693237,39.91692734
226,"MEDICAL LAKE WA",6,3,1,1,1,3,-117.682518,47.57226944
226,"MEDINA OH",6,73,16,15,42,73,-81.86336517,41.13858795
226,"MEDORA ND",6,1,1,0,0,1,-103.5243988,46.91657257
226,"MEDWAY MA",6,1,1,0,0,1,-71.39579773,42.14194107
226,"MELBOURNE FL",6,61,17,22,22,61,-80.60625458,28.07838249
226,"MELROSE MA",6,13,2,7,4,13,-71.07271576,42.45837784
226,"MELROSE PARK IL",6,2,0,0,2,2,-87.85682678,41.90048218
226,"MEMPHIS TN",6,1454,424,397,633,1454,-90.01696014,35.1194191
226,"MENA AR",6,10,4,2,4,10,-94.24035645,34.58638
226,"MENDOTA HEIGHTS MN",6,3,0,3,0,3,-93.12650299,44.88226318
226,"MENLO PARK CA",6,42,7,12,23,42,-122.1842423,37.45361328
226,"MENOMONEE FALLS WI",6,5,1,3,1,5,-88.11719513,43.17907715
226,"MENTOR OH",6,18,8,5,5,18,-81.33918762,41.66637421
226,"MERCED CA",6,40,10,12,18,40,-120.4848785,37.30197525
226,"MERCEDES TX",6,4,1,2,1,4,-97.91394043,26.15032959
226,"MERIDEN CT",6,10,4,2,4,10,-72.80596161,41.5384407
226,"MERIDIAN ID",6,8,0,4,4,8,-116.3941193,43.611866
226,"MERIDIAN MS",6,14,1,4,9,14,-88.70374298,32.36473846
226,"MERRIAM KS",6,3,1,0,2,3,-94.69395447,39.02367401
226,"MERRILL WI",6,1,1,0,0,1,-89.6834259,45.18042755
226,"MERRILLVILLE IN",6,4,1,1,2,4,-87.33312988,41.48298645
226,"MESA AZ",6,242,67,63,112,242,-111.8239059,33.42222214
226,"MESQUITE NV",6,2,1,0,1,2,-114.0683136,36.80557251
226,"MESQUITE TX",6,50,16,15,19,50,-96.59959412,32.76692581
226,"METAMORA IL",6,1,0,1,0,1,-89.36064911,40.7908287
226,"METUCHEN NJ",6,1,0,0,1,1,-74.36269379,40.543293
226,"MEXIA TX",6,1,0,0,1,1,-96.48291016,31.68026352
226,"MEXICO MO",6,1,0,0,1,1,-91.8833313,39.16965866
226,"MIAMI BEACH FL",6,129,40,31,58,129,-80.12982178,25.79146576
226,"MIAMI FL",6,2405,668,608,1129,2405,-80.19329071,25.77483749
226,"MIAMI OK",6,5,2,0,3,5,-94.87779999,36.87476349
226,"MIAMI SHORES FL",6,3,2,0,1,3,-80.19244385,25.8637619
226,"MIAMISBURG OH",6,32,11,5,16,32,-84.28652191,39.643116
226,"MICHIGAN CITY IN",6,8,1,0,7,8,-86.89486694,41.70751572
226,"MIDDLEBURY IN",6,3,2,0,1,3,-85.71139526,41.67531967
226,"MIDDLEBURY VT",6,54,9,15,30,54,-73.16629028,44.01540756
226,"MIDDLETON WI",6,2,0,1,1,2,-89.50476074,43.09717941
226,"MIDDLETOWN CT",6,41,14,10,17,41,-72.64955902,41.56232071
226,"MIDDLETOWN DE",6,14,5,5,4,14,-75.71700287,39.44935226
226,"MIDDLETOWN KY",6,1,0,0,1,1,-85.53855896,38.24543762
226,"MIDDLETOWN NJ",6,2,0,1,1,2,-74.11607361,40.39449692
226,"MIDDLETOWN NY",6,5,2,1,2,5,-74.4223938,41.44607544
226,"MIDDLETOWN OH",6,3,0,3,0,3,-84.39844513,39.51361084
226,"MIDDLEVILLE MI",6,1,0,0,1,1,-85.46193695,42.71302032
226,"MIDLAND MI",6,10,3,3,4,10,-84.24700928,43.61585236
226,"MIDLAND NC",6,1,1,0,0,1,-80.50031281,35.22761154
226,"MIDLAND TX",6,27,6,8,13,27,-102.0793686,31.99754143
226,"MIDWAY FL",6,3,0,2,1,3,-84.45413971,30.49596024
226,"MIDWEST CITY OK",6,10,2,3,5,10,-97.39709473,35.44970703
226,"MILFORD CT",6,9,1,5,3,9,-73.05560303,41.2226181
226,"MILFORD DE",6,4,2,0,2,4,-75.42737579,38.9128685
226,"MILFORD MA",6,17,0,7,10,17,-71.51522064,42.14015198
226,"MILFORD MI",6,4,0,2,2,4,-83.59909821,42.59347534
226,"MILFORD NH",6,1,0,0,1,1,-71.64792633,42.83569717
226,"MILFORD NY",6,4,0,3,1,4,-74.94455719,42.59064865
226,"MILFORD OH",6,3,0,2,1,3,-84.29400635,39.17559433
226,"MILL VALLEY CA",6,23,8,5,10,23,-122.5473328,37.90579224
226,"MILLBRAE CA",6,6,1,1,4,6,-122.3894043,37.59856033
226,"MILLBROOK AL",6,1,0,0,1,1,-86.36187744,32.48031998
226,"MILLBROOK NY",6,4,1,1,2,4,-73.69306183,41.78520966
226,"MILLBURY MA",6,1,0,1,0,1,-71.76168823,42.1903038
226,"MILLEDGEVILLE GA",6,10,3,3,4,10,-83.23179626,33.08055878
226,"MILLERSBURG PA",6,3,0,1,2,3,-76.96018982,40.53970718
226,"MILLERSTOWN PA",6,1,0,1,0,1,-79.79847717,40.65014267
226,"MILLERSVILLE PA",6,1,0,0,1,1,-76.35368347,39.99788666
226,"MILLIS MA",6,1,0,0,1,1,-71.35676575,42.16779327
226,"MILLSTADT IL",6,1,0,1,0,1,-90.09213257,38.46154404
226,"MILLTOWN NJ",6,2,2,0,0,2,-74.44260406,40.45628738
226,"MILLVILLE NJ",6,6,1,2,3,6,-75.03882599,39.40239716
226,"MILPITAS CA",6,1,0,0,1,1,-121.9090805,37.42808533
226,"MILTON DE",6,5,2,1,2,5,-75.31299591,38.77088547
226,"MILTON FL",6,6,2,0,4,6,-87.03953552,30.63289833
226,"MILTON MA",6,6,4,1,1,6,-71.06531525,42.25027466
226,"MILTON NH",6,1,0,1,0,1,-70.98744965,43.41014481
226,"MILTON PA",6,1,0,1,0,1,-76.84694672,41.0123024
226,"MILTON WI",6,2,1,0,1,2,-88.9439621,42.77545547
226,"MILTON WV",6,1,0,0,1,1,-82.12947845,38.43808746
226,"MILWAUKEE WI",6,931,278,259,394,931,-87.90684509,43.03887939
226,"MILWAUKIE OR",6,8,4,1,3,8,-122.6417084,45.44596481
226,"MINDEN LA",6,49,14,7,28,49,-93.28716278,32.61589432
226,"MINEOLA NY",6,2,0,1,1,2,-73.63988495,40.74962234
226,"MINERAL CITY OH",6,1,0,0,1,1,-81.36077881,40.6011467
226,"MINERAL WELLS TX",6,2,2,0,0,2,-98.11335754,32.80846024
226,"MINERSVILLE PA",6,2,1,0,1,2,-76.26126862,40.69085693
226,"MINNEAPOLIS MN",6,2318,664,599,1055,2318,-93.26397705,44.97980118
226,"MINNEOLA FL",6,4,2,0,2,4,-81.74643707,28.57386589
226,"MINNETONKA MN",6,9,4,1,4,9,-93.43367004,44.92795181
226,"MINOT ND",6,7,3,2,2,7,-101.2953949,48.23139572
226,"MINT HILL NC",6,5,1,3,1,5,-80.64685059,35.17968369
226,"MIRAMAR FL",6,70,21,17,32,70,-80.23181915,25.98794746
226,"MISHAWAKA IN",6,10,4,1,5,10,-86.18048859,41.65872574
226,"MISSION KS",6,42,13,13,16,42,-94.65638733,39.02796173
226,"MISSION TX",6,31,10,10,11,31,-98.32580566,26.21655273
226,"MISSION VIEJO CA",6,8,1,3,4,8,-117.6737366,33.59992218
226,"MISSOULA MT",6,124,28,42,54,124,-113.9832687,46.87278366
226,"MISSOURI CITY TX",6,44,17,6,21,44,-95.5381012,29.61878204
226,"MOAB UT",6,4,0,2,2,4,-109.5508347,38.57315063
226,"MOBERLY MO",6,5,0,3,2,5,-92.43862152,39.41818619
226,"MOBILE AL",6,190,53,42,95,190,-88.04309845,30.69476128
226,"MOBRIDGE SD",6,2,0,1,1,2,-100.4329529,45.53816223
226,"MODESTO CA",6,52,8,12,32,52,-120.9991455,37.63897324
226,"MOKENA IL",6,1,0,0,1,1,-87.88947296,41.52630615
226,"MOLINE IL",6,16,3,4,9,16,-90.51522064,41.5069809
226,"MONCKS CORNER SC",6,6,1,3,2,6,-80.01290131,33.19626236
226,"MONEE IL",6,1,0,1,0,1,-87.74182129,41.41996002
226,"MONESSEN PA",6,1,0,0,1,1,-79.88707733,40.14862442
226,"MONETT MO",6,4,0,3,1,4,-93.92830658,36.92906952
226,"MONMOUTH IL",6,1,0,1,0,1,-90.64776611,40.91139221
226,"MONMOUTH OR",6,4,2,1,1,4,-123.2363892,44.84816742
226,"MONONA WI",6,3,0,0,3,3,-89.33418274,43.06205368
226,"MONROE GA",6,2,1,0,1,2,-83.71302795,33.79499817
226,"MONROE LA",6,76,21,15,40,76,-92.11960602,32.50980759
226,"MONROE MI",6,2,0,0,2,2,-83.39758301,41.91663742
226,"MONROE NC",6,6,1,1,4,6,-80.54924011,34.98587036
226,"MONROE NY",6,9,3,0,6,9,-74.18616486,41.33085632
226,"MONROE WA",6,33,9,11,13,33,-121.9735718,47.85487747
226,"MONROVIA CA",6,40,13,10,17,40,-118.0006485,34.14796829
226,"MONT BELVIEU TX",6,1,0,1,0,1,-94.89146423,29.84809875
226,"MONTAGUE MI",6,1,1,0,0,1,-86.35713959,43.41694641
226,"MONTCLAIR NJ",6,55,12,16,27,55,-74.20848083,40.82605362
226,"MONTEBELLO CA",6,8,2,0,6,8,-118.1069412,34.00930023
226,"MONTEREY CA",6,46,17,10,19,46,-121.8974838,36.6002388
226,"MONTEREY PARK CA",6,3,2,1,0,3,-118.1248398,34.06269836
226,"MONTEVALLO AL",6,3,1,2,0,3,-86.86419678,33.10087967
226,"MONTGOMERY AL",6,230,60,73,97,230,-86.29966736,32.36724472
226,"MONTGOMERY IL",6,2,0,2,0,2,-88.34621429,41.73051071
226,"MONTGOMERY TX",6,3,1,1,1,3,-95.69664001,30.38855171
226,"MONTICELLO AR",6,1,0,1,0,1,-91.79141235,33.62911987
226,"MONTICELLO IL",6,2,1,1,0,2,-88.57354736,40.02787399
226,"MONTICELLO IN",6,1,0,1,0,1,-86.76451874,40.74537659
226,"MONTICELLO KY",6,1,0,0,1,1,-84.88193512,36.81594086
226,"MONTPELIER VT",6,10,3,3,4,10,-72.57458496,44.26039124
226,"MONTROSE CO",6,3,1,1,1,3,-107.8707047,38.4788475
226,"MONTROSE PA",6,2,0,1,1,2,-75.87622833,41.83430481
226,"MOON PA",6,1,0,0,1,1,-80.23907471,40.50891876
226,"MOORE HAVEN FL",6,1,1,0,0,1,-81.09259796,26.83358002
226,"MOORE OK",6,104,25,30,49,104,-97.48735046,35.33969498
226,"MOORESBORO NC",6,1,1,0,0,1,-81.69874573,35.29899597
226,"MOORESTOWN NJ",6,21,6,4,11,21,-74.94165039,39.96718597
226,"MOORESVILLE NC",6,10,0,6,4,10,-80.80976868,35.58535004
226,"MOORHEAD MN",6,17,6,5,6,17,-96.76844025,46.87382507
226,"MOORPARK CA",6,7,2,3,2,7,-118.8839111,34.28554535
226,"MORAGA CA",6,1,1,0,0,1,-122.1321945,37.83471298
226,"MOREHEAD CITY NC",6,1,1,0,0,1,-76.72536469,34.72343445
226,"MOREHEAD KY",6,8,3,2,3,8,-83.43223572,38.18409348
226,"MORGAN CITY LA",6,1,1,0,0,1,-91.20729065,29.69994926
226,"MORGAN HILL CA",6,4,0,1,3,4,-121.6563797,37.1303978
226,"MORGANTON NC",6,1,0,1,0,1,-81.68434906,35.74584961
226,"MORGANTOWN KY",6,5,2,1,2,5,-86.68365479,37.2256012
226,"MORGANTOWN WV",6,195,53,57,85,195,-79.95038605,39.63131714
226,"MORIARTY NM",6,1,1,0,0,1,-106.0516815,34.99026871
226,"MORRILTON AR",6,1,1,0,0,1,-92.74445343,35.15127182
226,"MORRIS IL",6,8,1,3,4,8,-88.42147064,41.3571167
226,"MORRIS MN",6,18,4,3,11,18,-95.91436005,45.58617401
226,"MORRIS OK",6,1,0,0,1,1,-95.86071014,35.60788727
226,"MORRIS PLAINS NJ",6,1,0,0,1,1,-74.47996521,40.82184601
226,"MORRISON CO",6,1,1,0,0,1,-105.1927185,39.65348434
226,"MORRISTOWN NJ",6,8,4,4,0,8,-74.48057556,40.79689789
226,"MORRISTOWN TN",6,4,0,0,4,4,-83.29478455,36.21415329
226,"MORRISVILLE NC",6,26,6,8,12,26,-78.82486725,35.82374954
226,"MORRO BAY CA",6,1,1,0,0,1,-120.8519135,35.36568451
226,"MORROW GA",6,9,2,5,2,9,-84.33943939,33.58339691
226,"MORVEN NC",6,1,0,1,0,1,-80.00048065,34.86457825
226,"MOSCOW ID",6,37,11,7,19,37,-117.0021973,46.73223877
226,"MOULTON AL",6,3,0,1,2,3,-87.29332733,34.48143387
226,"MOULTRIE GA",6,4,1,0,3,4,-83.78891754,31.18035507
226,"MOUND MN",6,2,0,0,2,2,-93.66635132,44.93652725
226,"MOUNDSVILLE WV",6,4,1,2,1,4,-80.74716949,39.92013931
226,"MOUNT AIRY MD",6,1,0,1,0,1,-77.15393066,39.37637711
226,"MOUNT AIRY NC",6,4,1,1,2,4,-80.60665131,36.49975586
226,"MOUNT CLEMENS MI",6,20,3,7,10,20,-82.87785339,42.59724808
226,"MOUNT ETNA IN",6,1,0,1,0,1,-85.56215668,40.74266815
226,"MOUNT HOLLY NJ",6,7,3,2,2,7,-74.78692627,39.99301147
226,"MOUNT JOY PA",6,1,0,0,1,1,-76.50283051,40.10977936
226,"MOUNT JULIET TN",6,3,0,2,1,3,-86.51877594,36.19998932
226,"MOUNT KISCO NY",6,5,2,1,2,5,-73.72622681,41.20458984
226,"MOUNT LEBANON PA",6,9,1,3,5,9,-80.04911804,40.35546494
226,"MOUNT MORRIS NY",6,2,0,1,1,2,-77.87361145,42.72562408
226,"MOUNT OLIVE NC",6,1,0,1,0,1,-78.06575012,35.19697952
226,"MOUNT PLEASANT MI",6,18,7,5,6,18,-84.76785278,43.59777832
226,"MOUNT PLEASANT PA",6,6,0,3,3,6,-79.54049683,40.1492691
226,"MOUNT PLEASANT SC",6,13,4,5,4,13,-79.86242676,32.79427719
226,"MOUNT PLEASANT TX",6,34,10,4,20,34,-94.96855927,33.15682602
226,"MOUNT PROSPECT IL",6,1,1,0,0,1,-87.93763733,42.0663414
226,"MOUNT RAINIER MD",6,11,3,1,7,11,-76.96430206,38.9414978
226,"MOUNT VERNON IA",6,2,0,0,2,2,-91.41739655,41.92199326
226,"MOUNT VERNON IL",6,7,5,0,2,7,-88.90307617,38.31738663
226,"MOUNT VERNON IN",6,1,0,1,0,1,-87.89586639,37.93523407
226,"MOUNT VERNON NY",6,12,1,2,3,6,-76.36322403,41.83351135
226,"MOUNT VERNON OH",6,2,0,1,1,2,-82.48577118,40.3935585
226,"MOUNT VERNON WA",6,6,2,3,1,6,-122.3365784,48.4208374
226,"MOUNTAIN HOME AR",6,13,3,4,6,13,-92.38542175,36.33543015
226,"MOUNTAIN HOME ID",6,15,7,4,4,15,-115.6928406,43.13270187
226,"MOUNTAIN VIEW CA",6,126,31,45,50,126,-122.0861969,37.3859024
226,"MOUNTLAKE TERRACE WA",6,2,0,1,1,2,-122.3119507,47.78780365
226,"MUKILTEO WA",6,1,0,1,0,1,-122.3008041,47.94359589
226,"MUKWONAGO WI",6,1,0,1,0,1,-88.33354187,42.86693192
226,"MULBERRY FL",6,2,0,1,1,2,-81.97315979,27.89601898
226,"MULDROW OK",6,5,1,1,3,5,-94.59899139,35.40637589
226,"MUNCIE IN",6,105,25,28,52,105,-85.38398743,40.18970871
226,"MUNDELEIN IL",6,4,1,1,2,4,-88.00391388,42.26291275
226,"MUNHALL PA",6,2,0,2,0,2,-79.89945984,40.39241409
226,"MUNSTER IN",6,3,2,0,1,3,-87.51268768,41.56475449
226,"MURFREESBORO TN",6,122,37,37,48,122,-86.39038086,35.84575653
226,"MURPHY NC",6,5,0,0,5,5,-84.03442383,35.08757019
226,"MURPHY TX",6,2,0,0,2,2,-96.61357117,33.01515198
226,"MURPHYSBORO IL",6,3,1,0,2,3,-89.33552551,37.7644043
226,"MURRAY KY",6,36,14,8,14,36,-88.31504059,36.61037827
226,"MURRAY UT",6,8,2,0,6,8,-111.8896103,40.66687012
226,"MURRIETA CA",6,14,5,3,6,14,-117.2157898,33.55398941
226,"MUSCATINE IA",6,2,0,1,1,2,-91.05540466,41.4216156
226,"MUSCLE SHOALS AL",6,7,2,2,3,7,-87.6674881,34.74491882
226,"MUSCODA WI",6,1,1,0,0,1,-90.44321442,43.18519592
226,"MUSKEGON MI",6,14,2,2,3,7,-86.25441742,43.23139763
226,"MUSKOGEE OK",6,72,15,23,34,72,-95.36999512,35.74824142
226,"MUSTANG OK",6,1,0,0,1,1,-97.72509766,35.38425446
226,"MYRTLE BEACH SC",6,41,9,14,18,41,-78.88601685,33.69656372
226,"MYRTLE MS",6,1,0,1,0,1,-89.11911011,34.55866241
226,"NACOGDOCHES TX",6,22,7,9,6,22,-94.6559906,31.60386467
226,"NAGS HEAD NC",6,1,0,1,0,1,-75.62320709,35.95791245
226,"NAHUNTA GA",6,1,0,1,0,1,-81.98110962,31.20463753
226,"NAMPA ID",6,38,13,8,17,38,-116.5658188,43.54054642
226,"NANTICOKE PA",6,1,0,0,1,1,-76.0042572,41.20532608
226,"NANTUCKET MA",6,5,0,2,3,5,-70.09862518,41.28360748
226,"NAPA CA",6,46,13,14,19,46,-122.2872086,38.29692841
226,"NAPERVILLE IL",6,74,21,19,34,74,-88.14768219,41.78578949
226,"NAPLES FL",6,50,12,14,24,50,-81.79434204,26.14280128
226,"NAPOLEON OH",6,4,2,1,1,4,-84.12521362,41.39214706
226,"NAPPANEE IN",6,4,2,1,1,4,-86.00133514,41.44298935
226,"NARBERTH PA",6,1,0,0,1,1,-75.25990295,40.00860596
226,"NASHUA NH",6,24,8,4,12,24,-71.46669769,42.76576996
226,"NATALIA TX",6,1,0,0,1,1,-98.86307526,29.19000626
226,"NATCHITOCHES LA",6,31,2,5,24,31,-93.08662415,31.76096535
226,"NATICK MA",6,20,4,4,12,20,-71.3484726,42.2836113
226,"NAUGATUCK CT",6,10,9,0,1,10,-73.04972076,41.4863205
226,"NAUVOO IL",6,1,0,0,1,1,-91.3849411,40.55012131
226,"NAVASOTA TX",6,1,0,1,0,1,-96.08838654,30.38853645
226,"NAZARETH PA",6,9,1,5,3,9,-75.30902863,40.74064255
226,"NEDERLAND CO",6,5,0,2,3,5,-105.5114899,39.96115494
226,"NEDERLAND TX",6,9,4,2,3,9,-93.99260712,29.97476387
226,"NEEDHAM MA",6,13,4,4,5,13,-71.21767426,42.27159119
226,"NEENAH WI",6,3,2,0,1,3,-88.4626236,44.18569183
226,"NEOGA IL",6,4,1,1,2,4,-88.45291901,39.31969833
226,"NEVADA CITY CA",6,17,6,2,9,17,-121.0184174,39.26145172
226,"NEVADA IA",6,1,0,1,0,1,-93.45307922,42.02274704
226,"NEVADA MO",6,1,0,0,1,1,-94.3551178,37.83953476
226,"NEW ALBANY IN",6,20,4,8,8,20,-85.80917358,38.29167938
226,"NEW ATHENS IL",6,1,0,0,1,1,-89.87749481,38.32641602
226,"NEW BALTIMORE MI",6,1,0,1,0,1,-82.73680115,42.68103409
226,"NEW BEDFORD MA",6,7,2,4,1,7,-70.93328857,41.63626862
226,"NEW BERLIN WI",6,1,0,1,0,1,-88.1087265,42.97659683
226,"NEW BERN NC",6,30,10,9,11,30,-77.04354095,35.10897827
226,"NEW BRAUNFELS TX",6,90,25,21,44,90,-98.12486267,29.70325089
226,"NEW BREMEN OH",6,1,0,0,1,1,-84.37955475,40.43714905
226,"NEW BRITAIN CT",6,9,3,5,1,9,-72.77884674,41.6615181
226,"NEW BRUNSWICK NJ",6,34,9,12,13,34,-74.45104218,40.48620987
226,"NEW BUFFALO MI",6,1,0,0,1,1,-86.7438736,41.7938385
226,"NEW CANAAN CT",6,3,0,0,3,3,-73.49369049,41.14690018
226,"NEW CARROLLTON MD",6,13,6,2,5,13,-76.8794632,38.97011185
226,"NEW CASTLE DE",6,42,15,15,12,42,-75.56227875,39.66440964
226,"NEW CASTLE PA",6,1,0,0,1,1,-80.34657288,41.00389481
226,"NEW GLARUS WI",6,2,0,0,2,2,-89.63531494,42.81429672
226,"NEW HARMONY IN",6,1,1,0,0,1,-87.93526459,38.12969589
226,"NEW HAVEN CT",6,365,110,94,161,365,-72.92726898,41.3084259
226,"NEW HAVEN IN",6,1,0,0,1,1,-85.01416779,41.07093048
226,"NEW HOLLAND PA",6,1,0,0,1,1,-76.0844574,40.10216141
226,"NEW HOPE MN",6,1,0,0,1,1,-93.38259125,45.02332687
226,"NEW HOPE PA",6,1,0,0,1,1,-74.95053864,40.36468124
226,"NEW IBERIA LA",6,2,1,1,0,2,-91.81869507,30.0039444
226,"NEW KENSINGTON PA",6,4,1,3,0,4,-79.76441956,40.57001114
226,"NEW LENOX IL",6,4,1,0,3,4,-87.9658432,41.51224899
226,"NEW LONDON CT",6,47,10,12,25,47,-72.09841156,41.35572815
226,"NEW LONDON MN",6,2,0,0,2,2,-94.94470978,45.30108261
226,"NEW MADRID MO",6,9,0,2,7,9,-89.52796936,36.58650589
226,"NEW MELLE MO",6,1,0,0,1,1,-90.87984467,38.71007538
226,"NEW MILFORD CT",6,8,2,3,3,8,-73.40771484,41.57733917
226,"NEW MILFORD NJ",6,2,0,0,2,2,-74.01824951,40.93526077
226,"NEW ORLEANS LA",6,1531,437,400,694,1531,-90.07525635,29.95483589
226,"NEW PALTZ NY",6,25,5,6,14,25,-74.08605194,41.74787903
226,"NEW PORT RICHEY FL",6,3,0,1,2,3,-82.71899414,28.24477577
226,"NEW ROCHELLE NY",6,21,3,6,12,21,-73.78160858,40.91175842
226,"NEW SMYRNA BEACH FL",6,1,1,0,0,1,-80.92392731,29.0242157
226,"NEW ULM MN",6,1,0,0,1,1,-94.46120453,44.31236649
226,"NEW YORK NY",6,8219,2499,2081,3639,8219,-74.00528717,40.7145195
226,"NEWARK DE",6,140,46,43,51,140,-75.74462128,39.68774414
226,"NEWARK NJ",6,495,143,142,210,495,-74.17185211,40.73570633
226,"NEWARK NY",6,7,3,1,3,7,-77.09454346,43.04671097
226,"NEWARK OH",6,7,2,2,3,7,-82.40110779,40.05843353
226,"NEWBERG OR",6,5,1,0,4,5,-122.9754334,45.29994202
226,"NEWBURGH IN",6,5,0,0,5,5,-87.40516663,37.94437027
226,"NEWBURGH NY",6,25,11,5,9,25,-74.00939941,41.50367737
226,"NEWBURYPORT MA",6,16,3,3,10,16,-70.8768692,42.81164551
226,"NEWINGTON CT",6,8,2,1,5,8,-72.72303772,41.69794464
226,"NEWMAN CA",6,1,0,0,1,1,-121.0232544,37.31364059
226,"NEWMARKET NH",6,9,3,3,3,9,-70.94036102,43.07514191
226,"NEWNAN GA",6,18,4,4,10,18,-84.79645538,33.37108231
226,"NEWPORT AR",6,2,2,0,0,2,-91.28199768,35.60486221
226,"NEWPORT KY",6,2,0,1,1,2,-84.49560547,39.09162521
226,"NEWPORT NEWS VA",6,84,21,29,34,84,-76.42758942,36.97909927
226,"NEWPORT OR",6,32,3,13,16,32,-124.0554047,44.6362915
226,"NEWPORT RI",6,38,12,10,16,38,-71.31213379,41.49024963
226,"NEWPORT TN",6,6,1,1,4,6,-83.18756104,35.96707916
226,"NEWTON IA",6,5,0,2,3,5,-93.05852509,41.69826126
226,"NEWTON IL",6,3,1,1,1,3,-88.16280365,38.99100876
226,"NEWTON KS",6,6,0,1,5,6,-97.3455658,38.04684067
226,"NEWTON MA",6,64,17,21,26,64,-71.20809937,42.33743286
226,"NEWTON NC",6,2,1,1,0,2,-81.22117615,35.67030334
226,"NEWTOWN PA",6,15,5,3,7,15,-74.93606567,40.22966003
226,"NIAGARA FALLS NY",6,43,7,15,21,43,-79.05632019,43.09456253
226,"NICEVILLE FL",6,1,1,0,0,1,-86.50150299,30.52109146
226,"NICHOLASVILLE KY",6,2,1,1,0,2,-84.57271576,37.88071442
226,"NICHOLSON GA",6,3,0,0,3,3,-83.43130493,34.11414719
226,"NICKERSON NE",6,8,4,1,3,8,-96.47119141,41.53437424
226,"NILES IL",6,5,3,1,1,5,-87.80277252,42.01877594
226,"NILES MI",6,3,1,2,0,3,-86.25424194,41.82971573
226,"NILES OH",6,1,0,0,1,1,-80.76469421,41.18286133
226,"NISKAYUNA NY",6,4,1,1,2,4,-73.84505463,42.77999115
226,"NIXA MO",6,67,18,19,30,67,-93.29502869,37.04324341
226,"NOBLESVILLE IN",6,41,12,9,20,41,-86.01766205,40.03728104
226,"NOCONA TX",6,4,1,0,3,4,-97.72662354,33.78715515
226,"NODAWAY IA",6,1,0,1,0,1,-94.89551544,40.93712997
226,"NOEL MO",6,7,3,2,2,7,-94.4858551,36.54568481
226,"NOLENSVILLE TN",6,2,2,0,0,2,-86.66940308,35.95249557
226,"NORCO CA",6,3,1,1,1,3,-117.5555801,33.93997192
226,"NORCROSS GA",6,48,13,16,19,48,-84.21324158,33.94129181
226,"NORFOLK NE",6,1,1,0,0,1,-97.41788483,42.02838898
226,"NORFOLK VA",6,447,147,94,206,447,-76.28334045,36.84831619
226,"NORMAL IL",6,27,7,11,9,27,-88.99052429,40.51409912
226,"NORMAN OK",6,131,40,34,57,131,-97.44689178,35.22203827
226,"NORPHLET AR",6,1,0,0,1,1,-92.6633606,33.31630707
226,"NORRISTOWN PA",6,3,2,0,1,3,-75.33937836,40.12155151
226,"NORTH ADAMS MA",6,2,0,1,1,2,-73.10797882,42.70087814
226,"NORTH ANDOVER MA",6,14,5,2,7,14,-71.13425446,42.69897079
226,"NORTH AUGUSTA SC",6,26,9,9,8,26,-81.96509552,33.5021019
226,"NORTH BEND OH",6,1,0,0,1,1,-84.74803162,39.15279388
226,"NORTH BEND WA",6,50,19,13,18,50,-121.7899017,47.49547195
226,"NORTH BERGEN NJ",6,17,4,6,7,17,-74.0112381,40.8045845
226,"NORTH BRANCH MI",6,1,0,0,1,1,-83.19683838,43.22947311
226,"NORTH BRANCH MN",6,3,1,0,2,3,-92.98061371,45.51115799
226,"NORTH CANTON OH",6,3,1,0,2,3,-81.40194702,40.87594223
226,"NORTH CHARLESTON SC",6,21,6,4,11,21,-79.97457886,32.85499191
226,"NORTH CHICAGO IL",6,13,3,4,6,13,-87.8412323,42.3254509
226,"NORTH EAST MD",6,1,0,0,1,1,-75.94083405,39.60018539
226,"NORTH HAVEN CT",6,1,0,1,0,1,-72.85857391,41.39123535
226,"NORTH LAS VEGAS NV",6,54,15,14,25,54,-115.1192093,36.19900131
226,"NORTH LIBERTY IA",6,13,6,3,4,13,-91.59856415,41.74905777
226,"NORTH LIBERTY IN",6,4,3,0,1,4,-86.42704773,41.5342598
226,"NORTH LITTLE ROCK AR",6,53,13,15,25,53,-92.26677704,34.76465988
226,"NORTH MIAMI BEACH FL",6,23,7,6,10,23,-80.16223907,25.93397713
226,"NORTH MIAMI FL",6,12,2,3,7,12,-80.18624115,25.8908596
226,"NORTH MUSKEGON MI",6,1,0,0,1,1,-86.26753235,43.25621414
226,"NORTH OGDEN UT",6,2,1,1,0,2,-111.9736023,41.30478668
226,"NORTH OLMSTED OH",6,7,2,1,4,7,-81.92334747,41.41566849
226,"NORTH PALM BEACH FL",6,1,0,0,1,1,-80.08132935,26.81809998
226,"NORTH PLATTE NE",6,14,7,2,5,14,-100.7660141,41.12404633
226,"NORTH POLE AK",6,3,3,0,0,3,-147.3626251,64.7430191
226,"NORTH RICHLAND HILLS TX",6,5,2,0,3,5,-97.22973633,32.83457947
226,"NORTH RIDGEVILLE OH",6,2,0,0,2,2,-82.04491425,41.37031937
226,"NORTH SYRACUSE NY",6,1,0,1,0,1,-76.12913513,43.13497543
226,"NORTH TONAWANDA NY",6,8,1,2,5,8,-78.86399841,43.03866196
226,"NORTH VERNON IN",6,2,1,0,1,2,-85.62359619,39.00614166
226,"NORTH WILKESBORO NC",6,1,0,1,0,1,-81.14702606,36.15879059
226,"NORTHAMPTON MA",6,63,17,15,31,63,-72.64012146,42.32544708
226,"NORTHBROOK IL",6,5,0,1,4,5,-87.82922363,42.12767792
226,"NORTHFIELD MN",6,8,3,3,2,8,-93.16210175,44.45811081
226,"NORTHFIELD VT",6,1,0,0,1,1,-72.65539551,44.15140152
226,"NORTHGLENN CO",6,4,2,0,2,4,-104.9886932,39.88547516
226,"NORTHPORT AL",6,5,1,3,1,5,-87.57746124,33.22927856
226,"NORTHPORT MI",6,2,1,0,1,2,-85.61663818,45.13160324
226,"NORTHPORT NY",6,1,1,0,0,1,-73.34220123,40.90099335
226,"NORTHVILLE MI",6,2,0,1,1,2,-83.48340607,42.4312706
226,"NORTHVILLE NY",6,2,1,0,1,2,-74.1713028,43.22576904
226,"NORWALK CA",6,7,1,2,4,7,-118.0839539,33.90219116
226,"NORWALK CT",6,39,11,11,17,39,-73.40729523,41.11759949
226,"NORWALK OH",6,2,0,0,2,2,-82.61576843,41.24267197
226,"NORWELL MA",6,1,0,1,0,1,-70.79288483,42.16187286
226,"NORWICH CT",6,17,4,5,8,17,-72.07475281,41.52449036
226,"NORWICH NY",6,1,1,0,0,1,-75.52252197,42.53137207
226,"NORWOOD MA",6,20,4,6,10,20,-71.1987915,42.19477844
226,"NORWOOD NY",6,2,0,1,1,2,-74.99372864,44.75166702
226,"NORWOOD OH",6,7,2,2,3,7,-84.45967865,39.15586853
226,"NOVATO CA",6,7,3,1,3,7,-122.576561,38.11727142
226,"NOVI MI",6,15,3,3,9,15,-83.47566223,42.48064423
226,"NUTLEY NJ",6,9,4,2,3,9,-74.15930939,40.82229996
226,"NYACK NY",6,40,11,11,18,40,-73.91687012,41.09091568
226,"NYSSA OR",6,1,0,1,0,1,-116.9971619,43.87642288
226,"O'FALLON MO",6,76,22,20,34,76,-90.69979095,38.8109436
226,"OAK BLUFFS MA",6,15,3,5,7,15,-70.56096649,41.45436859
226,"OAK BROOK IL",6,2,1,0,1,2,-87.92926788,41.83280945
226,"OAK CREEK WI",6,2,0,0,2,2,-87.86346436,42.88599014
226,"OAK FOREST IL",6,1,1,0,0,1,-87.74399567,41.60294342
226,"OAK GROVE MO",6,1,0,0,1,1,-94.12957764,39.0049324
226,"OAK HARBOR WA",6,4,1,1,2,4,-122.6395798,48.29240036
226,"OAK LAWN IL",6,4,1,2,1,4,-87.7545929,41.721138
226,"OAK PARK IL",6,54,14,14,26,54,-87.78443909,41.88500595
226,"OAK PARK MI",6,10,0,1,4,5,-84.21956253,42.40898132
226,"OAK RIDGE TN",6,6,3,1,2,6,-84.26974487,36.01036072
226,"OAKDALE CA",6,4,0,0,4,4,-120.8491745,37.76628113
226,"OAKDALE LA",6,6,2,2,2,6,-92.66092682,30.8165493
226,"OAKLAND CA",6,2652,846,713,1093,2652,-122.2733154,37.80438614
226,"OAKLAND TN",6,1,0,0,1,1,-89.5151062,35.22905731
226,"OBERLIN KS",6,1,0,0,1,1,-100.52948,39.81811142
226,"OBERLIN OH",6,16,6,2,8,16,-82.21720886,41.29413223
226,"OBLONG IL",6,4,0,0,4,4,-87.90914154,39.00207138
226,"OCALA FL",6,31,6,11,14,31,-82.13973236,29.18780708
226,"OCCOQUAN VA",6,2,0,1,1,2,-77.25945282,38.68394852
226,"OCEAN CITY MD",6,2,0,0,2,2,-75.08437347,38.33656311
226,"OCEAN RIDGE FL",6,1,0,0,1,1,-80.04788208,26.5275383
226,"OCEAN SPRINGS MS",6,2,0,1,1,2,-88.82833862,30.41417313
226,"OCEANSIDE CA",6,78,19,25,34,78,-117.3814011,33.19587326
226,"OCOEE FL",6,4,2,2,0,4,-81.54336548,28.56987
226,"ODEM TX",6,2,1,0,1,2,-97.58276367,27.95134926
226,"ODESSA MO",6,1,1,0,0,1,-93.95418549,38.99940491
226,"ODESSA TX",6,37,9,10,18,37,-102.3682938,31.84587097
226,"OGALLALA NE",6,103,31,30,42,103,-101.7200775,41.1279068
226,"OGDEN UT",6,90,20,26,44,90,-111.9730225,41.22582626
226,"OGDENSBURG NY",6,10,2,4,4,10,-75.48552704,44.69423294
226,"OHATCHEE AL",6,1,1,0,0,1,-86.00268555,33.78360748
226,"OHIO IL",6,4,1,1,2,4,-89.46100616,41.55773544
226,"OJAI CA",6,7,3,1,3,7,-119.2175903,34.4372139
226,"OKAWVILLE IL",6,2,0,1,1,2,-89.55079651,38.43439865
226,"OKEENE OK",6,8,2,3,3,8,-98.31767273,36.11601257
226,"OKLAHOMA CITY OK",6,605,181,169,255,605,-97.51699829,35.46761322
226,"OKOBOJI IA",6,1,0,1,0,1,-95.14891815,43.38606262
226,"OLATHE KS",6,169,45,40,84,169,-94.81970215,38.88142395
226,"OLD BRIDGE NJ",6,4,2,0,2,4,-74.36474609,40.41495895
226,"OLD ORCHARD BEACH ME",6,2,1,1,0,2,-70.37640381,43.51769257
226,"OLD SAYBROOK CT",6,4,1,2,1,4,-72.37509918,41.29185104
226,"OLEAN NY",6,4,3,0,1,4,-78.42921448,42.07747269
226,"OLIVE BRANCH MS",6,39,15,8,16,39,-89.82355499,34.96377563
226,"OLYMPIA FIELDS IL",6,8,4,0,4,8,-87.67446899,41.51344299
226,"OLYMPIA WA",6,233,57,77,99,233,-122.8909378,47.04053497
226,"OMAHA NE",6,630,170,177,283,630,-95.93825531,41.25878906
226,"ONALASKA WI",6,1,0,0,1,1,-91.23545074,43.88446808
226,"ONEONTA NY",6,3,0,0,3,3,-75.0631485,42.45296097
226,"ONTARIO CA",6,60,14,16,30,60,-117.6528702,34.06340408
226,"OOSTBURG WI",6,2,1,1,0,2,-87.79463959,43.62262726
226,"OPA-LOCKA FL",6,2,0,0,2,2,-80.25005341,25.90292931
226,"OPELIKA AL",6,15,6,6,3,15,-85.3780365,32.64568329
226,"OPELOUSAS LA",6,1,0,1,0,1,-92.08177948,30.53403282
226,"ORADELL NJ",6,1,1,0,0,1,-74.03572845,40.95891571
226,"ORANGE CA",6,129,34,42,53,129,-117.8544846,33.7877388
226,"ORANGE CITY IA",6,3,0,3,0,3,-96.05925751,43.00707626
226,"ORANGE COVE CA",6,1,0,0,1,1,-119.3159561,36.62437439
226,"ORANGE PARK FL",6,11,1,4,6,11,-81.70614624,30.16655731
226,"ORANGE TX",6,2,1,0,1,2,-93.73699951,30.09343147
226,"ORANGEBURG SC",6,14,1,6,7,14,-80.86129761,33.48974228
226,"ORCHARD PARK NY",6,7,1,4,2,7,-78.74337006,42.76783371
226,"OREGON CITY OR",6,16,3,4,9,16,-122.6096726,45.35689163
226,"OREGON WI",6,1,0,0,1,1,-89.38459778,42.92614746
226,"OREM UT",6,19,4,4,11,19,-111.6960449,40.29695892
226,"ORISKANY NY",6,1,1,0,0,1,-75.33181763,43.15730667
226,"ORLAND CA",6,2,0,1,1,2,-122.1985169,39.74710464
226,"ORLANDO FL",6,1969,536,512,921,1969,-81.3789978,28.53886795
226,"ORMOND BEACH FL",6,72,14,29,29,72,-81.05541992,29.28623772
226,"ORONO ME",6,3,1,1,1,3,-68.67062378,44.88346863
226,"OROVILLE CA",6,4,0,2,2,4,-121.5581131,39.51348877
226,"ORTONVILLE MI",6,1,0,0,1,1,-83.44315338,42.852314
226,"OSAWATOMIE KS",6,1,0,1,0,1,-94.95084381,38.49703598
226,"OSCEOLA AR",6,1,1,0,0,1,-89.96954346,35.70536041
226,"OSCEOLA IA",6,1,0,1,0,1,-93.76622009,41.03388596
226,"OSCEOLA WI",6,1,0,0,1,1,-92.70531464,45.32062531
226,"OSHKOSH WI",6,35,13,7,15,35,-88.54268646,44.02453613
226,"OSKALOOSA IA",6,1,1,0,0,1,-92.64469147,41.29632568
226,"OSSINING NY",6,6,2,2,2,6,-73.86093903,41.16327286
226,"OSSIPEE NH",6,4,2,1,1,4,-71.11573029,43.68548965
226,"OSWEGO IL",6,9,2,4,3,9,-88.3513031,41.68288422
226,"OSWEGO NY",6,21,3,7,11,21,-76.50988007,43.45563889
226,"OTHELLO WA",6,2,1,0,1,2,-119.1771622,46.82546616
226,"OTTAWA KS",6,1,1,0,0,1,-95.26805878,38.61549759
226,"OTTAWA OH",6,1,1,0,0,1,-84.04722595,41.01917267
226,"OTTUMWA IA",6,6,2,2,2,6,-92.41059113,41.01459122
226,"OVERLAND MO",6,7,4,1,2,7,-90.36277008,38.70130157
226,"OVERLAND PARK KS",6,148,39,40,69,148,-94.67124939,38.98216248
226,"OVIEDO FL",6,18,7,4,7,18,-81.20778656,28.67054749
226,"OWASSO OK",6,5,1,3,1,5,-95.85546875,36.26954651
226,"OWATONNA MN",6,38,12,8,18,38,-93.22633362,44.08358383
226,"OWENSBORO KY",6,24,4,8,12,24,-87.11345673,37.77421188
226,"OWENSVILLE MO",6,4,2,1,1,4,-91.50177765,38.34587479
226,"OWINGSVILLE KY",6,3,0,0,3,3,-83.76404572,38.14480591
226,"OWOSSO MI",6,1,0,0,1,1,-84.17687988,42.99795914
226,"OXFORD AL",6,1,0,0,1,1,-85.83503723,33.6145134
226,"OXFORD MI",6,1,0,0,1,1,-83.26428986,42.82481766
226,"OXFORD MS",6,148,40,39,69,148,-89.52319336,34.37203979
226,"OXFORD NC",6,2,0,2,0,2,-78.59002686,36.31116486
226,"OXFORD OH",6,13,4,4,5,13,-84.74536133,39.50694275
226,"OXNARD CA",6,81,23,15,43,81,-119.1790085,34.19766998
226,"OYSTER BAY NY",6,3,1,1,1,3,-73.52724457,40.87223053
226,"OZARK MO",6,3,1,1,1,3,-93.20661163,37.02112198
226,"PACIFIC GROVE CA",6,2,1,1,0,2,-121.9299164,36.62815475
226,"PACIFIC MO",6,1,0,0,1,1,-90.74199677,38.48199081
226,"PACIFICA CA",6,19,5,4,10,19,-122.4893951,37.61383438
226,"PADUCAH KY",6,53,10,17,26,53,-88.60009766,37.08333206
226,"PAGE AZ",6,1,0,0,1,1,-111.4749603,36.90849304
226,"PAGELAND SC",6,2,1,1,0,2,-80.39112091,34.77358246
226,"PAHOKEE FL",6,2,0,1,1,2,-80.66488647,26.82079887
226,"PAINTED POST NY",6,3,0,0,3,3,-77.09351349,42.16218185
226,"PALATINE IL",6,3,2,0,1,3,-88.03440857,42.11017609
226,"PALATKA FL",6,1,0,0,1,1,-81.63694763,29.6489048
226,"PALESTINE TX",6,3,0,1,2,3,-95.6313324,31.76263046
226,"PALISADES PARK NJ",6,14,5,6,3,14,-73.9969635,40.84852982
226,"PALM BAY FL",6,25,5,7,13,25,-80.58313751,28.03806496
226,"PALM BEACH FL",6,31,8,8,15,31,-80.03616333,26.70643616
226,"PALM BEACH GARDENS FL",6,12,1,4,7,12,-80.07454681,26.8109169
226,"PALM DESERT CA",6,36,10,7,19,36,-116.3907166,33.72164154
226,"PALM SPRINGS CA",6,144,37,41,66,144,-116.5467758,33.83036423
226,"PALM SPRINGS FL",6,6,0,1,5,6,-80.09664154,26.63662338
226,"PALMDALE CA",6,65,15,15,35,65,-118.118454,34.57925034
226,"PALMER AK",6,4,2,0,2,4,-149.1138458,61.59459305
226,"PALMER TX",6,1,0,0,1,1,-96.66825104,32.43172073
226,"PALMETTO FL",6,3,1,0,2,3,-82.57216644,27.52223396
226,"PALMETTO GA",6,4,1,0,1,2,-83.79598999,33.71222115
226,"PALMYRA MO",6,1,0,1,0,1,-91.53061676,39.80343628
226,"PALMYRA NJ",6,1,0,0,1,1,-75.02716827,40.00719452
226,"PALMYRA PA",6,3,0,1,2,3,-76.59290314,40.30906677
226,"PALO ALTO CA",6,129,34,33,62,129,-122.1449661,37.44177628
226,"PALOS HILLS IL",6,1,0,0,1,1,-87.81729889,41.6969986
226,"PAMPA TX",6,1,0,0,1,1,-100.96035,35.53606796
226,"PANAMA CITY BEACH FL",6,62,21,16,25,62,-85.80211639,30.1792717
226,"PANAMA CITY FL",6,50,10,17,23,50,-85.65970612,30.16412926
226,"PANORA IA",6,1,1,0,0,1,-94.36328125,41.69157791
226,"PAONIA CO",6,2,0,0,2,2,-107.5928116,38.86806107
226,"PAPILLION NE",6,6,2,2,2,6,-96.04257202,41.15442276
226,"PARADISE CA",6,2,1,0,1,2,-121.6395493,39.74609756
226,"PARADISE VALLEY AZ",6,2,2,0,0,2,-111.9442825,33.53105164
226,"PARAGOULD AR",6,4,1,0,3,4,-90.5002594,36.05854034
226,"PARAMOUNT CA",6,17,3,6,8,17,-118.161644,33.88947678
226,"PARAMUS NJ",6,1,0,1,0,1,-74.0747757,40.9445343
226,"PARIS IL",6,6,2,3,1,6,-87.69623566,39.61117172
226,"PARIS KY",6,8,1,3,4,8,-84.25283051,38.21011353
226,"PARIS TN",6,15,2,7,6,15,-88.3266983,36.30187225
226,"PARIS TX",6,21,6,9,6,21,-95.55589294,33.66113663
226,"PARK CITY UT",6,289,77,85,127,289,-111.5018539,40.65143204
226,"PARKER CITY IN",6,1,0,1,0,1,-85.20401764,40.18889618
226,"PARKER CO",6,35,8,7,20,35,-104.7624359,39.51849365
226,"PARKERSBURG WV",6,6,1,3,2,6,-81.54850006,39.28261948
226,"PARKS LA",6,1,0,1,0,1,-91.8321991,30.21488571
226,"PARKVILLE MO",6,5,1,2,2,5,-94.68252563,39.19501114
226,"PARLIER CA",6,6,1,3,2,6,-119.5286789,36.61136627
226,"PARMA HEIGHTS OH",6,2,1,0,1,2,-81.75946808,41.39034271
226,"PARMA MI",6,1,0,0,1,1,-84.59953308,42.258358
226,"PARMA OH",6,24,9,4,11,24,-81.72257996,41.40510178
226,"PARSONS KS",6,12,2,3,7,12,-95.2614975,37.34062195
226,"PARSONS WV",6,6,0,1,5,6,-79.68100739,39.09702682
226,"PASADENA CA",6,379,107,112,160,379,-118.1466675,34.14794922
226,"PASADENA TX",6,25,7,5,13,25,-95.20979309,29.69150162
226,"PASCAGOULA MS",6,4,2,0,2,4,-88.55257416,30.36789703
226,"PASCO WA",6,7,1,3,3,7,-119.1023636,46.2282753
226,"PASSAIC NJ",6,5,0,2,3,5,-74.12754822,40.8571434
226,"PATASKALA OH",6,2,0,0,2,2,-82.67435455,39.99578094
226,"PATCHOGUE NY",6,3,0,2,1,3,-73.01426697,40.76568985
226,"PATERSON NJ",6,111,33,31,47,111,-74.17102051,40.91714478
226,"PATTERSON CA",6,1,1,0,0,1,-121.1320572,37.47135162
226,"PATTERSON LA",6,3,2,0,1,3,-91.30235291,29.69374847
226,"PATTERSON NY",6,5,2,2,1,5,-73.60557556,41.51379395
226,"PAULSBORO NJ",6,2,0,0,2,2,-75.23970032,39.83067322
226,"PAWTUCKET RI",6,25,8,9,8,25,-71.38137054,41.87892532
226,"PAYETTE ID",6,11,0,5,6,11,-116.9361572,44.07813263
226,"PAYSON UT",6,1,0,0,1,1,-111.7331848,40.04447937
226,"PEABODY MA",6,1,0,1,0,1,-70.92794037,42.52825928
226,"PEARL RIVER LA",6,1,0,0,1,1,-89.74861145,30.37618065
226,"PEARLAND TX",6,42,8,8,26,42,-95.28644562,29.56411743
226,"PEARSALL TX",6,1,0,1,0,1,-99.09545898,28.89260483
226,"PECATONICA IL",6,1,1,0,0,1,-89.35954285,42.31416321
226,"PEEKSKILL NY",6,3,0,1,2,3,-73.91973877,41.29017639
226,"PEKIN IL",6,4,1,1,2,4,-89.64067841,40.56766891
226,"PELLA IA",6,6,0,3,3,6,-92.92386627,41.40042114
226,"PEMBROKE NC",6,2,0,0,2,2,-79.19446564,34.68062592
226,"PEMBROKE PINES FL",6,56,17,13,26,56,-80.22357941,26.00384903
226,"PENDLETON IN",6,13,3,4,6,13,-85.74658203,39.99742126
226,"PENDLETON OR",6,23,6,5,12,23,-118.7900848,45.67152786
226,"PENN HILLS PA",6,11,2,4,5,11,-79.85767365,40.46170044
226,"PENN YAN NY",6,3,0,1,2,3,-77.05323029,42.66117096
226,"PENNDEL PA",6,1,1,0,0,1,-74.91597748,40.1521492
226,"PENSACOLA FL",6,145,30,42,73,145,-87.21669006,30.42154694
226,"PEORIA AZ",6,38,17,6,15,38,-112.2390747,33.58084106
226,"PEORIA HEIGHTS IL",6,1,0,1,0,1,-89.57430267,40.74733734
226,"PEORIA IL",6,89,32,16,41,89,-89.59487152,40.70241928
226,"PERRIS CA",6,4,0,3,1,4,-117.2306519,33.78261948
226,"PERRY FL",6,1,1,0,0,1,-83.58158875,30.11780548
226,"PERRY GA",6,3,1,1,1,3,-83.73152161,32.45870972
226,"PERRY MI",6,2,1,0,1,2,-84.21952057,42.82634354
226,"PERRY MO",6,1,0,0,1,1,-91.67559814,39.43136215
226,"PERRYSBURG OH",6,8,0,4,4,8,-83.62700653,41.55728531
226,"PERRYVILLE MD",6,5,3,1,1,5,-76.07060242,39.56047821
226,"PERRYVILLE MO",6,8,5,1,2,8,-89.86131287,37.72448349
226,"PERTH AMBOY NJ",6,32,9,8,15,32,-74.26480103,40.5068779
226,"PERU IL",6,3,0,2,1,3,-89.12227631,41.32889175
226,"PERU IN",6,1,0,0,1,1,-86.06684875,40.74810028
226,"PETALUMA CA",6,36,7,14,15,36,-122.6394272,38.23221207
226,"PETERBOROUGH NH",6,1,1,0,0,1,-71.95066071,42.87090683
226,"PETERSBURG VA",6,11,2,2,7,11,-77.40148926,37.2280426
226,"PEWAUKEE WI",6,1,0,0,1,1,-88.26155853,43.08044434
226,"PFLUGERVILLE TX",6,22,2,9,11,22,-97.62039948,30.4396553
226,"PHARR TX",6,28,9,6,13,28,-98.1840744,26.19566154
226,"PHENIX CITY AL",6,20,7,5,8,20,-85.00059509,32.4714241
226,"PHILADELPHIA MS",6,2,1,0,1,2,-89.11659241,32.7718277
226,"PHILADELPHIA NY",6,3,0,1,2,3,-75.70793915,44.15469742
226,"PHILADELPHIA PA",6,3633,1098,958,1577,3633,-75.16322327,39.95243835
226,"PHILADELPHIA TN",6,1,0,0,1,1,-84.40354156,35.67960358
226,"PHILLIPSBURG NJ",6,1,1,0,0,1,-75.18927002,40.69387054
226,"PHOENIX AZ",6,1606,453,427,726,1606,-112.0752716,33.44825363
226,"PHOENIX OR",6,7,3,3,1,7,-122.8203583,42.27503967
226,"PHOENIXVILLE PA",6,26,8,5,13,26,-75.51416779,40.13076401
226,"PICAYUNE MS",6,2,1,1,0,2,-89.67980194,30.52602005
226,"PICO RIVERA CA",6,6,2,1,3,6,-118.0985489,33.983284
226,"PIEDMONT CA",6,1,0,1,0,1,-122.2344055,37.8243103
226,"PIEDMONT SD",6,5,1,1,3,5,-103.3931732,44.23329163
226,"PIGEON FORGE TN",6,2,0,2,0,2,-83.54741669,35.79348755
226,"PIGGOTT AR",6,1,0,0,1,1,-90.19084167,36.38312912
226,"PIKEVILLE KY",6,5,1,1,3,5,-82.51830292,37.47967529
226,"PILOT POINT TX",6,1,0,0,1,1,-96.96129608,33.39688873
226,"PINE BLUFF AR",6,11,3,3,5,11,-92.00374603,34.22846222
226,"PINE CITY MN",6,6,1,2,3,6,-92.96896362,45.82616043
226,"PINEHURST NC",6,1,0,0,1,1,-79.46926117,35.19573975
226,"PINELLAS PARK FL",6,19,4,8,7,19,-82.69934845,27.84342194
226,"PINEVILLE LA",6,2,1,1,0,2,-92.43460083,31.32294083
226,"PINK HILL NC",6,1,0,0,1,1,-77.74569702,35.05550766
226,"PINOLE CA",6,2,0,0,2,2,-122.3012772,38.00416565
226,"PIQUA OH",6,2,1,1,0,2,-84.24250793,40.14477539
226,"PISMO BEACH CA",6,31,10,6,15,31,-120.6432953,35.1427269
226,"PITMAN NJ",6,2,2,0,0,2,-75.13101959,39.73334122
226,"PITTSBORO IN",6,1,0,0,1,1,-86.46704865,39.8641243
226,"PITTSBORO NC",6,1,1,0,0,1,-79.17662811,35.72052002
226,"PITTSBURG CA",6,69,29,16,24,69,-121.8871613,38.02787781
226,"PITTSBURG KS",6,9,3,3,3,9,-94.70526123,37.41111374
226,"PITTSBURGH PA",6,2338,696,676,966,2338,-79.99537659,40.44091415
226,"PITTSFIELD MA",6,46,20,12,14,46,-73.24451447,42.45004272
226,"PLACENTIA CA",6,1,1,0,0,1,-117.8715134,33.87210464
226,"PLACERVILLE CA",6,35,11,7,17,35,-120.8002701,38.72951508
226,"PLAINFIELD IL",6,27,6,5,16,27,-88.20417786,41.62700653
226,"PLAINFIELD IN",6,10,2,3,5,10,-86.39954376,39.70450974
226,"PLAINFIELD NJ",6,11,3,0,8,11,-74.40673065,40.63404083
226,"PLAINSBORO NJ",6,1,0,0,1,1,-74.59952545,40.33381653
226,"PLANO IL",6,1,0,1,0,1,-88.5372467,41.66307449
226,"PLANO TX",6,133,29,31,73,133,-96.69931793,33.01993942
226,"PLANT CITY FL",6,3,1,1,1,3,-82.11231232,28.01914597
226,"PLANTATION FL",6,32,12,11,9,32,-80.23281097,26.12825966
226,"PLAQUEMINE LA",6,21,6,6,9,21,-91.23427582,30.28962708
226,"PLATTE CITY MO",6,1,0,0,1,1,-94.78305054,39.37047958
226,"PLATTEVILLE WI",6,1,0,1,0,1,-90.47890472,42.73428726
226,"PLATTSBURGH NY",6,24,9,8,7,24,-73.45239258,44.69951248
226,"PLEASANT HILL CA",6,4,0,1,3,4,-122.0632401,37.94770813
226,"PLEASANT VALLEY MO",6,3,1,0,2,3,-94.48001099,39.21652985
226,"PLEASANTON CA",6,8,2,2,4,8,-121.8771362,37.66220856
226,"PLEASANTON TX",6,1,0,0,1,1,-98.47924042,28.96782303
226,"PLEASANTVILLE IA",6,7,4,0,3,7,-93.26985168,41.38561249
226,"PLEASANTVILLE NJ",6,4,0,2,2,4,-74.52319336,39.3899765
226,"PLEASANTVILLE NY",6,1,0,0,1,1,-73.792099,41.13287354
226,"PLENTYWOOD MT",6,1,1,0,0,1,-104.564415,48.78044128
226,"PLYMOUTH IN",6,1,1,0,0,1,-86.31345367,41.33988953
226,"PLYMOUTH MA",6,28,7,9,12,28,-70.67458344,41.95769882
226,"PLYMOUTH MI",6,1,0,0,1,1,-83.46985626,42.37141418
226,"PLYMOUTH MN",6,7,0,3,4,7,-93.45163727,45.02838898
226,"PLYMOUTH NC",6,1,1,0,0,1,-76.74766541,35.86725616
226,"PLYMOUTH WI",6,1,1,0,0,1,-87.9770813,43.74871445
226,"POCA WV",6,1,1,0,0,1,-81.81469727,38.47033691
226,"POCATELLO ID",6,26,5,5,16,26,-112.4475937,42.87098694
226,"POINT PLEASANT NJ",6,1,0,1,0,1,-74.06723022,40.08329391
226,"POINT PLEASANT WV",6,2,0,0,2,2,-82.13266754,38.84964752
226,"POLAND OH",6,1,0,0,1,1,-80.61445618,41.02416992
226,"POMONA CA",6,50,14,11,25,50,-117.7534485,34.05541611
226,"POMPANO BEACH FL",6,37,11,10,16,37,-80.12407684,26.23855591
226,"PONCA CITY OK",6,1,1,0,0,1,-97.08611298,36.70682907
226,"PONTIAC MI",6,14,5,4,5,14,-83.29104614,42.63900757
226,"PONTOON BEACH IL",6,1,1,0,0,1,-90.08075714,38.7317276
226,"PONTOTOC MS",6,3,0,2,1,3,-88.99865723,34.24829102
226,"POPLAR BLUFF MO",6,9,4,1,4,9,-90.3928833,36.75717545
226,"POPLARVILLE MS",6,2,1,1,0,2,-89.53426361,30.84044838
226,"PORT ALLEN LA",6,1,0,1,0,1,-91.21043396,30.45239639
226,"PORT ANGELES WA",6,22,4,7,11,22,-123.4329224,48.11795044
226,"PORT ARTHUR TX",6,65,12,25,28,65,-93.93045807,29.90067863
226,"PORT CHESTER NY",6,2,0,1,1,2,-73.66493225,41.00179291
226,"PORT HUENEME CA",6,14,5,2,7,14,-119.1969757,34.14772797
226,"PORT HURON MI",6,16,4,3,9,16,-82.42453766,42.97105026
226,"PORT NECHES TX",6,1,0,0,1,1,-93.95863342,29.99169731
226,"PORT ORANGE FL",6,18,3,4,11,18,-81.00856781,29.13491631
226,"PORT ORCHARD WA",6,9,2,2,5,9,-122.6369019,47.53696823
226,"PORT ORFORD OR",6,12,6,4,2,12,-124.4993668,42.74531555
226,"PORT TOWNSEND WA",6,4,0,2,2,4,-122.7630005,48.11659241
226,"PORTAGE IN",6,2,0,0,2,2,-87.18197632,41.57239151
226,"PORTAGE MI",6,15,4,4,7,15,-85.57974243,42.20133972
226,"PORTAGE WI",6,12,4,3,5,12,-89.46311188,43.53891754
226,"PORTER OK",6,3,1,1,1,3,-95.5231781,35.87133026
226,"PORTERFIELD WI",6,1,1,0,0,1,-87.79449463,45.15425491
226,"PORTERVILLE CA",6,5,0,2,3,5,-119.0190811,36.06521988
226,"PORTLAND IN",6,7,4,3,0,7,-84.97788239,40.43445969
226,"PORTLAND ME",6,353,108,94,151,353,-70.25403595,43.6618576
226,"PORTLAND MI",6,2,1,0,1,2,-84.90298462,42.86923599
226,"PORTLAND OR",6,4914,1416,1309,2189,4914,-122.6786423,45.52309418
226,"PORTLAND TN",6,1,0,1,0,1,-86.51625824,36.58184814
226,"PORTOLA VALLEY CA",6,5,1,2,2,5,-122.2373505,37.38395309
226,"PORTSMOUTH NH",6,48,15,11,22,48,-70.76164246,43.07198334
226,"PORTSMOUTH OH",6,3,0,3,0,3,-82.99292755,38.74839783
226,"PORTSMOUTH VA",6,37,10,7,20,37,-76.29769135,36.83554077
226,"POTEAU OK",6,1,0,0,1,1,-94.623703,35.05377197
226,"POTOSI MO",6,1,0,1,0,1,-90.78826141,37.93638992
226,"POTSDAM NY",6,18,6,2,10,18,-74.98085785,44.66995239
226,"POTTSTOWN PA",6,12,5,4,3,12,-75.64894867,40.24571609
226,"POUGHKEEPSIE NY",6,46,13,11,22,46,-73.92034149,41.70055771
226,"POULSBO WA",6,2,0,1,1,2,-122.648819,47.73558426
226,"POUND VA",6,3,2,1,0,3,-82.60127258,37.12379837
226,"POWAY CA",6,1,1,0,0,1,-117.0376205,32.96272659
226,"POWDER SPRINGS GA",6,8,3,3,2,8,-84.68379974,33.8599205
226,"POWELL WY",6,10,2,5,3,10,-108.7592468,44.75395203
226,"PRAIRIE DU CHIEN WI",6,2,1,1,0,2,-91.14174652,43.05184174
226,"PRAIRIE VIEW TX",6,21,5,8,8,21,-95.9883194,30.09370232
226,"PRAIRIE VILLAGE KS",6,9,3,4,2,9,-94.63400269,38.99189377
226,"PRATTVILLE AL",6,30,16,5,9,30,-86.45972443,32.46446228
226,"PRESCOTT AZ",6,16,6,3,7,16,-112.4702301,34.54008102
226,"PRESQUE ISLE ME",6,4,0,2,2,4,-68.01457214,46.68122482
226,"PRICE UT",6,5,3,2,0,5,-110.8117294,39.60165024
226,"PRICHARD AL",6,4,2,1,1,4,-88.07904053,30.739048
226,"PRIEST RIVER ID",6,1,1,0,0,1,-116.906868,48.18558121
226,"PRINCESS ANNE MD",6,2,0,1,1,2,-75.69158173,38.20330429
226,"PRINCETON KY",6,1,0,0,1,1,-87.8817749,37.1091156
226,"PRINCETON NJ",6,98,28,27,43,98,-74.65805817,40.34872055
226,"PRINCETON WV",6,5,1,2,2,5,-81.09912872,37.36967468
226,"PROCTORVILLE OH",6,3,2,0,1,3,-82.37682343,38.43706512
226,"PROPHETSTOWN IL",6,1,1,0,0,1,-89.93671417,41.6713829
226,"PROSPECT PA",6,5,2,2,1,5,-80.04576111,40.90452576
226,"PROSPER TX",6,10,1,4,5,10,-96.80168915,33.23641205
226,"PROSSER WA",6,4,1,1,2,4,-119.7716522,46.20647812
226,"PROVIDENCE RI",6,400,127,111,162,400,-71.40118408,41.82990265
226,"PROVINCETOWN MA",6,308,98,76,134,308,-70.17770386,42.05849075
226,"PROVO UT",6,66,13,18,35,66,-111.6589813,40.23337936
226,"PUEBLO CO",6,92,27,28,37,92,-104.6108551,38.25450516
226,"PULASKI TN",6,1,0,1,0,1,-87.03085327,35.19976807
226,"PULLMAN WA",6,283,80,77,126,283,-117.180481,46.73068619
226,"PUNTA GORDA FL",6,6,1,2,3,6,-82.04517365,26.93050766
226,"PURCELLVILLE VA",6,6,1,2,3,6,-77.71422577,39.13694763
226,"PUYALLUP WA",6,30,10,9,11,30,-122.2927628,47.19064331
226,"QUAKERTOWN PA",6,5,2,2,1,5,-75.33325958,40.44256592
226,"QUAPAW OK",6,4,2,1,1,4,-94.7911377,36.95119095
226,"QUARRYVILLE PA",6,1,0,1,0,1,-76.16281891,39.898983
226,"QUEEN CREEK AZ",6,16,7,7,2,16,-111.6382294,33.25391769
226,"QUINCY IL",6,45,15,10,20,45,-91.41021729,39.9356575
226,"QUINCY MA",6,34,9,11,14,34,-71.00706482,42.24961472
226,"QUINCY MI",6,1,0,0,1,1,-84.88388824,41.94426727
226,"QUINCY WA",6,2,0,1,1,2,-119.8556213,47.23251343
226,"RACINE WI",6,42,14,12,16,42,-87.78296661,42.72628021
226,"RADFORD VA",6,27,9,6,12,27,-80.57588196,37.13208389
226,"RAINBOW CITY AL",6,3,1,2,0,3,-86.04200745,33.95517349
226,"RALEIGH NC",6,1311,370,370,571,1311,-78.63800049,35.77230835
226,"RAMSEY MN",6,3,2,0,1,3,-93.41651154,45.24803162
226,"RAMSEY NJ",6,13,2,6,5,13,-74.13990021,41.05768967
226,"RANCHO CORDOVA CA",6,4,2,2,0,4,-121.3053742,38.58900452
226,"RANCHO MIRAGE CA",6,5,1,4,0,5,-116.4143066,33.73956299
226,"RANDLEMAN NC",6,1,0,0,1,1,-79.80243683,35.81801224
226,"RANDOLPH MA",6,4,1,1,2,4,-71.03983307,42.1629715
226,"RANDOLPH VT",6,1,0,1,0,1,-72.6631012,43.92315674
226,"RANGER TX",6,2,1,0,1,2,-98.67836761,32.47434998
226,"RANTOUL IL",6,5,4,1,0,5,-88.15558624,40.31206131
226,"RAPID CITY SD",6,24,7,8,9,24,-103.2325821,44.08078766
226,"RAVENNA OH",6,4,2,1,1,4,-81.24195099,41.15758896
226,"RAWLINS WY",6,2,0,0,2,2,-107.2396469,41.79079819
226,"RAYTOWN MO",6,12,7,5,0,12,-94.46369934,39.00871277
226,"READING MA",6,1,0,0,1,1,-71.0990448,42.52708054
226,"READING OH",6,1,0,1,0,1,-84.44190979,39.22368622
226,"READING PA",6,46,15,10,21,46,-75.9259491,40.33562851
226,"RECTOR AR",6,1,0,0,1,1,-90.29301453,36.26305771
226,"RED BANK NJ",6,5,2,0,3,5,-74.06324768,40.3471756
226,"RED BLUFF CA",6,2,0,2,0,2,-122.2382431,40.17803574
226,"RED HOOK NY",6,4,3,0,1,4,-73.87477875,41.99516296
226,"RED LAKE FALLS MN",6,2,0,2,0,2,-96.27508545,47.88212967
226,"RED LION PA",6,13,4,2,7,13,-76.60523987,39.9010849
226,"RED WING MN",6,5,1,2,2,5,-92.53401184,44.56221771
226,"REDDING CA",6,32,8,13,11,32,-122.3944626,40.58649826
226,"REDDING CT",6,4,0,2,2,4,-73.38277435,41.30291367
226,"REDLANDS CA",6,60,15,18,27,60,-117.21064,34.0318718
226,"REDMOND OR",6,2,0,0,2,2,-121.1761093,44.27230453
226,"REDMOND WA",6,230,75,67,88,230,-122.1240006,47.67367172
226,"REDONDO BEACH CA",6,41,12,13,16,41,-118.3907471,33.84916687
226,"REDWATER TX",6,1,0,1,0,1,-94.25495911,33.3584404
226,"REDWOOD CITY CA",6,94,22,40,32,94,-122.2364655,37.48601151
226,"REEDLEY CA",6,8,0,2,6,8,-119.4518738,36.59639359
226,"REEDS SPRING MO",6,6,2,2,2,6,-93.37806702,36.74977493
226,"REFUGIO TX",6,26,4,8,14,26,-97.27603912,28.30598068
226,"REHOBOTH BEACH DE",6,3,1,2,0,3,-75.0807724,38.71229172
226,"REIDSVILLE NC",6,1,0,0,1,1,-79.66392517,36.35525513
226,"RENO NV",6,191,52,53,86,191,-119.8160934,39.5294838
226,"RENOVO PA",6,1,0,0,1,1,-77.75049591,41.32676315
226,"RENSSELAER NY",6,3,0,2,1,3,-73.741745,42.64271927
226,"RENTON WA",6,85,24,23,38,85,-122.2197342,47.48252487
226,"REPUBLIC MO",6,10,3,4,3,10,-93.48056793,37.12031555
226,"REVERE MA",6,3,1,2,0,3,-71.01091003,42.40863037
226,"REXBURG ID",6,3,1,2,0,3,-111.7915344,43.82584763
226,"REYNOLDSBURG OH",6,7,3,1,3,7,-82.81163788,39.95471191
226,"RHINELANDER WI",6,1,0,0,1,1,-89.41246796,45.63654709
226,"RIALTO CA",6,19,5,5,9,19,-117.3716126,34.1063118
226,"RICHARDSON TX",6,35,14,5,16,35,-96.73020172,32.94840622
226,"RICHFIELD MN",6,13,4,5,4,13,-93.28303528,44.87028503
226,"RICHLAND CENTER WI",6,4,0,0,4,4,-90.38737488,43.33480072
226,"RICHLAND MS",6,1,1,0,0,1,-90.16493225,32.22668076
226,"RICHLAND WA",6,28,4,14,10,28,-119.2866592,46.28547287
226,"RICHMOND CA",6,108,34,26,48,108,-122.3500443,37.9354744
226,"RICHMOND HEIGHTS MO",6,40,9,13,18,40,-90.31951904,38.62892532
226,"RICHMOND HILL GA",6,3,2,0,1,3,-81.30295563,31.9388752
226,"RICHMOND IN",6,11,3,2,6,11,-84.8900528,39.82888412
226,"RICHMOND KY",6,14,4,4,6,14,-84.29437256,37.74818802
226,"RICHMOND TX",6,31,12,7,12,31,-95.76106262,29.58276558
226,"RICHMOND VA",6,1024,299,271,454,1024,-77.45962524,37.55412674
226,"RICHTON PARK IL",6,3,2,0,1,3,-87.70342255,41.48434448
226,"RIDGEFIELD CT",6,8,3,1,4,8,-73.49742126,41.28165054
226,"RIDGEFIELD PARK NJ",6,3,0,2,1,3,-74.02059937,40.85723877
226,"RIDGEFIELD WA",6,1,0,1,0,1,-122.7458344,45.81910324
226,"RIDGELAND MS",6,25,7,7,11,25,-90.13221741,32.42857742
226,"RINGGOLD GA",6,16,5,6,5,16,-85.10852051,34.9195137
226,"RINGWOOD NJ",6,1,0,1,0,1,-74.24452209,41.11375046
226,"RIO GRANDE CITY TX",6,3,1,1,1,3,-98.82068634,26.38054466
226,"RIO HONDO TX",6,1,0,0,1,1,-97.58255005,26.23609543
226,"RIO RANCHO NM",6,5,1,0,4,5,-106.6682816,35.23852539
226,"RIPLEY MS",6,1,0,1,0,1,-88.95102692,34.72987747
226,"RIPLEY WV",6,1,1,0,0,1,-81.70641327,38.81864166
226,"RIPON CA",6,1,0,1,0,1,-121.1263886,37.74160385
226,"RIPON WI",6,7,2,4,1,7,-88.83634186,43.8422966
226,"RISCO MO",6,1,1,0,0,1,-89.8181076,36.55341721
226,"RISON AR",6,1,0,0,1,1,-92.19036102,33.95878983
226,"RIVER EDGE NJ",6,1,0,1,0,1,-74.03898621,40.9289856
226,"RIVERDALE GA",6,30,6,15,9,30,-84.4131012,33.57296371
226,"RIVERDALE IL",6,1,1,0,0,1,-87.633255,41.6336174
226,"RIVERHEAD NY",6,3,0,2,1,3,-72.66098785,40.91713333
226,"RIVERSIDE CA",6,251,70,66,115,251,-117.3973999,33.95311737
226,"RIVERSIDE NJ",6,40,13,10,17,40,-74.95646667,40.03240967
226,"RIVERTON IL",6,1,0,0,1,1,-89.53983307,39.84453201
226,"RIVERTON UT",6,3,0,1,2,3,-111.940033,40.52087402
226,"RIVERVIEW MI",6,1,1,0,0,1,-83.17921448,42.17431259
226,"ROANOKE AL",6,1,0,0,1,1,-85.37194061,33.15143967
226,"ROANOKE RAPIDS NC",6,1,1,0,0,1,-77.65331268,36.46160889
226,"ROANOKE VA",6,101,24,27,50,101,-79.94111633,37.27119827
226,"ROBBINS IL",6,1,0,1,0,1,-87.70363617,41.64415359
226,"ROBBINS NC",6,1,0,1,0,1,-79.58666992,35.43448257
226,"ROBBINSDALE MN",6,2,1,1,0,2,-93.33868408,45.03195572
226,"ROBINSON IL",6,6,5,1,0,6,-87.73912048,39.00521469
226,"ROCHELLE IL",6,1,1,0,0,1,-89.06913757,41.9238472
226,"ROCHESTER IL",6,1,1,0,0,1,-89.53198242,39.74978256
226,"ROCHESTER MI",6,20,10,5,5,20,-83.13374329,42.68050766
226,"ROCHESTER MN",6,95,34,16,45,95,-92.47042084,44.02156448
226,"ROCHESTER NY",6,769,209,221,339,769,-77.61522675,43.15487671
226,"ROCK HILL MO",6,2,2,0,0,2,-90.37846375,38.60773849
226,"ROCK HILL SC",6,49,16,10,23,49,-81.02463531,34.92498779
226,"ROCK ISLAND IL",6,29,10,11,8,29,-90.5790329,41.50963593
226,"ROCK SPRINGS WY",6,2,0,2,0,2,-109.2040176,41.58724976
226,"ROCKAWAY NJ",6,2,1,1,0,2,-74.51339722,40.90123367
226,"ROCKDALE TX",6,3,1,1,1,3,-97.00177765,30.65601349
226,"ROCKFORD IL",6,45,11,10,24,45,-89.09428406,42.27135086
226,"ROCKFORD MI",6,6,2,2,2,6,-85.56002045,43.12025833
226,"ROCKFORD MN",6,2,0,2,0,2,-93.73521423,45.08799744
226,"ROCKINGHAM NC",6,1,0,0,1,1,-79.77334595,34.9397316
226,"ROCKLAND ME",6,16,4,5,7,16,-69.1079483,44.10363388
226,"ROCKLIN CA",6,24,10,8,6,24,-121.2383118,38.79031754
226,"ROCKPORT MA",6,2,0,1,1,2,-70.61954498,42.65607071
226,"ROCKPORT TX",6,1,0,1,0,1,-97.05498505,28.02133369
226,"ROCKVILLE CENTRE NY",6,1,0,1,0,1,-73.64044189,40.6588974
226,"ROCKVILLE IN",6,1,1,0,0,1,-87.22940063,39.76271057
226,"ROCKVILLE MD",6,128,35,42,51,128,-77.15235901,39.08402252
226,"ROCKWALL TX",6,6,1,0,5,6,-96.46016693,32.93169022
226,"ROCKY HILL CT",6,5,0,2,3,5,-72.64056396,41.66537857
226,"ROCKY MOUNT NC",6,13,2,2,9,13,-77.78997803,35.93837738
226,"ROCKY MOUNT VA",6,1,0,0,1,1,-79.89165497,36.99800491
226,"ROCKY RIVER OH",6,13,1,3,9,13,-81.83889008,41.4756279
226,"ROELAND PARK KS",6,4,2,1,1,4,-94.63275146,39.03766251
226,"ROGERS AR",6,29,8,6,15,29,-94.11903381,36.33228683
226,"ROGERSVILLE MO",6,1,0,1,0,1,-93.05628967,37.11710358
226,"ROGUE RIVER OR",6,1,1,0,0,1,-123.1744843,42.43546677
226,"ROLLA MO",6,5,0,1,4,5,-91.77151489,37.95161438
226,"ROME GA",6,18,7,6,5,18,-85.16900635,34.24008942
226,"ROME NY",6,5,0,2,3,5,-75.4548645,43.21290207
226,"ROMEOVILLE IL",6,7,1,1,5,7,-88.08948517,41.64759064
226,"ROMULUS MI",6,3,0,1,2,3,-83.3963623,42.22240448
226,"ROODHOUSE IL",6,1,0,0,1,1,-90.37174225,39.48381424
226,"ROPESVILLE TX",6,1,0,0,1,1,-102.1553803,33.4136467
226,"ROSCOE IL",6,4,1,2,1,4,-89.00959778,42.41326523
226,"ROSCOE SD",6,4,1,2,1,4,-99.33797455,45.44993591
226,"ROSE VALLEY PA",6,1,0,0,1,1,-75.38393402,39.89647293
226,"ROSEBURG OR",6,15,5,2,8,15,-123.3444519,43.21644974
226,"ROSEDALE MS",6,1,0,1,0,1,-91.02830505,33.853508
226,"ROSELLE IL",6,3,1,2,0,3,-88.08023071,41.9848671
226,"ROSELLE NJ",6,5,2,3,0,5,-74.2624588,40.66469574
226,"ROSEMOUNT MN",6,2,1,1,0,2,-93.12598419,44.73943329
226,"ROSENBERG TX",6,15,5,6,4,15,-95.80905914,29.5575695
226,"ROSEVILLE CA",6,61,20,18,23,61,-121.2899246,38.75195694
226,"ROSEVILLE MI",6,1,0,0,1,1,-82.93720245,42.49747086
226,"ROSEVILLE MN",6,42,12,8,22,42,-93.14508057,45.02290726
226,"ROSS CA",6,4,0,2,2,4,-122.557251,37.96221924
226,"ROSWELL GA",6,37,11,13,13,37,-84.36141205,34.02328491
226,"ROSWELL NM",6,4,2,0,2,4,-104.5282135,33.39533997
226,"ROTTERDAM NY",6,1,0,0,1,1,-73.96983337,42.78696823
226,"ROUND LAKE IL",6,2,0,0,2,2,-88.09385681,42.35342789
226,"ROUND ROCK TX",6,30,9,6,15,30,-97.67939758,30.50861359
226,"ROWLETT TX",6,32,7,8,17,32,-96.56422424,32.90298462
226,"ROWLEY MA",6,2,1,1,0,2,-70.87771606,42.71709442
226,"ROXANA IL",6,1,1,0,0,1,-90.07637024,38.84868622
226,"ROXBORO NC",6,10,3,2,5,10,-78.98235321,36.3940506
226,"ROY UT",6,4,0,2,2,4,-112.035286,41.16501999
226,"ROYAL OAK MI",6,22,6,5,11,22,-83.1442337,42.48933792
226,"ROYERSFORD PA",6,10,3,1,6,10,-75.53735352,40.18464279
226,"ROYSE CITY TX",6,3,1,1,1,3,-96.33287048,32.97550201
226,"RUMSON NJ",6,3,1,0,2,3,-73.99851227,40.37051773
226,"RUSHVILLE IL",6,1,0,0,1,1,-90.56352997,40.12114334
226,"RUSSELLVILLE AR",6,20,4,7,9,20,-93.1343689,35.27845383
226,"RUSTON LA",6,12,4,5,3,12,-92.63848877,32.52357101
226,"RUTHERFORD NJ",6,4,2,2,0,4,-74.10585022,40.82668304
226,"RUTLAND VT",6,7,0,3,4,7,-72.97142029,43.61096954
226,"RYE CO",6,8,0,3,5,8,-104.9316177,37.92366791
226,"RYE NY",6,2,0,0,2,2,-73.68312836,40.98072433
226,"SACHSE TX",6,5,3,0,2,5,-96.59605408,32.97636795
226,"SACKETS HARBOR NY",6,1,1,0,0,1,-76.12520599,43.94608688
226,"SACO ME",6,2,1,1,0,2,-70.4417038,43.50106049
226,"SACRAMENTO CA",6,1058,283,262,513,1058,-121.4959793,38.58154297
226,"SADDLE BROOK NJ",6,6,2,0,4,6,-74.09207153,40.89922333
226,"SAEGERTOWN PA",6,1,0,1,0,1,-80.14733124,41.71915817
226,"SAGAMORE HILLS OH",6,2,0,1,1,2,-81.56762695,41.31193924
226,"SAGINAW MI",6,18,1,8,9,18,-83.95076752,43.41968918
226,"SAGINAW TX",6,9,2,3,4,9,-97.36431885,32.86053848
226,"SAHUARITA AZ",6,92,25,22,45,92,-110.9567032,31.95795059
226,"SALEM IL",6,38,12,10,16,38,-88.94590759,38.62715149
226,"SALEM IN",6,2,1,0,1,2,-86.10127258,38.60612488
226,"SALEM MA",6,63,20,15,28,63,-70.89565277,42.51993179
226,"SALEM NH",6,3,0,0,3,3,-71.19998169,42.78861618
226,"SALEM NJ",6,3,0,2,1,3,-75.46625519,39.5720787
226,"SALEM OH",6,1,1,0,0,1,-80.85612488,40.90091705
226,"SALEM OR",6,135,31,39,65,135,-123.0377197,44.94248199
226,"SALEM VA",6,2,0,0,2,2,-80.05405426,37.29384232
226,"SALINA KS",6,10,1,4,5,10,-97.61184692,38.84041977
226,"SALINAS CA",6,164,41,52,71,164,-121.6571732,36.67780304
226,"SALINE MI",6,1,0,1,0,1,-83.78155518,42.16699982
226,"SALISBURY MD",6,42,14,10,18,42,-75.5984726,38.36100388
226,"SALISBURY NC",6,9,2,4,3,9,-80.47377014,35.67113495
226,"SALT LAKE CITY UT",6,559,158,141,260,559,-111.8912659,40.77029037
226,"SALTILLO MS",6,1,1,0,0,1,-88.68186188,34.37690353
226,"SALUDA SC",6,2,0,1,1,2,-81.77184296,34.00602722
226,"SAN ANGELO TX",6,26,5,6,15,26,-100.4379044,31.46401215
226,"SAN ANSELMO CA",6,4,2,1,1,4,-122.5641785,37.97429276
226,"SAN ANTONIO TX",6,1776,476,455,845,1776,-98.49394989,29.42439651
226,"SAN BENITO TX",6,10,2,3,5,10,-97.63174438,26.1331501
226,"SAN BERNARDINO CA",6,88,24,23,41,88,-117.304596,34.12142563
226,"SAN BRUNO CA",6,1,0,1,0,1,-122.4133148,37.63018799
226,"SAN CARLOS CA",6,33,4,6,23,33,-122.262207,37.50718307
226,"SAN CLEMENTE CA",6,13,4,2,7,13,-117.6134033,33.42698669
226,"SAN DIEGO CA",6,2487,723,664,1100,2487,-117.1587296,32.71524429
226,"SAN DIMAS CA",6,6,2,1,3,6,-117.8088913,34.10668945
226,"SAN FRANCISCO CA",6,3916,1089,1099,1728,3916,-122.4213257,37.77465057
226,"SAN GABRIEL CA",6,3,1,2,0,3,-118.107605,34.09612274
226,"SAN JACINTO CA",6,2,1,0,1,2,-116.9603272,33.78380585
226,"SAN JOSE CA",6,676,185,157,334,676,-121.8973846,37.33491516
226,"SAN JUAN CAPISTRANO CA",6,4,2,0,2,4,-117.6644516,33.50197601
226,"SAN LEANDRO CA",6,29,10,9,10,29,-122.155983,37.70180511
226,"SAN LUIS OBISPO CA",6,66,9,20,37,66,-120.6622849,35.28281021
226,"SAN MARCOS CA",6,40,12,10,18,40,-117.1673966,33.14345551
226,"SAN MARCOS TX",6,212,53,65,94,212,-97.94176483,29.88363266
226,"SAN MATEO CA",6,61,23,17,21,61,-122.3270264,37.56283569
226,"SAN PABLO CA",6,3,0,2,1,3,-122.3469696,37.96184921
226,"SAN RAFAEL CA",6,34,13,7,14,34,-122.5331726,37.97325134
226,"SAN RAMON CA",6,48,13,16,19,48,-121.9799347,37.77985764
226,"SAND SPRINGS OK",6,4,0,1,3,4,-96.10940552,36.13979721
226,"SANDPOINT ID",6,2,0,1,1,2,-116.5548554,48.27656555
226,"SANDUSKY OH",6,1,0,1,0,1,-82.7080307,41.44903183
226,"SANDY OR",6,3,1,1,1,3,-122.263649,45.39704132
226,"SANDY SPRINGS GA",6,15,6,4,5,15,-84.37850952,33.92443848
226,"SANFORD FL",6,38,13,8,17,38,-81.27256012,28.80128288
226,"SANFORD ME",6,5,0,0,5,5,-70.77335358,43.43920135
226,"SANFORD MI",6,4,1,0,3,4,-84.38056946,43.67271042
226,"SANFORD NC",6,8,5,2,1,8,-79.17978668,35.4800415
226,"SANGER CA",6,2,0,1,1,2,-119.5580063,36.70794296
226,"SANTA ANA CA",6,76,20,18,38,76,-117.8697281,33.74567413
226,"SANTA BARBARA CA",6,227,67,61,99,227,-119.7056656,34.4233017
226,"SANTA CLARA CA",6,75,18,24,33,75,-121.946434,37.34754181
226,"SANTA CRUZ CA",6,196,56,55,85,196,-122.0333557,36.97389984
226,"SANTA FE NM",6,182,41,49,92,182,-105.9468155,35.68014526
226,"SANTA FE SPRINGS CA",6,1,0,0,1,1,-118.0864639,33.94723129
226,"SANTA MARIA CA",6,13,2,3,8,13,-120.437973,34.95292664
226,"SANTA MONICA CA",6,383,108,94,181,383,-118.4925232,34.01921082
226,"SANTA PAULA CA",6,8,1,4,3,8,-119.0609283,34.35404587
226,"SANTA ROSA CA",6,147,38,43,66,147,-122.7165146,38.44017792
226,"SANTAQUIN UT",6,1,0,0,1,1,-111.7862549,39.97566605
226,"SARALAND AL",6,1,0,1,0,1,-88.07051086,30.82098389
226,"SARANAC LAKE NY",6,18,4,4,10,18,-74.1305542,44.32965851
226,"SARASOTA FL",6,73,25,11,37,73,-82.53031158,27.33688736
226,"SARATOGA CA",6,8,0,2,6,8,-122.0252457,37.26384735
226,"SARATOGA SPRINGS NY",6,36,5,11,20,36,-73.78382111,43.08345032
226,"SARCOXIE MO",6,2,0,2,0,2,-94.11733246,37.06952286
226,"SARTELL MN",6,2,2,0,0,2,-94.20728302,45.62141418
226,"SATELLITE BEACH FL",6,2,2,0,0,2,-80.58939362,28.17677498
226,"SAUGATUCK MI",6,6,1,1,4,6,-86.2021637,42.65496826
226,"SAUGERTIES NY",6,13,3,4,6,13,-73.95199585,42.07786942
226,"SAUGUS MA",6,2,1,1,0,2,-71.00926971,42.46496964
226,"SAUK CITY WI",6,1,1,0,0,1,-89.72237396,43.27073669
226,"SAUK VILLAGE IL",6,1,0,1,0,1,-87.56780243,41.48827362
226,"SAUKVILLE WI",6,1,1,0,0,1,-87.94111633,43.38184738
226,"SAUSALITO CA",6,3,1,2,0,3,-122.4881592,37.85736847
226,"SAVAGE MN",6,1,0,0,1,1,-93.33673096,44.7649498
226,"SAVANNA OK",6,1,0,0,1,1,-95.8442688,34.82937241
226,"SAVANNAH GA",6,227,67,51,109,227,-81.09463501,32.07280731
226,"SAVOY IL",6,1,0,0,1,1,-88.25175476,40.05500793
226,"SAYREVILLE NJ",6,5,0,2,3,5,-74.36043549,40.45940018
226,"SCARSDALE NY",6,3,0,1,2,3,-73.78360748,41.00525665
226,"SCHAUMBURG IL",6,19,3,8,8,19,-88.08359528,42.03350449
226,"SCHENECTADY NY",6,10,4,3,3,10,-73.938591,42.81433487
226,"SCHERERVILLE IN",6,6,1,3,2,6,-87.44911957,41.49306488
226,"SCHOFIELD WI",6,3,1,1,1,3,-89.60473633,44.90977859
226,"SCHULENBURG TX",6,1,1,0,0,1,-96.90359497,29.68226433
226,"SCHUYLKILL HAVEN PA",6,2,0,1,1,2,-76.17021942,40.63098145
226,"SCOOBA MS",6,1,0,0,1,1,-88.47669983,32.82835388
226,"SCOTCH PLAINS NJ",6,4,2,1,1,4,-74.38912964,40.65579605
226,"SCOTLAND NECK NC",6,2,0,0,2,2,-77.41972351,36.12969589
226,"SCOTTSBLUFF NE",6,68,18,11,39,68,-103.6682434,41.86663818
226,"SCOTTSBORO AL",6,2,1,0,1,2,-86.03386688,34.67259216
226,"SCOTTSBURG IN",6,1,0,0,1,1,-85.77010345,38.68574142
226,"SCOTTSDALE AZ",6,126,43,31,52,126,-111.9002533,33.50918579
226,"SCOTTSVILLE TX",6,1,0,1,0,1,-94.23889923,32.54086304
226,"SCRANTON PA",6,54,10,18,26,54,-75.66184998,41.40919113
226,"SCRANTON SC",6,1,0,0,1,1,-79.7436142,33.91777802
226,"SEABROOK TX",6,5,2,0,3,5,-95.02601624,29.56442451
226,"SEAFORD DE",6,12,6,1,5,12,-75.61972809,38.64723206
226,"SEAGOVILLE TX",6,1,0,1,0,1,-96.53910828,32.63978958
226,"SEALY TX",6,1,1,0,0,1,-96.15762329,29.78135109
226,"SEARCY AR",6,13,4,4,5,13,-91.73634338,35.25092697
226,"SEARSPORT ME",6,1,0,1,0,1,-68.92290497,44.45871353
226,"SEASIDE CA",6,11,2,5,4,11,-121.8542252,36.6110611
226,"SEAT PLEASANT MD",6,5,4,0,1,5,-76.90610504,38.8963623
226,"SEATTLE WA",6,5881,1716,1639,2526,5881,-122.3343964,47.60571289
226,"SEBASTOPOL CA",6,9,0,2,7,9,-122.8264999,38.40188217
226,"SEBRING FL",6,2,0,0,2,2,-81.4406662,27.49625397
226,"SECAUCUS NJ",6,1,0,1,0,1,-74.05567169,40.78977585
226,"SEDALIA MO",6,4,1,0,3,4,-93.22884369,38.70438766
226,"SEDONA AZ",6,8,3,3,2,8,-111.7623367,34.86959839
226,"SEGUIN TX",6,15,1,5,9,15,-97.96529388,29.56933594
226,"SELBYVILLE DE",6,1,0,0,1,1,-75.22740173,38.45663452
226,"SELINSGROVE PA",6,1,0,1,0,1,-76.86167145,40.79915619
226,"SELLERSBURG IN",6,3,0,0,3,3,-85.75473785,38.39831543
226,"SELMA AL",6,6,2,0,4,6,-87.02119446,32.40768433
226,"SELMA CA",6,3,1,2,0,3,-119.6140518,36.57050323
226,"SELMA NC",6,1,1,0,0,1,-78.28382874,35.53673172
226,"SEMINOLE FL",6,4,1,1,2,4,-82.79083252,27.84035683
226,"SEMMES AL",6,1,0,1,0,1,-88.25917053,30.7788372
226,"SENATOBIA MS",6,5,3,2,0,5,-89.96900177,34.61786652
226,"SENECA FALLS NY",6,1,1,0,0,1,-76.79602814,42.91084671
226,"SENECA SC",6,10,3,2,5,10,-82.95318604,34.68600845
226,"SENOIA GA",6,1,1,0,0,1,-84.55380249,33.30273819
226,"SEVIERVILLE TN",6,7,1,2,4,7,-83.56149292,35.86820984
226,"SEWICKLEY PA",6,3,1,1,1,3,-80.18386078,40.5364151
226,"SEYMOUR CT",6,4,0,1,3,4,-73.0753479,41.39679718
226,"SHAFTER CA",6,9,2,2,5,9,-119.2740555,35.50065613
226,"SHAKER HEIGHTS OH",6,80,16,22,42,80,-81.53669739,41.47419357
226,"SHAKOPEE MN",6,17,6,6,5,17,-93.52770233,44.79788971
226,"SHALLOTTE NC",6,1,0,0,1,1,-78.38527679,33.97378159
226,"SHARON MA",6,8,5,0,3,8,-71.17311096,42.12431335
226,"SHARON PA",6,4,1,1,2,4,-80.49273682,41.2334137
226,"SHARONVILLE OH",6,1,0,0,1,1,-84.41338348,39.26810455
226,"SHARPSBURG NC",6,1,1,0,0,1,-77.82837677,35.86738205
226,"SHAWNEE KS",6,61,14,21,26,61,-94.7208786,39.0417366
226,"SHAWNEE OK",6,8,4,1,3,8,-96.92608643,35.32754898
226,"SHEBOYGAN WI",6,25,7,4,14,25,-87.71476746,43.75089264
226,"SHEFFIELD AL",6,1,0,0,1,1,-87.69856262,34.76504517
226,"SHEFFIELD LAKE OH",6,1,0,0,1,1,-82.10116577,41.48757935
226,"SHELBY IA",6,7,0,2,5,7,-95.45110321,41.51625061
226,"SHELBY MI",6,1,1,0,0,1,-86.36434174,43.60855484
226,"SHELBY NC",6,10,6,2,2,10,-81.53518677,35.29262543
226,"SHELBYVILLE IL",6,1,0,1,0,1,-88.78992462,39.40638733
226,"SHELBYVILLE IN",6,4,1,0,3,4,-85.77182007,39.5215683
226,"SHELBYVILLE KY",6,5,2,2,1,5,-85.22341156,38.21203232
226,"SHELTON CT",6,3,1,0,2,3,-73.09243011,41.31684494
226,"SHELTON WA",6,1,1,0,0,1,-123.0995026,47.21501923
226,"SHEPHERD TX",6,1,0,1,0,1,-94.99694824,30.49860954
226,"SHERIDAN WY",6,1,0,1,0,1,-106.9579773,44.7972641
226,"SHERMAN TX",6,12,6,2,4,12,-96.60933685,33.63597488
226,"SHERWOOD AR",6,10,3,2,5,10,-92.22438049,34.81515884
226,"SHERWOOD OR",6,6,2,1,3,6,-122.8425446,45.35624313
226,"SHERWOOD WI",6,2,0,1,0,1,-89.30547333,44.311050415
226,"SHIPPENSBURG PA",6,6,3,2,1,6,-77.51955414,40.05068207
226,"SHIPSHEWANA IN",6,1,0,0,1,1,-85.58047485,41.67308807
226,"SHIVELY KY",6,12,2,3,7,12,-85.82255554,38.20013809
226,"SHOREVIEW MN",6,4,2,2,0,4,-93.1241684,45.06987762
226,"SHOREWOOD IL",6,9,5,3,1,9,-88.201828,41.52030182
226,"SHOREWOOD WI",6,1,1,0,0,1,-87.88748932,43.08912277
226,"SHREVEPORT LA",6,113,37,27,49,113,-93.7507019,32.52565002
226,"SIDNEY NE",6,1,0,1,0,1,-102.9793778,41.14286041
226,"SIERRA MADRE CA",6,13,4,2,7,13,-118.0547943,34.16183853
226,"SIERRA VISTA AZ",6,8,4,1,3,8,-110.3048325,31.55449295
226,"SIKESTON MO",6,6,1,2,3,6,-89.5878067,36.87693024
226,"SILOAM SPRINGS AR",6,13,4,3,6,13,-94.54097748,36.18841934
226,"SILSBEE TX",6,1,0,0,1,1,-94.17839813,30.34930038
226,"SILVER CITY NM",6,2,1,0,1,2,-108.281929,32.77336884
226,"SILVERTON OH",6,2,0,1,1,2,-84.4001236,39.19305038
226,"SILVERTON OR",6,2,1,1,0,2,-122.7857742,45.00499725
226,"SIMI VALLEY CA",6,39,14,4,21,39,-118.7839508,34.26951981
226,"SIMPSONVILLE SC",6,4,0,1,3,4,-82.25405121,34.73744202
226,"SIMSBURY CT",6,1,1,0,0,1,-72.8000412,41.8762207
226,"SIOUX CENTER IA",6,9,3,0,6,9,-96.17614746,43.0798111
226,"SIOUX CITY IA",6,33,12,7,14,33,-96.40085602,42.5001564
226,"SIOUX FALLS SD",6,123,33,32,58,123,-96.73429108,43.54177475
226,"SISSETON SD",6,2,1,1,0,2,-97.052948,45.66472244
226,"SISTER BAY WI",6,1,0,0,1,1,-87.12120819,45.19202423
226,"SKANEATELES NY",6,1,1,0,0,1,-76.42854309,42.94717026
226,"SKIATOOK OK",6,1,1,0,0,1,-96.00171661,36.36858749
226,"SKOKIE IL",6,14,5,4,5,14,-87.73321533,42.03328705
226,"SLEEPY EYE MN",6,1,0,1,0,1,-94.72470093,44.29698563
226,"SLIDELL LA",6,29,12,11,6,29,-89.78143311,30.27558708
226,"SLIPPERY ROCK PA",6,2,1,1,0,2,-80.05516052,41.06407928
226,"SLOATSBURG NY",6,2,2,0,0,2,-74.19187164,41.15483475
226,"SMITHFIELD NC",6,1,0,1,0,1,-78.33872223,35.50891876
226,"SMITHSBURG MD",6,1,0,1,0,1,-77.57201385,39.65513611
226,"SMITHVILLE MO",6,7,1,1,5,7,-94.58171082,39.38669586
226,"SMITHVILLE TN",6,3,1,0,2,3,-85.81411743,35.96058273
226,"SMYRNA DE",6,1,0,0,1,1,-75.60120392,39.30263519
226,"SMYRNA GA",6,25,4,8,13,25,-84.51447296,33.88409042
226,"SMYRNA TN",6,17,6,4,7,17,-86.51843262,35.98318863
226,"SNOHOMISH WA",6,6,2,2,2,6,-122.1009903,47.91241837
226,"SNOQUALMIE WA",6,2,0,0,2,2,-121.8274155,47.52823257
226,"SNOW HILL NC",6,7,2,2,3,7,-77.68035889,35.45199203
226,"SOCIAL CIRCLE GA",6,1,0,0,1,1,-83.71785736,33.65628433
226,"SOCORRO NM",6,2,0,2,0,2,-106.8982925,34.06193924
226,"SOLANA BEACH CA",6,36,14,8,14,36,-117.2725525,32.99123383
226,"SOLEDAD CA",6,1,1,0,0,1,-121.3278732,36.42473984
226,"SOLON OH",6,1,0,1,0,1,-81.44110107,41.3899231
226,"SOMERDALE NJ",6,1,0,0,1,1,-75.02175903,39.8440094
226,"SOMERS WI",6,1,0,1,0,1,-87.9103775,42.64015579
226,"SOMERSET PA",6,1,1,0,0,1,-79.0776825,40.00854874
226,"SOMERTON AZ",6,3,1,1,1,3,-114.7113113,32.59666443
226,"SOMERVILLE MA",6,373,106,95,172,373,-71.09860992,42.38757324
226,"SOMERVILLE NJ",6,1,0,1,0,1,-74.60894775,40.57460785
226,"SONOMA CA",6,25,5,8,12,25,-122.4600754,38.29153061
226,"SONORA CA",6,19,6,4,9,19,-120.3842011,37.98400497
226,"SOUDERTON PA",6,1,1,0,0,1,-75.32456207,40.31177902
226,"SOUTH AMBOY NJ",6,2,1,0,1,2,-74.28966522,40.47789383
226,"SOUTH BELOIT IL",6,1,1,0,0,1,-89.03701782,42.49333191
226,"SOUTH BEND IN",6,132,40,36,56,132,-86.25171661,41.67295837
226,"SOUTH BURLINGTON VT",6,1,0,1,0,1,-73.17012787,44.46702576
226,"SOUTH CHARLESTON WV",6,1,1,0,0,1,-81.69944763,38.36863708
226,"SOUTH ELGIN IL",6,2,0,0,2,2,-88.29248047,41.99429321
226,"SOUTH EUCLID OH",6,2,0,1,1,2,-81.51824188,41.5230751
226,"SOUTH GATE CA",6,31,5,7,19,31,-118.213707,33.95462799
226,"SOUTH HADLEY MA",6,3,2,1,0,3,-72.57582855,42.26013184
226,"SOUTH HOLLAND IL",6,1,1,0,0,1,-87.60710144,41.60099792
226,"SOUTH JORDAN UT",6,6,1,3,2,6,-111.9315186,40.56394577
226,"SOUTH LAKE TAHOE CA",6,17,4,7,6,17,-119.972786,38.94574356
226,"SOUTH LYON MI",6,6,2,2,2,6,-83.65129089,42.46051788
226,"SOUTH MIAMI FL",6,1,0,1,0,1,-80.29296875,25.70849991
226,"SOUTH MILWAUKEE WI",6,1,0,0,1,1,-87.86100006,42.91051483
226,"SOUTH NYACK NY",6,4,2,1,1,4,-73.91947937,41.08323288
226,"SOUTH PASADENA CA",6,2,1,1,0,2,-118.1516647,34.11618805
226,"SOUTH PITTSBURG TN",6,2,1,1,0,2,-85.70410156,35.01231766
226,"SOUTH PLAINFIELD NJ",6,18,4,4,10,18,-74.41103363,40.57961655
226,"SOUTH PORTLAND ME",6,2,0,0,2,2,-70.23975372,43.6415062
226,"SOUTH RIVER NJ",6,8,2,4,2,8,-74.38522339,40.44672394
226,"SOUTH SALT LAKE UT",6,5,0,1,4,5,-111.8901367,40.71858215
226,"SOUTH SAN FRANCISCO CA",6,21,7,5,9,21,-122.4101868,37.65430069
226,"SOUTH TUCSON AZ",6,1,0,0,1,1,-110.9697952,32.19969177
226,"SOUTH WHITLEY IN",6,1,0,0,1,1,-85.62773895,41.08475113
226,"SOUTHAMPTON NY",6,60,16,19,25,60,-72.38861084,40.88444519
226,"SOUTHAMPTON PA",6,5,1,2,2,5,-75.04278564,40.17464447
226,"SOUTHAVEN MS",6,7,1,2,4,7,-90.02496338,34.99386215
226,"SOUTHBOROUGH MA",6,1,1,0,0,1,-71.52334595,42.30595398
226,"SOUTHFIELD MI",6,32,11,7,14,32,-83.22153473,42.47357559
226,"SOUTHGATE MI",6,11,4,5,2,11,-83.19342804,42.2142067
226,"SOUTHINGTON CT",6,22,5,3,14,22,-72.8768158,41.59680557
226,"SOUTHLAKE TX",6,2,2,0,0,2,-97.13466644,32.94153214
226,"SOUTHPORT NC",6,1,0,1,0,1,-78.01985931,33.9217453
226,"SOUTHWICK MA",6,6,2,1,3,6,-72.76921844,42.05488205
226,"SPANISH FORK UT",6,1,0,0,1,1,-111.6517334,40.11501312
226,"SPARKS NV",6,11,0,6,5,11,-119.7548142,39.53468704
226,"SPARTA TN",6,3,1,0,2,3,-85.46425629,35.9259491
226,"SPARTANBURG SC",6,126,35,30,61,126,-81.93160248,34.94982529
226,"SPEARFISH SD",6,4,0,0,4,4,-103.8635941,44.49181366
226,"SPEEDWAY IN",6,34,10,9,15,34,-86.2671051,39.80224609
226,"SPENCER IA",6,2,1,1,0,2,-95.14494324,43.14133835
226,"SPENCER MA",6,1,0,1,0,1,-71.98745728,42.24233246
226,"SPENCER TN",6,1,0,0,1,1,-85.46665192,35.74720764
226,"SPIRO OK",6,2,0,0,2,2,-94.62031555,35.24132538
226,"SPOKANE WA",6,235,67,65,103,235,-117.4281387,47.65847015
226,"SPOTSWOOD NJ",6,1,1,0,0,1,-74.39738464,40.39186096
226,"SPRING HILL TN",6,19,4,8,7,19,-86.93003845,35.75111389
226,"SPRING LAKE HEIGHTS NJ",6,1,0,1,0,1,-74.03012848,40.1507225
226,"SPRING LAKE MI",6,2,1,1,0,2,-86.19725037,43.07686234
226,"SPRING VALLEY NY",6,2,1,0,1,2,-74.04323578,41.11329269
226,"SPRINGDALE AR",6,21,9,3,9,21,-94.12921143,36.1869278
226,"SPRINGFIELD IL",6,163,48,39,76,163,-89.6439743,39.80184174
226,"SPRINGFIELD KY",6,1,1,0,0,1,-85.22190857,37.68533707
226,"SPRINGFIELD MA",6,65,18,20,27,65,-72.57289124,42.10980606
226,"SPRINGFIELD MO",6,510,158,125,227,510,-93.29862213,37.21548843
226,"SPRINGFIELD OH",6,2,1,1,0,2,-83.80889893,39.92424011
226,"SPRINGFIELD OR",6,8,1,0,7,8,-123.024704,44.04590988
226,"SPRINGFIELD TN",6,4,1,1,2,4,-86.88502502,36.50941086
226,"SPRINGFIELD VT",6,18,2,4,12,18,-72.48161316,43.29873657
226,"SPRINGVILLE UT",6,1,0,1,0,1,-111.6123734,40.16522598
226,"ST LOUIS MO",6,11994,3993,2769,5232,11994,-90.19819641,38.62716675
226,"STAMFORD CT",6,63,18,17,28,63,-73.53807068,41.05353165
226,"STAMFORD TX",6,1,1,0,0,1,-99.80379486,32.94544601
226,"STANLEY ID",6,1,1,0,0,1,-114.9478149,44.21094131
226,"STANLEY LA",6,1,0,1,0,1,-93.89855957,31.96143341
226,"STANLEY NC",6,1,0,1,0,1,-81.09666443,35.35927582
226,"STANTON CA",6,4,1,0,3,4,-117.9945526,33.80238724
226,"STANTON KY",6,5,1,1,3,5,-83.85791779,37.84600449
226,"STAR ID",6,3,0,1,2,3,-116.495697,43.69187927
226,"STARKE FL",6,9,2,2,5,9,-82.10956573,29.94442368
226,"STARKVILLE MS",6,32,7,12,13,32,-88.81492615,33.46545029
226,"STATE COLLEGE PA",6,89,27,22,40,89,-77.85973358,40.79336929
226,"STATESBORO GA",6,67,18,17,32,67,-81.78266907,32.44914246
226,"STATESVILLE NC",6,8,0,4,4,8,-80.88671875,35.78310013
226,"STATHAM GA",6,2,0,0,2,2,-83.59605408,33.96524429
226,"STAUNTON VA",6,16,3,6,7,16,-79.07145691,38.14970016
226,"STAYTON OR",6,1,1,0,0,1,-122.7968597,44.8002739
226,"STEAMBOAT SPRINGS CO",6,13,3,5,5,13,-106.8292313,40.48627853
226,"STEELVILLE MO",6,1,1,0,0,1,-91.35505676,37.96838379
226,"STEILACOOM WA",6,9,2,1,6,9,-122.6048813,47.16923141
226,"STEPHENVILLE TX",6,13,5,3,5,13,-98.20308685,32.22081757
226,"STERLING HEIGHTS MI",6,3,1,0,2,3,-83.03016663,42.58047485
226,"STERLING IL",6,4,0,4,0,4,-89.69670868,41.78865433
226,"STEUBENVILLE OH",6,7,1,2,4,7,-80.63353729,40.36983871
226,"STEVENS POINT WI",6,61,20,17,24,61,-89.57467651,44.52337265
226,"STILLWATER MN",6,8,1,2,5,8,-92.80657959,45.05171967
226,"STILLWATER OK",6,27,6,8,13,27,-97.0588913,36.11580658
226,"STILWELL OK",6,2,2,0,0,2,-94.62871552,35.81448746
226,"STOCKBRIDGE GA",6,13,3,4,6,13,-84.23356628,33.54455185
226,"STOCKTON CA",6,119,28,37,54,119,-121.293457,37.95776749
226,"STONE MOUNTAIN GA",6,58,17,17,24,58,-84.14538574,33.8065033
226,"STONE PARK IL",6,1,1,0,0,1,-87.88384247,41.90581894
226,"STONEHAM MA",6,5,2,1,2,5,-71.09869385,42.48027039
226,"STORM LAKE IA",6,2,1,0,1,2,-95.20105743,42.64270401
226,"STORY CITY IA",6,2,2,0,0,2,-93.59599304,42.18712616
226,"STOUGHTON MA",6,6,3,0,3,6,-71.10134888,42.12547302
226,"STOW OH",6,12,3,2,7,12,-81.44025421,41.1593895
226,"STOWE VT",6,4,2,1,1,4,-72.68366241,44.46540451
226,"STRATFORD CT",6,1,0,0,1,1,-73.13223267,41.18459702
226,"STRUTHERS OH",6,5,2,2,1,5,-80.59054565,41.05240631
226,"STUART FL",6,23,10,6,7,23,-80.25237274,27.19645882
226,"STUART VA",6,3,1,1,1,3,-80.26490784,36.64115906
226,"STURGEON BAY WI",6,1,0,0,1,1,-87.37574005,44.83692169
226,"STURGIS KY",6,2,0,1,1,2,-87.98410797,37.54692459
226,"STURGIS MI",6,1,0,0,1,1,-85.41933441,41.7995491
226,"STURGIS SD",6,1,0,1,0,1,-103.5133972,44.41167831
226,"SUFFOLK VA",6,44,12,13,19,44,-76.58317566,36.72846985
226,"SUGAR HILL GA",6,6,2,1,3,6,-84.03327179,34.10667801
226,"SUGAR LAND TX",6,21,3,10,8,21,-95.6352005,29.61997795
226,"SULLIVAN MO",6,4,0,0,4,4,-91.16096497,38.20802689
226,"SULPHUR SPRINGS TX",6,8,2,0,6,8,-95.60125732,33.13871002
226,"SUMMERDALE AL",6,1,0,0,1,1,-87.69980621,30.48824692
226,"SUMMERSVILLE WV",6,2,1,0,1,2,-80.85063171,38.27550125
226,"SUMMERVILLE SC",6,32,9,11,12,32,-80.17547607,33.01868439
226,"SUMMIT IL",6,4,1,0,3,4,-87.81018066,41.78816223
226,"SUMMIT NJ",6,1,0,0,1,1,-74.3586731,40.74148178
226,"SUMNER WA",6,4,2,1,1,4,-122.2424011,47.20277405
226,"SUMTER SC",6,12,1,1,10,12,-80.34135437,33.92088318
226,"SUN PRAIRIE WI",6,4,4,0,0,4,-89.21392059,43.18373108
226,"SUN VALLEY ID",6,4,3,1,0,4,-114.3539352,43.69688034
226,"SUNNYVALE CA",6,134,39,34,61,134,-122.0380707,37.36878967
226,"SUNNYVALE TX",6,2,0,2,0,2,-96.56118774,32.7967453
226,"SUNRISE FL",6,26,9,2,15,26,-80.2282486,26.14059067
226,"SUPERIOR CO",6,7,4,1,2,7,-105.169548,39.95254517
226,"SUPERIOR WI",6,2,0,0,2,2,-92.10461426,46.72050476
226,"SURF CITY NC",6,7,1,3,3,7,-77.54553986,34.42726898
226,"SURFSIDE BEACH SC",6,3,1,2,0,3,-78.97283173,33.6062355
226,"SURFSIDE FL",6,9,1,3,5,9,-80.12493134,25.87931252
226,"SUTHERLIN OR",6,3,2,0,1,3,-123.3144531,43.38960648
226,"SUWANEE GA",6,10,3,0,7,10,-84.0713501,34.05178452
226,"SWANSBORO NC",6,1,0,0,1,1,-77.12390137,34.68983078
226,"SWANSEA IL",6,4,1,1,2,4,-89.98918152,38.53406143
226,"SWARTHMORE PA",6,6,2,2,2,6,-75.34899139,39.90222549
226,"SWARTZ CREEK MI",6,1,1,0,0,1,-83.8306427,42.95724869
226,"SWEENY TX",6,4,0,3,1,4,-95.69893646,29.03920364
226,"SWEETWATER TX",6,2,1,1,0,2,-100.4070358,32.47128296
226,"SYCAMORE IL",6,2,0,1,1,2,-88.68714142,41.98875427
226,"SYKESVILLE MD",6,3,1,0,2,3,-76.96707916,39.37390518
226,"SYLVANIA OH",6,5,2,1,2,5,-83.71266174,41.71902466
226,"SYLVESTER GA",6,1,0,0,1,1,-83.83532715,31.53106117
226,"SYRACUSE NY",6,522,154,142,226,522,-76.14653015,43.04846191
226,"TACOMA WA",6,606,169,166,271,606,-122.4466705,47.25242233
226,"TAFT TX",6,1,0,1,0,1,-97.39922333,27.97969055
226,"TAHLEQUAH OK",6,7,1,3,3,7,-94.9703064,35.91559982
226,"TAKOMA PARK MD",6,31,12,8,11,31,-77.00667572,38.97793198
226,"TALLADEGA AL",6,9,2,2,5,9,-86.10553741,33.43610001
226,"TALLAHASSEE FL",6,517,134,146,237,517,-84.27896881,30.44669914
226,"TALLULAH LA",6,1,0,0,1,1,-91.18704987,32.40855789
226,"TAMAQUA PA",6,1,0,0,1,1,-75.96853638,40.79745102
226,"TAMARAC FL",6,13,3,2,8,13,-80.22389984,26.19458199
226,"TAMPA FL",6,1756,485,464,807,1756,-82.4580307,27.94833755
226,"TANANA AK",6,3,0,0,3,3,-152.0746002,65.16492462
226,"TAOS NM",6,46,19,9,18,46,-105.5769424,36.40658188
226,"TARBORO NC",6,2,2,0,0,2,-77.5349884,35.89706039
226,"TARPON SPRINGS FL",6,29,7,12,10,29,-82.75656128,28.14682198
226,"TARRYTOWN NY",6,1,1,0,0,1,-73.85806274,41.07656097
226,"TAUNTON MA",6,5,1,1,3,5,-71.08903503,41.900177
226,"TAVARES FL",6,1,0,0,1,1,-81.72516632,28.80491257
226,"TAYLOR MI",6,5,2,1,2,5,-83.26967621,42.24112701
226,"TAYLOR TX",6,1,0,0,1,1,-97.41002655,30.57122421
226,"TAYLORSVILLE KY",6,1,1,0,0,1,-85.34210968,38.03184128
226,"TAYLORVILLE IL",6,4,2,1,1,4,-89.29446411,39.5492363
226,"TAZEWELL VA",6,1,0,1,0,1,-81.51947021,37.11498642
226,"TEA SD",6,15,3,1,11,15,-96.83795166,43.44678497
226,"TEANECK NJ",6,20,5,6,9,20,-74.01485443,40.89759064
226,"TECUMSEH KS",6,4,1,1,2,4,-95.57958984,39.04811478
226,"TECUMSEH MI",6,9,3,3,3,9,-83.94480133,42.00404358
226,"TEHACHAPI CA",6,2,0,2,0,2,-118.4508972,35.132164
226,"TELLURIDE CO",6,1,1,0,0,1,-107.8138123,37.93754578
226,"TEMECULA CA",6,31,7,7,17,31,-117.1428146,33.48790741
226,"TEMPE AZ",6,390,108,105,177,390,-111.9108276,33.41504288
226,"TEMPLE CITY CA",6,5,1,3,1,5,-118.0596924,34.10735321
226,"TEMPLE TX",6,65,18,16,31,65,-97.34354401,31.09850502
226,"TENAFLY NJ",6,4,2,2,0,4,-73.9623642,40.92551041
226,"TERRE HAUTE IN",6,52,13,8,31,52,-87.41414642,39.46681976
226,"TEWKSBURY MA",6,34,8,8,18,34,-71.23313904,42.61103439
226,"TEXARKANA AR",6,2,1,0,1,2,-94.03818512,33.44210052
226,"TEXARKANA TX",6,11,1,6,4,11,-94.04785156,33.42536545
226,"TEXAS CITY TX",6,1,1,0,0,1,-94.90317535,29.38432312
226,"THE DALLES OR",6,1,1,0,0,1,-121.1804581,45.59422684
226,"THE VILLAGE OK",6,4,2,1,1,4,-97.55195618,35.56108093
226,"THIBODAUX LA",6,6,3,2,1,6,-90.82309723,29.79626465
226,"THIEF RIVER FALLS MN",6,1,0,0,1,1,-96.18167114,48.11899567
226,"THOMASTON GA",6,1,0,0,1,1,-84.32656097,32.888237
226,"THOMASVILLE AL",6,1,0,0,1,1,-87.73569489,31.91395187
226,"THOMASVILLE GA",6,4,2,1,1,4,-83.97835541,30.8371582
226,"THOMASVILLE NC",6,6,2,2,2,6,-80.08161163,35.88302994
226,"THOMSON GA",6,1,0,0,1,1,-82.50429535,33.47103119
226,"THORNTON CO",6,58,12,19,27,58,-104.9727631,39.86811829
226,"THOUSAND OAKS CA",6,28,9,7,12,28,-118.8398514,34.17078018
226,"THREE OAKS MI",6,3,1,1,1,3,-86.61090088,41.7985611
226,"THREE RIVERS MI",6,2,0,2,0,2,-85.63246918,41.94419861
226,"THREE RIVERS TX",6,6,1,1,4,6,-98.17991638,28.46170235
226,"TIBURON CA",6,9,0,3,6,9,-122.4590607,37.87349701
226,"TIFFIN IA",6,1,0,0,1,1,-91.66307831,41.70594788
226,"TIFFIN OH",6,4,0,2,2,4,-83.17781067,41.11477661
226,"TIGARD OR",6,14,4,5,5,14,-122.7737198,45.4310112
226,"TINLEY PARK IL",6,1,0,0,1,1,-87.78465271,41.57352448
226,"TIPP CITY OH",6,3,1,2,0,3,-84.17195892,39.95846939
226,"TIPTON IN",6,1,0,0,1,1,-86.0413208,40.28222275
226,"TITUSVILLE FL",6,4,1,1,2,4,-80.80722809,28.61296272
226,"TITUSVILLE PA",6,4,1,0,3,4,-79.67320251,41.62724304
226,"TOCCOA GA",6,1,1,0,0,1,-83.33230591,34.5774498
226,"TOLEDO OH",6,223,56,57,110,223,-83.55497742,41.66411591
226,"TOLLESON AZ",6,8,2,2,4,8,-112.2612381,33.45026016
226,"TOMAHAWK WI",6,1,0,0,1,1,-89.73039246,45.47093964
226,"TOMBALL TX",6,21,6,2,13,21,-95.6162262,30.09776115
226,"TOMBSTONE AZ",6,19,7,5,7,19,-110.0689316,31.71310997
226,"TOMS RIVER NJ",6,41,14,8,19,41,-74.19700623,39.95401382
226,"TONASKET WA",6,1,0,1,0,1,-119.4414749,48.70505142
226,"TONAWANDA NY",6,5,0,4,1,5,-78.88004303,43.02050018
226,"TOOELE UT",6,42,10,14,18,42,-112.3005066,40.53457642
226,"TOPEKA KS",6,148,49,35,64,148,-95.67857361,39.04813766
226,"TOPPENISH WA",6,11,4,4,3,11,-120.3111954,46.37686539
226,"TOPSFIELD MA",6,1,1,0,0,1,-70.94822693,42.6378746
226,"TORONTO KS",6,15,6,2,7,15,-95.94944,37.79908752
226,"TORRANCE CA",6,47,12,13,22,47,-118.3428345,33.8359642
226,"TORRINGTON CT",6,6,4,2,0,6,-73.12056732,41.80105209
226,"TORRINGTON WY",6,5,1,2,2,5,-104.1826859,42.06502533
226,"TRACY CA",6,17,5,5,7,17,-121.427269,37.73949814
226,"TRAPPE MD",6,1,0,1,0,1,-76.05755615,38.65869522
226,"TRAVELERS REST SC",6,2,1,0,1,2,-82.44297028,34.96780014
226,"TRAVERSE CITY MI",6,55,13,21,21,55,-85.6207962,44.76324844
226,"TREASURE ISLAND FL",6,3,1,0,2,3,-82.76873779,27.76968193
226,"TREMONT IL",6,3,1,1,1,3,-89.49304199,40.52783585
226,"TRENTON FL",6,1,0,0,1,1,-82.81704712,29.61356735
226,"TRENTON NJ",6,74,14,24,36,74,-74.74206543,40.21709442
226,"TRENTON OH",6,1,1,0,0,1,-84.45779419,39.48095703
226,"TRINIDAD CO",6,1,0,1,0,1,-104.5080338,37.17304611
226,"TROY AL",6,5,0,3,2,5,-85.97013855,31.80913544
226,"TROY MI",6,22,8,6,8,22,-83.14983368,42.60589218
226,"TROY MO",6,6,0,3,3,6,-90.98098755,38.979702
226,"TROY NY",6,30,6,11,13,30,-73.69088745,42.72839737
226,"TROY OH",6,73,22,26,25,73,-84.20330811,40.03966141
226,"TRUCKEE CA",6,4,1,1,2,4,-120.1852493,39.32775879
226,"TRUMANN AR",6,3,0,2,1,3,-90.5122757,35.67847824
226,"TRUMANSBURG NY",6,7,1,2,4,7,-76.66526794,42.54250717
226,"TRUSSVILLE AL",6,2,1,1,0,2,-86.61297607,33.62001419
226,"TRUTH OR CONSEQUENCES NM",6,6,1,2,3,6,-107.2433853,33.13360596
226,"TRYON NC",6,16,2,6,8,16,-82.23826599,35.20822144
226,"TUCKAHOE NY",6,1,0,0,1,1,-73.82630157,40.95046616
226,"TUCKER GA",6,6,2,1,3,6,-84.21690369,33.85486603
226,"TUCKERTON NJ",6,1,1,0,0,1,-74.3393631,39.60338211
226,"TUCSON AZ",6,600,149,184,267,600,-110.9277954,32.22209167
226,"TUKWILA WA",6,2,1,0,1,2,-122.26371,47.47369385
226,"TULARE CA",6,10,1,7,2,10,-119.3488922,36.20763016
226,"TULLAHOMA TN",6,2,0,1,1,2,-86.20916748,35.36205673
226,"TULSA OK",6,481,132,129,220,481,-95.98488617,36.1603241
226,"TUMWATER WA",6,3,1,0,2,3,-122.9116669,47.00710678
226,"TUNKHANNOCK PA",6,6,0,2,4,6,-75.94562531,41.5386734
226,"TUPELO MS",6,17,5,1,11,17,-88.71934509,34.26508713
226,"TURLOCK CA",6,20,7,4,9,20,-120.8488617,37.49431229
226,"TURTLE CREEK PA",6,3,1,0,2,3,-79.8516922,40.39013672
226,"TUSCALOOSA AL",6,183,46,60,77,183,-87.56897736,33.21024704
226,"TUSCUMBIA AL",6,3,2,0,1,3,-87.70251465,34.73139191
226,"TUSKEGEE AL",6,4,0,1,3,4,-85.69181061,32.42424011
226,"TUSTIN CA",6,11,5,0,6,11,-117.8277283,33.74598312
226,"TUTTLE OK",6,2,1,0,1,2,-97.82015991,35.29173279
226,"TWENTYNINE PALMS CA",6,10,1,3,6,10,-116.055397,34.13557053
226,"TWIN FALLS ID",6,9,2,0,7,9,-114.4627686,42.56301498
226,"TWINSBURG OH",6,3,2,0,1,3,-81.43978882,41.3127594
226,"TYLER TX",6,39,8,14,17,39,-95.3013916,32.35176468
226,"TYRONE GA",6,1,0,0,1,1,-84.59676361,33.47140121
226,"TYRONE PA",6,2,0,2,0,2,-78.23786926,40.67061996
226,"UKIAH CA",6,7,2,1,4,7,-123.2104721,39.15015793
226,"UNION BRIDGE MD",6,1,0,0,1,1,-77.17628479,39.56907654
226,"UNION CITY CA",6,13,6,1,6,13,-122.0214462,37.59539032
226,"UNION CITY GA",6,2,0,2,0,2,-84.55107117,33.58210373
226,"UNION CITY NJ",6,6,2,2,2,6,-74.02296448,40.77968979
226,"UNION KY",6,6,3,2,1,6,-84.68045044,38.94612122
226,"UNION ME",6,2,0,2,0,2,-69.27328491,44.21183395
226,"UNION MO",6,2,1,0,1,2,-91.00618744,38.44558716
226,"UNION NJ",6,6,1,2,3,6,-74.26235199,40.69780731
226,"UNION SC",6,1,0,1,0,1,-81.62347412,34.71575165
226,"UNIONTOWN PA",6,11,3,3,5,11,-79.7276535,39.89894104
226,"UNIVERSAL CITY TX",6,1,0,0,1,1,-98.29141235,29.54836273
226,"UNIVERSITY CITY MO",6,103,42,15,46,103,-90.33391571,38.66000748
226,"UNIVERSITY HEIGHTS OH",6,11,2,5,4,11,-81.5369873,41.49779892
226,"UNIVERSITY PLACE WA",6,3,1,0,2,3,-122.5529404,47.2352562
226,"UPLAND CA",6,19,2,7,10,19,-117.6498413,34.09745026
226,"UPPER DARBY PA",6,17,2,6,9,17,-75.27319336,39.92858124
226,"UPPER MARLBORO MD",6,35,11,6,18,35,-76.74905396,38.81620026
226,"UPPER SANDUSKY OH",6,1,1,0,0,1,-83.28137207,40.82746506
226,"URBANA IL",6,186,53,61,72,186,-88.20746613,40.11079025
226,"URBANA OH",6,6,3,1,2,6,-83.75213623,40.10844803
226,"UTICA NY",6,22,4,8,10,22,-75.23220062,43.10119629
226,"UVALDA GA",6,1,0,0,1,1,-82.50778961,32.03624725
226,"UVALDE TX",6,18,4,4,10,18,-99.78696442,29.20999336
226,"VACAVILLE CA",6,16,4,6,6,16,-121.9900284,38.35633469
226,"VADNAIS HEIGHTS MN",6,2,0,1,1,2,-93.07452393,45.05739975
226,"VALDESE NC",6,1,1,0,0,1,-81.56863403,35.74153519
226,"VALDEZ AK",6,18,5,4,9,18,-146.3392181,61.13446426
226,"VALDOSTA GA",6,105,32,30,43,105,-83.27806854,30.83293533
226,"VALIER IL",6,1,0,0,1,1,-89.04284668,38.01522064
226,"VALLEJO CA",6,73,19,24,30,73,-122.2594299,38.1039505
226,"VALLEY AL",6,4,2,2,0,4,-85.17531586,32.81519318
226,"VALLEY STREAM NY",6,5,1,1,3,5,-73.70756531,40.66439819
226,"VALPARAISO FL",6,1,0,1,0,1,-86.49382019,30.51258087
226,"VALPARAISO IN",6,25,7,9,9,25,-87.05838013,41.46813583
226,"VANCOUVER WA",6,304,76,80,148,304,-122.6816559,45.63534164
226,"VANDALIA IL",6,1,0,0,1,1,-89.09368896,38.96084595
226,"VANDALIA MO",6,1,0,1,0,1,-91.48904419,39.31077194
226,"VANDALIA OH",6,2,1,0,1,2,-84.19855499,39.89054871
226,"VARDAMAN MS",6,2,0,1,1,2,-89.17769623,33.87607956
226,"VARNADO LA",6,14,4,3,7,14,-89.82972717,30.89409256
226,"VARNVILLE SC",6,1,0,0,1,1,-81.07863617,32.85089874
226,"VENICE FL",6,4,1,1,2,4,-82.45388031,27.10065269
226,"VERGENNES VT",6,2,1,1,0,2,-73.25317383,44.16755676
226,"VERMILION OH",6,2,2,0,0,2,-82.36431122,41.42188644
226,"VERMILLION SD",6,11,1,1,9,11,-96.92948914,42.77981949
226,"VERNAL UT",6,1,0,1,0,1,-109.5302963,40.45552444
226,"VERNON HILLS IL",6,1,1,0,0,1,-87.97944641,42.21946716
226,"VERNON TX",6,2,1,0,1,2,-99.26555634,34.15447235
226,"VERO BEACH FL",6,21,4,9,8,21,-80.39705658,27.63908195
226,"VERONA PA",6,2,0,1,1,2,-79.84282684,40.50643539
226,"VERONA WI",6,1,1,0,0,1,-89.53356171,42.99075699
226,"VERSAILLES KY",6,2,0,0,2,2,-84.73013306,38.05267715
226,"VERSAILLES PA",6,1,0,0,1,1,-79.83054352,40.31568146
226,"VESTAL NY",6,4,3,0,1,4,-76.05289459,42.08543015
226,"VESTAVIA HILLS AL",6,8,4,1,3,8,-86.78768921,33.44869995
226,"VICKSBURG MS",6,17,5,4,8,17,-90.87818909,32.35280991
226,"VICTORIA TX",6,73,22,20,31,73,-97.00409698,28.80560303
226,"VICTORVILLE CA",6,31,12,6,13,31,-117.2928162,34.53612137
226,"VIDALIA GA",6,1,0,0,1,1,-82.41294098,32.21813965
226,"VIENNA VA",6,26,6,9,11,26,-77.2645874,38.90164566
226,"VIENNA WV",6,3,2,0,1,3,-81.54671478,39.33840179
226,"VILLA PARK IL",6,2,1,1,0,2,-87.98905182,41.88983536
226,"VILLA RICA GA",6,5,3,0,2,5,-84.91907501,33.73210907
226,"VINCENNES IN",6,5,0,1,4,5,-87.5169754,38.68549347
226,"VINE GROVE KY",6,3,2,0,1,3,-85.98104858,37.81027222
226,"VINELAND NJ",6,3,0,0,3,3,-75.02515411,39.48631668
226,"VINTON LA",6,1,0,0,1,1,-93.58152008,30.19109917
226,"VIRGINIA BEACH VA",6,509,168,143,198,509,-75.97751617,36.8533783
226,"VIRGINIA MN",6,1,0,0,1,1,-92.53681946,47.52297211
226,"VIROQUA WI",6,2,0,0,2,2,-90.8891983,43.55662155
226,"VISALIA CA",6,25,10,7,8,25,-119.2938156,36.33000946
226,"VISTA CA",6,18,5,5,8,18,-117.2447052,33.2000885
226,"VIVIAN LA",6,1,0,1,0,1,-93.98780823,32.87190247
226,"VOLO IL",6,3,1,1,1,3,-88.16824341,42.32604218
226,"VONORE TN",6,1,1,0,0,1,-84.2419281,35.59017944
226,"WABBASEKA AR",6,1,0,0,1,1,-91.79612732,34.3609581
226,"WACO TX",6,113,30,37,46,113,-97.14704895,31.54987144
226,"WADESBORO NC",6,3,0,3,0,3,-80.07618713,34.96852875
226,"WADSWORTH OH",6,5,1,0,4,5,-81.7297821,41.02577972
226,"WAGNER SD",6,1,0,0,1,1,-98.29380798,43.08109283
226,"WAITE PARK MN",6,11,6,3,2,11,-94.224823,45.55731201
226,"WAKE FOREST NC",6,27,10,6,11,27,-78.50919342,35.98039246
226,"WAKEFIELD MA",6,27,5,10,12,27,-71.07489014,42.51018906
226,"WALDOBORO ME",6,1,0,1,0,1,-69.37466431,44.09539795
226,"WALKER LA",6,1,1,0,0,1,-92.58390808,32.19055176
226,"WALKERSVILLE MD",6,3,1,1,1,3,-77.35131073,39.48646164
226,"WALKERTOWN NC",6,9,4,3,2,9,-80.15262604,36.17556
226,"WALLA WALLA WA",6,19,4,3,12,19,-118.3452072,46.06405258
226,"WALLED LAKE MI",6,3,0,2,1,3,-83.4806366,42.53804779
226,"WALLER TX",6,2,1,0,1,2,-95.92726135,30.05709457
226,"WALLINGFORD CT",6,4,2,1,1,4,-72.82215118,41.45715332
226,"WALNUT CREEK CA",6,25,7,8,10,25,-122.0670624,37.90636826
226,"WALNUT HILL IL",6,2,0,0,2,2,-89.04346466,38.47752762
226,"WALPOLE MA",6,45,12,19,14,45,-71.2485199,42.14173889
226,"WALTERBORO SC",6,1,0,0,1,1,-80.66620636,32.90554047
226,"WALTHAM MA",6,23,6,8,9,23,-71.2346344,42.37656403
226,"WANATAH IN",6,3,0,1,2,3,-86.89819336,41.43061829
226,"WARDENSVILLE WV",6,1,0,0,1,1,-78.59748077,39.07683945
226,"WARE MA",6,33,13,7,13,33,-72.24856567,42.26243591
226,"WAREHAM MA",6,2,2,0,0,2,-70.68606567,41.76660156
226,"WARMINSTER PA",6,3,1,2,0,3,-75.09890747,40.20700836
226,"WARNER ROBINS GA",6,4,1,2,1,4,-83.59963989,32.62118149
226,"WARREN MI",6,219,69,47,103,219,-83.02783203,42.47764969
226,"WARREN OH",6,6,2,1,3,6,-80.81771851,41.23757935
226,"WARRENSBURG MO",6,23,6,6,11,23,-93.73639679,38.76289749
226,"WARRENTON MO",6,24,7,8,9,24,-91.14160919,38.81156921
226,"WARRENTON OR",6,1,1,0,0,1,-123.9260635,46.16466522
226,"WARRENTON VA",6,87,18,26,43,87,-77.79475403,38.71380615
226,"WARRIOR AL",6,1,1,0,0,1,-86.80948639,33.81428528
226,"WARSAW IN",6,6,2,1,3,6,-85.85310364,41.23810196
226,"WARSAW NC",6,6,2,1,3,6,-78.09035492,34.99985886
226,"WARSAW NY",6,1,0,0,1,1,-78.13197327,42.74021912
226,"WARWICK NY",6,7,3,2,2,7,-74.35926819,41.25672531
226,"WARWICK RI",6,9,2,1,6,9,-71.37738037,41.69232941
226,"WASCO CA",6,3,1,1,1,3,-119.3427811,35.59425735
226,"WASHINGTON DC",6,17200,5236,4163,7801,17200,-77.01257324,38.88911819
226,"WASHINGTON IL",6,2,0,2,0,2,-89.40994263,40.70514297
226,"WASHINGTON MO",6,151,62,22,67,151,-91.01213074,38.55807495
226,"WASHINGTON NJ",6,1,0,1,0,1,-74.97875977,40.75879669
226,"WASHINGTON PA",6,8,1,3,4,8,-80.24552155,40.17398453
226,"WASHINGTON UT",6,3,0,1,2,3,-113.5095291,37.13038635
226,"WASHOUGAL WA",6,6,1,3,2,6,-122.3545303,45.58441925
226,"WASILLA AK",6,11,4,1,6,11,-149.4517059,61.58290482
226,"WATERBURY CT",6,14,4,4,6,14,-73.05029297,41.55849075
226,"WATERFORD WI",6,2,1,1,0,2,-88.21479797,42.76306152
226,"WATERLOO IA",6,17,6,4,7,17,-92.34320831,42.49277496
226,"WATERLOO IL",6,8,5,1,2,8,-90.14981842,38.3361702
226,"WATERTOWN NY",6,5,2,1,2,5,-75.9100647,43.97471619
226,"WATERTOWN SD",6,1,0,1,0,1,-97.11455536,44.9015274
226,"WATERTOWN WI",6,10,3,1,6,10,-88.72946167,43.19454193
226,"WATERVILLE ME",6,15,5,4,6,15,-69.63098145,44.55205154
226,"WATERVLIET NY",6,1,0,0,1,1,-73.70020294,42.73034668
226,"WATKINSVILLE GA",6,1,1,0,0,1,-83.40834808,33.86332703
226,"WATSONVILLE CA",6,14,3,6,5,14,-121.7594147,36.90995407
226,"WAUCONDA IL",6,1,0,1,0,1,-88.13915253,42.25894928
226,"WAUKEE IA",6,4,2,2,0,4,-93.8857193,41.61172485
226,"WAUKEGAN IL",6,11,2,3,6,11,-87.84466553,42.36366653
226,"WAUKESHA WI",6,30,8,13,9,30,-88.23146057,43.01194382
226,"WAUKON IA",6,1,0,0,1,1,-91.47581482,43.26935577
226,"WAUNAKEE WI",6,7,1,5,1,7,-89.45576477,43.19177246
226,"WAUSAU WI",6,19,6,7,6,19,-89.63059998,44.95904922
226,"WAUWATOSA WI",6,22,8,3,11,22,-88.00754547,43.04960632
226,"WAVERLY IA",6,1,0,1,0,1,-92.47597504,42.7256813
226,"WAVERLY NE",6,10,4,2,4,10,-96.52924347,40.9175148
226,"WAXAHACHIE TX",6,2,0,0,2,2,-96.84883118,32.38674545
226,"WAXHAW NC",6,4,2,1,1,4,-80.74282074,34.92486572
226,"WAYNE MI",6,8,3,1,4,8,-83.38627625,42.28170776
226,"WAYNE NE",6,3,2,1,0,3,-97.01864624,42.23064804
226,"WAYNE NJ",6,9,2,4,3,9,-74.27560425,40.92553711
226,"WAYNE PA",6,6,2,2,2,6,-75.38678741,40.04436111
226,"WAYNESBORO PA",6,1,0,0,1,1,-77.5769043,39.75597763
226,"WAYNESBORO VA",6,2,1,0,1,2,-78.88896179,38.06871414
226,"WAYNESBURG PA",6,1,0,0,1,1,-80.17857361,39.89648438
226,"WAYNESVILLE MO",6,16,1,4,11,16,-92.20101166,37.8287735
226,"WAYNESVILLE NC",6,6,3,3,0,6,-82.98840332,35.48899078
226,"WAYZATA MN",6,3,1,1,1,3,-93.51425171,44.97086334
226,"WEATHERFORD OK",6,8,3,2,3,8,-98.70834351,35.52646255
226,"WEATHERFORD TX",6,2,1,0,1,2,-97.79758453,32.7595253
226,"WEAVERVILLE NC",6,8,1,3,4,8,-82.56031799,35.6974411
226,"WEBSTER CITY IA",6,6,2,1,3,6,-93.81646729,42.46933365
226,"WEBSTER GROVES MO",6,4,2,1,1,4,-90.35769653,38.59287262
226,"WEBSTER NY",6,19,5,5,9,19,-77.42967224,43.21234131
226,"WEBSTER TX",6,3,2,0,1,3,-95.11889648,29.53835869
226,"WEED CA",6,143,48,53,42,143,-122.388382,41.42225266
226,"WEEHAWKEN NJ",6,27,12,5,10,27,-74.01938629,40.7696991
226,"WEIRTON WV",6,2,1,0,1,2,-80.58799744,40.40523529
226,"WELLESLEY MA",6,19,3,8,8,19,-71.29138947,42.29670715
226,"WELLSBORO PA",6,1,1,0,0,1,-77.29973602,41.74900436
226,"WELLSTON OH",6,1,0,0,1,1,-82.53286743,39.12374496
226,"WELLSVILLE NY",6,1,0,1,0,1,-77.94774628,42.12202454
226,"WELLSVILLE OH",6,1,1,0,0,1,-80.65098572,40.60504913
226,"WENATCHEE WA",6,10,3,3,4,10,-120.3128357,47.42322159
226,"WENTZVILLE MO",6,25,5,7,13,25,-90.85335541,38.81171036
226,"WESLACO TX",6,104,22,33,49,104,-97.99131775,26.16018867
226,"WEST ALLIS WI",6,3,0,1,2,3,-88.00700378,43.01686478
226,"WEST BEND WI",6,11,3,3,5,11,-88.18346405,43.42544556
226,"WEST BRANCH MI",6,3,0,0,3,3,-84.23848724,44.2763443
226,"WEST CALDWELL NJ",6,11,1,1,9,11,-74.30077362,40.84119797
226,"WEST CHESTER OH",6,32,8,9,15,32,-84.40789032,39.33029938
226,"WEST CHESTER PA",6,38,10,10,18,38,-75.60475159,39.96074677
226,"WEST CHICAGO IL",6,12,5,3,4,12,-88.20433807,41.88489914
226,"WEST COVINA CA",6,15,4,6,5,15,-117.9406204,34.0685463
226,"WEST DES MOINES IA",6,25,5,8,12,25,-93.71179962,41.57717514
226,"WEST FARGO ND",6,37,13,5,19,37,-96.90450287,46.87138367
226,"WEST FRANKFORT IL",6,1,0,0,1,1,-88.93157196,37.89781189
226,"WEST GROVE PA",6,2,0,0,2,2,-75.82701874,39.82243729
226,"WEST HARTFORD CT",6,18,7,3,8,18,-72.74108887,41.76238251
226,"WEST HAVEN CT",6,3,0,2,1,3,-72.94598389,41.27069473
226,"WEST HOLLYWOOD CA",6,141,50,29,62,141,-118.3634567,34.08982468
226,"WEST JORDAN UT",6,17,6,3,8,17,-111.9405594,40.60975647
226,"WEST LAFAYETTE IN",6,151,42,46,63,151,-86.9082489,40.42613983
226,"WEST LIBERTY IA",6,2,1,0,1,2,-91.26389313,41.57024384
226,"WEST LIBERTY KY",6,4,1,1,2,4,-83.25924683,37.92175293
226,"WEST MEMPHIS AR",6,2,1,0,1,2,-90.18457031,35.14645004
226,"WEST MONROE LA",6,1,0,0,1,1,-92.14794922,32.5187645
226,"WEST NEW YORK NJ",6,3,1,1,1,3,-74.01316833,40.7882576
226,"WEST ORANGE NJ",6,13,4,6,3,13,-74.23833466,40.7989006
226,"WEST PALM BEACH FL",6,343,91,94,158,343,-80.05298615,26.71585464
226,"WEST PEORIA IL",6,1,0,1,0,1,-89.6051712,40.7019577
226,"WEST PLAINS MO",6,13,5,3,5,13,-91.85284424,36.72810745
226,"WEST POINT GA",6,1,1,0,0,1,-85.18297577,32.87822342
226,"WEST POINT MS",6,1,0,1,0,1,-88.65067291,33.60783005
226,"WEST POINT NE",6,1,1,0,0,1,-96.70909119,41.84187317
226,"WEST RICHLAND WA",6,23,5,6,12,23,-119.3632965,46.30400085
226,"WEST SACRAMENTO CA",6,4,1,2,1,4,-121.5324554,38.58049393
226,"WEST SENECA NY",6,5,0,2,3,5,-78.79914856,42.85012436
226,"WEST TX",6,34,9,11,14,34,-97.09226227,31.80267906
226,"WEST UNION IA",6,1,1,0,0,1,-91.80863953,42.96290207
226,"WEST VALLEY CITY UT",6,8,1,2,5,8,-111.9695816,40.69639969
226,"WEST VIEW PA",6,1,0,0,1,1,-80.03391266,40.52226257
226,"WEST WARWICK RI",6,16,2,7,7,16,-71.5218811,41.70644379
226,"WEST YELLOWSTONE MT",6,1,0,0,1,1,-111.1018829,44.66385651
226,"WESTBOROUGH MA",6,2,0,1,1,2,-71.61507416,42.26956177
226,"WESTBROOK ME",6,9,4,1,4,9,-70.37012482,43.67708588
226,"WESTBURY NY",6,1,0,1,0,1,-73.58692932,40.75608444
226,"WESTCLIFFE CO",6,2,1,0,1,2,-105.4663086,38.13474274
226,"WESTERLY RI",6,12,3,3,6,12,-71.82659149,41.37784958
226,"WESTERVILLE OH",6,101,21,26,54,101,-82.92906952,40.12620926
226,"WESTFIELD IN",6,20,5,7,8,20,-86.12757111,40.04309464
226,"WESTFIELD MA",6,4,0,1,3,4,-72.74882507,42.12547302
226,"WESTFIELD NJ",6,17,5,2,10,17,-74.34671783,40.65938187
226,"WESTFORD MA",6,6,2,3,1,6,-71.43686676,42.57947159
226,"WESTLAKE OH",6,2,0,0,2,2,-81.91750336,41.45558167
226,"WESTLAND MI",6,12,3,4,5,12,-83.39988708,42.32430649
226,"WESTMINSTER CA",6,9,3,2,4,9,-118.0086441,33.7593689
226,"WESTMINSTER CO",6,25,7,4,14,25,-105.0385208,39.83644867
226,"WESTMINSTER MD",6,31,2,16,13,31,-76.99542999,39.57574463
226,"WESTMONT IL",6,5,2,1,2,5,-87.97566223,41.79613113
226,"WESTMORELAND TN",6,1,0,0,1,1,-86.24802399,36.56184006
226,"WESTON WI",6,2,0,1,1,2,-92.07221222,44.81256104
226,"WESTPORT CT",6,12,1,3,8,12,-73.35696411,41.14154053
226,"WESTPORT NY",6,1,0,0,1,1,-73.43728638,44.18396759
226,"WESTVILLE IL",6,1,1,0,0,1,-87.63852692,40.04247284
226,"WESTVILLE NJ",6,5,1,1,3,5,-75.13100433,39.86798859
226,"WESTVILLE OK",6,4,2,1,1,4,-94.56835937,35.99255753
226,"WESTWOOD KS",6,1,0,1,0,1,-94.61717224,39.040802
226,"WETUMPKA AL",6,1,0,1,0,1,-86.21166229,32.54381561
226,"WHARTON TX",6,1,0,0,1,1,-96.10342407,29.31210136
226,"WHEAT RIDGE CO",6,3,1,1,1,3,-105.0783615,39.76603317
226,"WHEATON IL",6,47,14,15,18,47,-88.10729218,41.86618805
226,"WHEELER TX",6,1,0,0,1,1,-100.2721405,35.44525528
226,"WHEELING IL",6,4,1,2,1,4,-87.92919159,42.13937759
226,"WHEELING WV",6,41,13,8,20,41,-80.7192688,40.06991577
226,"WHITE BEAR LAKE MN",6,10,3,3,4,10,-93.01039886,45.08457947
226,"WHITE HOUSE TN",6,2,1,0,1,2,-86.65110016,36.47054672
226,"WHITE OAK PA",6,6,2,0,4,6,-79.8089447,40.33785248
226,"WHITE PLAINS NY",6,58,16,17,25,58,-73.76217651,41.03399658
226,"WHITEFISH BAY WI",6,6,1,1,1,3,-87.561748505,44.0099659
226,"WHITEFISH MT",6,15,3,5,7,15,-114.3380127,48.41337967
226,"WHITEHALL PA",6,1,1,0,0,1,-79.99015045,40.36117554
226,"WHITESBURG KY",6,5,1,2,2,5,-82.82665253,37.11859894
226,"WHITEVILLE NC",6,1,0,0,1,1,-78.70272064,34.3391037
226,"WHITEWATER WI",6,14,3,5,6,14,-88.73226166,42.83348846
226,"WHITTIER CA",6,67,17,15,35,67,-118.0349197,33.9793129
226,"WICHITA FALLS TX",6,58,20,14,24,58,-98.49403381,33.91383743
226,"WICHITA KS",6,456,123,134,199,456,-97.3383255,37.69230652
226,"WICKENBURG AZ",6,1,0,0,1,1,-112.7309876,33.96890259
226,"WICKLIFFE OH",6,2,0,0,2,2,-81.45320129,41.60562515
226,"WIGGINS MS",6,2,1,0,0,1,-89.388908385,31.78047371
226,"WILDOMAR CA",6,1,0,0,1,1,-117.2806625,33.59801483
226,"WILKES-BARRE PA",6,7,3,3,1,7,-75.88058472,41.24601746
226,"WILKINSBURG PA",6,46,7,16,23,46,-79.88179016,40.44174194
226,"WILLIAMS AZ",6,5,1,2,2,5,-112.1919174,35.24922943
226,"WILLIAMSBURG OH",6,2,0,0,2,2,-84.05879211,39.05864716
226,"WILLIAMSBURG VA",6,37,11,9,17,37,-76.70659637,37.27114868
226,"WILLIAMSPORT PA",6,20,7,5,8,20,-77.00060272,41.24121475
226,"WILLIAMSTON MI",6,1,0,0,1,1,-84.28330231,42.68922043
226,"WILLIAMSTON NC",6,2,1,0,1,2,-77.05486298,35.85483551
226,"WILLIAMSTOWN KY",6,2,0,1,1,2,-84.56015778,38.63843536
226,"WILLIAMSTOWN MA",6,11,5,2,4,11,-73.21173859,42.70910263
226,"WILLIAMSVILLE IL",6,2,0,0,2,2,-89.54888916,39.95424652
226,"WILLINGBORO NJ",6,6,3,1,2,6,-74.86815643,40.02816391
226,"WILLIS TX",6,3,1,1,1,3,-95.48044586,30.42520714
226,"WILLMAR MN",6,1,1,0,0,1,-95.04427338,45.12181473
226,"WILLOUGHBY HILLS OH",6,1,0,1,0,1,-81.41830444,41.598526
226,"WILLOUGHBY OH",6,20,3,7,10,20,-81.40597534,41.63972092
226,"WILLOW SPRINGS IL",6,1,1,0,0,1,-87.8605423,41.74113464
226,"WILLOWICK OH",6,1,1,0,0,1,-81.46814728,41.63298416
226,"WILMETTE IL",6,1,1,0,0,1,-87.72296143,42.07221222
226,"WILMINGTON DE",6,96,32,25,39,96,-75.54558563,39.74601364
226,"WILMINGTON IL",6,2,0,1,1,2,-88.14704132,41.30776596
226,"WILMINGTON NC",6,133,36,34,63,133,-77.94431305,34.22592926
226,"WILMINGTON OH",6,5,0,3,2,5,-83.82820892,39.44527435
226,"WILSON NC",6,3,0,1,2,3,-77.914711,35.72143173
226,"WILSON NY",6,1,1,0,0,1,-78.82568359,43.31000519
226,"WILSONVILLE OR",6,5,1,0,4,5,-122.7757416,45.29935455
226,"WILTON CT",6,1,0,0,1,1,-73.43698883,41.19543076
226,"WINCHESTER KY",6,1,0,0,1,1,-84.17945862,37.99042511
226,"WINCHESTER MA",6,2,0,0,2,2,-71.13614655,42.45266342
226,"WINCHESTER VA",6,15,2,4,9,15,-78.16301727,39.18608475
226,"WINDER GA",6,19,3,6,10,19,-83.71982574,33.99271393
226,"WINDERMERE FL",6,16,5,7,4,16,-81.53463745,28.49615097
226,"WINDOM MN",6,2,2,0,0,2,-95.11735535,43.86626816
226,"WINDSOR CA",6,2,1,0,1,2,-122.8183441,38.546772
226,"WINDSOR CO",6,12,2,1,9,12,-104.9023056,40.47741699
226,"WINDSOR CT",6,8,2,2,4,8,-72.64279175,41.85288239
226,"WINDSOR MO",6,61,19,16,26,61,-93.5224762,38.53234863
226,"WINDSOR VA",6,3,1,0,2,3,-76.74337006,36.80891037
226,"WINDSOR VT",6,6,2,1,3,6,-72.38378906,43.48069
226,"WINFIELD AL",6,1,0,0,1,1,-87.81744385,33.92904282
226,"WINFIELD KS",6,1,0,0,1,1,-96.9961853,37.23976898
226,"WINFIELD MO",6,6,1,4,1,6,-90.73840332,38.99734879
226,"WINNETKA IL",6,3,1,0,2,3,-87.73626709,42.10827255
226,"WINNSBORO TX",6,1,1,0,0,1,-95.29055023,32.95773315
226,"WINONA MN",6,16,6,3,7,16,-91.63965607,44.04986572
226,"WINONA MS",6,1,1,0,0,1,-89.73496246,33.48717499
226,"WINOOSKI VT",6,2,2,0,0,2,-73.18509674,44.49157333
226,"WINSTON-SALEM NC",6,226,75,67,84,226,-80.24356842,36.1001091
226,"WINTER HAVEN FL",6,15,5,5,5,15,-81.73223114,28.02276421
226,"WINTER PARK CO",6,17,6,4,7,17,-105.7649307,39.89161301
226,"WINTER PARK FL",6,161,40,51,70,161,-81.33872223,28.6003685
226,"WISCASSET ME",6,2,0,0,2,2,-69.66466522,44.00312805
226,"WITT IL",6,1,1,0,0,1,-89.34815216,39.2564888
226,"WIXOM MI",6,1,0,0,1,1,-83.53598785,42.52477264
226,"WOBURN MA",6,3,0,1,2,3,-71.15155029,42.47951508
226,"WOLFEBORO NH",6,2,1,1,0,2,-71.1996994,43.58374405
226,"WOOD RIVER IL",6,1,0,1,0,1,-90.09774017,38.86127472
226,"WOODBRIDGE NJ",6,7,2,3,2,7,-74.28398895,40.55769348
226,"WOODBURN IN",6,1,1,0,0,1,-84.85319519,41.12522507
226,"WOODBURN OR",6,2,0,1,1,2,-122.8577652,45.14351273
226,"WOODBURY GA",6,1,0,0,1,1,-84.58252716,32.9842186
226,"WOODBURY MN",6,4,1,2,1,4,-92.95999908,44.92368698
226,"WOODBURY NJ",6,15,4,2,9,15,-75.15171051,39.83841705
226,"WOODHAVEN MI",6,1,0,0,1,1,-83.24159241,42.13908005
226,"WOODINVILLE WA",6,12,5,2,5,12,-122.1656876,47.75372314
226,"WOODLAND CA",6,10,5,2,3,10,-121.7751541,38.67827225
226,"WOODRIDGE IL",6,1,0,1,0,1,-88.05056763,41.74704742
226,"WOODRUFF SC",6,2,1,0,1,2,-82.03645325,34.73959732
226,"WOODSIDE CA",6,5,1,3,1,5,-122.2564316,37.42977905
226,"WOODSTOCK GA",6,23,6,8,9,23,-84.51925659,34.10178375
226,"WOODSTOCK IL",6,6,2,1,3,6,-88.4488678,42.31498718
226,"WOODWARD OK",6,1,1,0,0,1,-99.39118958,36.43392563
226,"WOONSOCKET RI",6,1,1,0,0,1,-71.51394653,42.00294876
226,"WOOSTER OH",6,19,6,3,10,19,-81.93497467,40.80502319
226,"WORCESTER MA",6,121,40,30,51,121,-71.801651,42.26288986
226,"WORTH IL",6,1,0,1,0,1,-87.79718018,41.68992233
226,"WORTHINGTON MN",6,5,2,2,1,5,-95.5971756,43.62000275
226,"WORTHINGTON OH",6,11,4,3,4,11,-83.01785278,40.09322739
226,"WRIGHT CITY MO",6,4,1,1,2,4,-91.02021027,38.82786942
226,"WYANDOTTE MI",6,9,3,2,4,9,-83.15003204,42.21445465
226,"WYCKOFF NJ",6,1,0,0,1,1,-74.17180634,41.00969696
226,"WYLIE TX",6,13,5,3,5,13,-96.5396347,33.01520157
226,"WYOMING MI",6,25,6,5,14,25,-85.70549011,42.9133873
226,"WYOMING MN",6,1,0,0,1,1,-92.99753571,45.33620453
226,"WYOMISSING PA",6,2,2,0,0,2,-75.96470642,40.32975388
226,"WYTHEVILLE VA",6,1,1,0,0,1,-81.08470917,36.94871521
226,"XENIA OH",6,2,1,0,1,2,-83.92948151,39.68489075
226,"YAKIMA WA",6,15,2,8,5,15,-120.508812,46.60157394
226,"YANKTON SD",6,2,1,0,1,2,-97.39076233,42.8748703
226,"YARDLEY PA",6,1,0,0,1,1,-74.8451004,40.2459259
226,"YEADON PA",6,2,0,2,0,2,-75.25486755,39.93914032
226,"YELLOW SPRINGS OH",6,12,0,2,10,12,-83.88698578,39.80642319
226,"YELM WA",6,1,1,0,0,1,-122.608902,46.94182968
226,"YONKERS NY",6,51,23,12,16,51,-73.89792633,40.93142319
226,"YORBA LINDA CA",6,4,0,2,2,4,-117.8147278,33.88856888
226,"YORK PA",6,79,28,26,25,79,-76.72687531,39.96264267
226,"YORK SC",6,1,0,0,1,1,-81.24180603,34.99464035
226,"YORKVILLE IL",6,2,0,1,1,2,-88.44723511,41.64102936
226,"YOUNGSTOWN OH",6,211,59,54,98,211,-80.64901733,41.1000061
226,"YOUNGSVILLE LA",6,4,1,3,0,4,-91.99059296,30.09988785
226,"YOUNGSVILLE NC",6,2,1,1,0,2,-78.47360992,36.02531433
226,"YPSILANTI MI",6,131,29,46,56,131,-83.61315155,42.24105453
226,"YREKA CA",6,2,1,0,1,2,-122.6363983,41.73524094
226,"YUBA CITY CA",6,16,1,5,10,16,-121.6193237,39.14025497
226,"YUCAIPA CA",6,12,3,3,6,12,-117.0447998,34.03347397
226,"YUCCA VALLEY CA",6,11,3,1,7,11,-116.4475403,34.11928558
226,"YUKON OK",6,3,1,2,0,3,-97.76316071,35.50673294
226,"YUMA AZ",6,14,4,5,5,14,-114.6262665,32.72531128
226,"YUMA CO",6,1,0,1,0,1,-102.7258301,40.12628937
226,"ZACHARY LA",6,3,1,1,1,3,-91.15661621,30.64884186
226,"ZANESVILLE OH",6,28,10,7,11,28,-82.01314545,39.94056702
226,"ZEELAND MI",6,8,3,2,3,8,-86.01843262,42.812603
226,"ZIONSVILLE IN",6,2,1,1,0,2,-86.26182556,39.95092773
227,"ABERDEEN SD",7,2,1,0,1,2,-98.48273468,45.46180344
227,"ABERDEEN WA",7,2,1,0,1,2,-123.8181381,46.97493744
227,"ABILENE KS",7,1,0,0,1,1,-97.21461487,38.9171524
227,"ABILENE TX",7,11,3,2,6,11,-99.73384094,32.44894028
227,"ABSECON NJ",7,46,14,10,22,46,-74.49462128,39.42850494
227,"ACTON MA",7,2,2,0,0,2,-71.43197632,42.48540115
227,"ADA OH",7,2,1,0,1,2,-83.82268524,40.76944351
227,"ADA OK",7,4,1,1,2,4,-96.67899323,34.77481842
227,"ADAMS MA",7,1,1,0,0,1,-73.1167984,42.62440872
227,"ADDISON TX",7,10,2,3,5,10,-96.82976532,32.96215057
227,"ADDYSTON OH",7,2,1,0,1,2,-84.70896912,39.13671875
227,"ADEL GA",7,1,0,1,0,1,-83.42346191,31.13760948
227,"ADRIAN MI",7,1,0,1,0,1,-84.03691101,41.89771652
227,"ADRIAN MO",7,1,0,1,0,1,-94.35219574,38.39756775
227,"AIKEN SC",7,8,0,2,6,8,-81.71619415,33.55714417
227,"AKRON OH",7,88,24,22,42,88,-81.51885223,41.08151627
227,"AKRON PA",7,3,1,2,0,3,-76.20130157,40.15691757
227,"ALABASTER AL",7,1,1,0,0,1,-86.81655121,33.24436188
227,"ALACHUA FL",7,1,0,0,1,1,-82.49368286,29.79605484
227,"ALAMEDA CA",7,28,9,9,10,28,-122.2444763,37.76513672
227,"ALAMOGORDO NM",7,2,1,1,0,2,-105.9584656,32.90003967
227,"ALBANY CA",7,1,0,0,1,1,-122.3003311,37.88674164
227,"ALBANY GA",7,4,0,3,1,4,-84.15510559,31.58296013
227,"ALBANY NY",7,62,26,5,31,62,-73.75520325,42.6529007
227,"ALBANY OR",7,4,0,4,0,4,-123.1083984,44.63620758
227,"ALBEMARLE NC",7,1,1,0,0,1,-80.19947815,35.3506012
227,"ALBERT LEA MN",7,1,0,0,1,1,-93.36846924,43.6479454
227,"ALBION MI",7,1,1,0,0,1,-84.75305176,42.24326324
227,"ALBUQUERQUE NM",7,308,93,98,117,308,-106.6517639,35.08336639
227,"ALCOA TN",7,2,1,0,1,2,-83.96761322,35.77825165
227,"ALEXANDER AR",7,1,1,0,0,1,-92.44168854,34.62968826
227,"ALEXANDRIA IN",7,2,1,1,0,2,-85.67569733,40.2626915
227,"ALEXANDRIA LA",7,9,1,4,4,9,-92.44517517,31.31143761
227,"ALEXANDRIA VA",7,126,41,40,45,126,-77.04605103,38.80503082
227,"ALHAMBRA CA",7,4,3,0,1,4,-118.1287003,34.0954628
227,"ALICE TX",7,3,2,1,0,3,-98.07035828,27.7528286
227,"ALICEVILLE AL",7,1,1,0,0,1,-88.15151978,33.12960434
227,"ALIQUIPPA PA",7,1,1,0,0,1,-80.23978424,40.63685608
227,"ALLEN TX",7,4,1,0,3,4,-96.67116547,33.10336685
227,"ALLENTOWN PA",7,18,3,7,8,18,-75.46569824,40.60851288
227,"ALLIANCE OH",7,1,0,0,1,1,-81.10575867,40.91523743
227,"ALLOUEZ WI",7,1,0,1,0,1,-88.01641846,44.47735977
227,"ALPHARETTA GA",7,9,4,3,2,9,-84.29410553,34.07542419
227,"ALTAMONTE SPRINGS FL",7,4,0,2,2,4,-81.39485931,28.66284752
227,"ALTON IL",7,13,3,5,5,13,-90.18429565,38.89074326
227,"ALTOONA PA",7,4,1,1,2,4,-78.39411163,40.51860046
227,"ALTUS OK",7,1,0,0,1,1,-99.33457184,34.63834
227,"ALVIN TX",7,3,2,0,1,3,-95.24459076,29.42417526
227,"AMARILLO TX",7,16,6,3,7,16,-101.8324051,35.22210312
227,"AMBOY IL",7,1,1,0,0,1,-89.3286972,41.71424103
227,"AMES IA",7,34,8,12,14,34,-93.61370087,42.02269363
227,"AMHERST MA",7,21,12,4,5,21,-72.5192337,42.37371826
227,"AMHERST OH",7,2,0,2,0,2,-82.22229767,41.39805603
227,"AMORY MS",7,2,0,1,1,2,-88.48745728,33.98094559
227,"AMSTERDAM NY",7,1,0,1,0,1,-74.18743134,42.93893051
227,"ANACORTES WA",7,1,1,0,0,1,-122.6148834,48.51247025
227,"ANADARKO OK",7,2,0,1,1,2,-98.2443161,35.07276535
227,"ANAHEIM CA",7,15,5,1,9,15,-117.9165115,33.8354454
227,"ANCHORAGE AK",7,51,12,17,22,51,-149.8811951,61.21649933
227,"ANDERSON IN",7,21,9,4,8,21,-85.68051147,40.1053772
227,"ANDERSON SC",7,5,2,0,3,5,-82.65641785,34.50934219
227,"ANDOVER NH",7,1,0,1,0,1,-71.82262421,43.43712234
227,"ANKENY IA",7,3,0,1,2,3,-93.60646057,41.72983551
227,"ANN ARBOR MI",7,134,39,44,51,134,-83.74536896,42.28347015
227,"ANNAPOLIS MD",7,24,7,5,12,24,-76.49166107,38.97844696
227,"ANNISTON AL",7,1,0,0,1,1,-85.8313446,33.65997314
227,"ANSONIA CT",7,4,0,2,2,4,-73.0779953,41.34640884
227,"ANTIOCH CA",7,6,2,3,1,6,-121.808136,38.0049057
227,"APACHE JUNCTION AZ",7,4,1,1,2,4,-111.5511551,33.41511536
227,"APEX NC",7,1,0,1,0,1,-78.84952545,35.73279572
227,"APOLLO PA",7,1,0,1,0,1,-79.56620789,40.58155441
227,"APOPKA FL",7,5,0,3,2,5,-81.5089798,28.68117523
227,"APPLE VALLEY MN",7,18,6,8,4,18,-93.21794128,44.73189926
227,"APPLETON WI",7,7,0,3,4,7,-88.41551208,44.2618866
227,"APPOMATTOX VA",7,2,1,0,1,2,-78.82469177,37.35719299
227,"ARCADIA CA",7,1,0,1,0,1,-118.0368881,34.1397934
227,"ARCADIA FL",7,3,1,0,2,3,-81.85810089,27.21654701
227,"ARCATA CA",7,10,3,4,3,10,-124.08564,40.86624527
227,"ARCHBOLD OH",7,1,0,1,0,1,-84.30731201,41.52135849
227,"ARDEN HILLS MN",7,1,0,0,1,1,-93.15720367,45.05033112
227,"ARDMORE OK",7,2,1,1,0,2,-97.14401245,34.17425156
227,"ARKANSAS CITY KS",7,1,0,1,0,1,-97.03897858,37.06211472
227,"ARLINGTON HEIGHTS IL",7,22,6,8,8,22,-87.98104858,42.08821106
227,"ARLINGTON MA",7,10,2,5,3,10,-71.15559387,42.41545486
227,"ARLINGTON TX",7,147,40,44,63,147,-97.10882568,32.73590469
227,"ARLINGTON WA",7,2,0,0,2,2,-122.1277237,48.19829941
227,"ARNOLD MO",7,1,0,1,0,1,-90.37690735,38.43906784
227,"ARTESIA CA",7,2,1,1,0,2,-118.0846176,33.86582184
227,"ARTESIA NM",7,1,1,0,0,1,-104.4046478,32.84522247
227,"ARVADA CO",7,4,2,0,2,4,-105.0886612,39.8028183
227,"ASBURY PARK NJ",7,3,1,1,1,3,-74.01100159,40.22047806
227,"ASHEBORO NC",7,1,0,0,1,1,-79.81291199,35.70822525
227,"ASHEVILLE NC",7,73,21,21,31,73,-82.55367279,35.60134888
227,"ASHLAND AL",7,3,1,1,1,3,-85.83626556,33.27382278
227,"ASHLAND KY",7,15,5,7,3,15,-82.63764954,38.47874069
227,"ASHLAND MA",7,2,0,2,0,2,-71.46256256,42.26143265
227,"ASHLAND OH",7,3,3,0,0,3,-82.31797028,40.86874771
227,"ASHLAND OR",7,35,14,9,12,35,-122.7111359,42.19425583
227,"ASHLAND VA",7,9,5,2,2,9,-77.47959137,37.75937653
227,"ASHLAND WI",7,2,0,0,2,2,-90.88419342,46.59241104
227,"ASHTABULA OH",7,1,0,0,1,1,-80.78971863,41.86506653
227,"ASPEN CO",7,10,2,2,6,10,-106.8185959,39.19105911
227,"ASTORIA OR",7,8,3,2,3,8,-123.8339157,46.18756866
227,"ATASCADERO CA",7,2,0,1,1,2,-120.6487961,35.47494888
227,"ATCHISON KS",7,1,1,0,0,1,-95.12229919,39.56309128
227,"ATHENS AL",7,1,0,0,1,1,-86.97190857,34.80292892
227,"ATHENS OH",7,26,5,8,13,26,-82.10113525,39.32934952
227,"ATHENS PA",7,8,0,3,5,8,-76.52072906,41.9661293
227,"ATLANTA GA",7,2771,895,761,1115,2771,-84.38757324,33.74927521
227,"ATLANTIC CITY NJ",7,17,7,4,6,17,-74.42202759,39.36457062
227,"ATOKA TN",7,1,1,0,0,1,-89.77851868,35.44120789
227,"ATTLEBORO MA",7,1,1,0,0,1,-71.28439331,41.94469833
227,"AUBURN AL",7,17,4,2,11,17,-85.48087311,32.61021423
227,"AUBURN CA",7,126,46,28,52,126,-121.0794067,38.89623642
227,"AUBURN GA",7,1,0,0,1,1,-83.82753754,34.01380157
227,"AUBURN MA",7,1,0,0,1,1,-71.84958649,42.18192291
227,"AUBURN ME",7,1,0,0,1,1,-70.23028564,44.09794235
227,"AUBURN NY",7,1,1,0,0,1,-76.56542969,42.93203735
227,"AUBURN WA",7,5,1,1,3,5,-122.2304688,47.30677795
227,"AUGUSTA KS",7,1,0,1,0,1,-96.97721863,37.68652725
227,"AUGUSTA ME",7,2,0,0,2,2,-69.7781601,44.31053925
227,"AURORA CO",7,36,16,10,10,36,-104.8693161,39.73983765
227,"AURORA IL",7,18,5,2,11,18,-88.32048798,41.76070023
227,"AUSTELL GA",7,1,0,0,1,1,-84.63414001,33.81290054
227,"AUSTIN MN",7,2,1,1,0,2,-92.97491455,43.6665535
227,"AUSTIN TX",7,1264,418,333,513,1264,-97.74386597,30.26748466
227,"AUSTINTOWN OH",7,33,12,7,14,33,-80.76424408,41.10162354
227,"AVIS PA",7,2,0,1,1,2,-77.31352997,41.1848526
227,"AVONDALE AZ",7,9,4,2,3,9,-112.3513947,33.43592072
227,"AYER MA",7,1,0,1,0,1,-71.57945251,42.55764771
227,"BAKERSFIELD CA",7,53,18,16,19,53,-119.0206375,35.37326813
227,"BALDWIN CITY KS",7,2,0,1,1,2,-95.18656921,38.77522659
227,"BALDWIN IL",7,1,1,0,0,1,-89.84280396,38.1832962
227,"BALDWIN PARK CA",7,1,0,1,0,1,-117.9624786,34.08519363
227,"BALDWINSVILLE NY",7,1,0,0,1,1,-76.33219147,43.15886307
227,"BALLSTON SPA NY",7,7,2,0,5,7,-73.84790039,43.00103378
227,"BALLWIN MO",7,27,8,6,13,27,-90.54669189,38.5951004
227,"BALTIMORE MD",7,834,266,228,340,834,-76.6115799,39.29075623
227,"BANGOR ME",7,8,3,3,2,8,-68.77653503,44.80109406
227,"BAR HARBOR ME",7,6,3,1,2,6,-68.20309448,44.38752747
227,"BARDSTOWN KY",7,8,2,1,1,4,-85.46318817,37.810512545
227,"BARNESVILLE GA",7,2,1,0,1,2,-84.15583038,33.05487442
227,"BARRE VT",7,1,1,0,0,1,-72.50119781,44.19706345
227,"BARTLESVILLE OK",7,2,0,0,2,2,-95.98135376,36.74737549
227,"BARTLETT TN",7,1,0,0,1,1,-89.87441254,35.20460892
227,"BARTONVILLE IL",7,24,7,5,12,24,-89.65235138,40.6502037
227,"BASTROP TX",7,5,2,2,1,5,-97.31572723,30.11092758
227,"BATAVIA OH",7,1,0,0,1,1,-84.17655182,39.07704926
227,"BATESVILLE MS",7,7,3,1,3,7,-89.94464874,34.31167603
227,"BATON ROUGE LA",7,99,37,22,40,99,-91.15479279,30.45132256
227,"BATTLE CREEK MI",7,2,1,1,0,2,-85.17985535,42.32100677
227,"BATTLE GROUND WA",7,2,0,1,1,2,-122.5356064,45.78078842
227,"BATTLE LAKE MN",7,1,1,0,0,1,-95.71406555,46.28032303
227,"BAXLEY GA",7,1,0,1,0,1,-82.34827423,31.77871323
227,"BAY CITY MI",7,4,1,1,2,4,-83.8886261,43.59466171
227,"BAY HARBOR ISLANDS FL",7,1,1,0,0,1,-80.13056946,25.88832092
227,"BAY SPRINGS MS",7,3,0,3,0,3,-89.28733826,31.97930336
227,"BAY VILLAGE OH",7,5,4,0,1,5,-81.92155457,41.48464966
227,"BAYONNE NJ",7,3,1,1,1,3,-74.10975647,40.66794968
227,"BAYTOWN TX",7,23,6,10,7,23,-94.97782135,29.73608589
227,"BEACON NY",7,4,1,2,1,4,-73.9688797,41.50502014
227,"BEAUFORT NC",7,9,4,3,2,9,-76.66288757,34.71848679
227,"BEAUFORT SC",7,1,0,1,0,1,-80.68718719,32.44019699
227,"BEAUMONT CA",7,3,1,0,2,3,-116.9783173,33.9292717
227,"BEAUMONT TX",7,15,5,5,5,15,-94.10238647,30.08622551
227,"BEAVER PA",7,1,0,1,0,1,-80.30450439,40.69532776
227,"BEAVERCREEK OH",7,3,0,0,3,3,-84.06332397,39.70913696
227,"BEAVERTON OR",7,29,13,5,11,29,-122.8055344,45.48670197
227,"BEDFORD MA",7,1,0,0,1,1,-71.27526855,42.49069214
227,"BEDFORD NY",7,2,1,1,0,2,-73.64318085,41.204319
227,"BEDFORD OH",7,5,1,1,3,5,-81.53594208,41.39339828
227,"BEDFORD PA",7,4,1,1,2,4,-78.50319672,40.01898575
227,"BEDFORD VA",7,2,0,2,0,2,-79.52242279,37.33457184
227,"BEE CAVE TX",7,1,0,0,1,1,-97.94541931,30.30895233
227,"BEL AIR MD",7,2,0,1,1,2,-76.34788513,39.53611374
227,"BELDING MI",7,3,1,1,1,3,-85.22901917,43.09791946
227,"BELEN NM",7,5,0,4,1,5,-106.7750244,34.65850067
227,"BELL CA",7,2,1,1,0,2,-118.1889572,33.97753906
227,"BELLEAIR BEACH FL",7,1,0,1,0,1,-82.84260559,27.9237709
227,"BELLEVILLE IL",7,49,19,17,13,49,-89.98438263,38.52002716
227,"BELLEVILLE NJ",7,2,1,1,0,2,-74.14912415,40.79369736
227,"BELLEVUE NE",7,4,2,2,0,4,-95.89156342,41.13648224
227,"BELLEVUE WA",7,14,7,1,6,14,-122.2029648,47.61014557
227,"BELLFLOWER CA",7,2,0,0,2,2,-118.1186295,33.88169479
227,"BELLINGHAM WA",7,58,15,10,33,58,-122.4727402,48.76121521
227,"BELLMAWR NJ",7,4,1,1,2,4,-75.09385681,39.86771774
227,"BELLPORT NY",7,2,2,0,0,2,-72.93808746,40.75737
227,"BELMONT CA",7,4,3,1,0,4,-122.2783508,37.51996613
227,"BELMONT MA",7,1,1,0,0,1,-71.1774292,42.39597321
227,"BELMONT MS",7,2,0,1,1,2,-88.20941162,34.51007462
227,"BELMONT NC",7,5,3,1,1,5,-81.0369873,35.24316406
227,"BELOIT WI",7,1,0,0,1,1,-89.03194427,42.50856781
227,"BELTON MO",7,2,1,0,1,2,-94.53222656,38.81176376
227,"BELTON TX",7,1,0,0,1,1,-97.46511841,31.05611229
227,"BEMIDJI MN",7,1,0,1,0,1,-94.88105774,47.47352982
227,"BEND OR",7,49,17,7,25,49,-121.3171387,44.0577774
227,"BENICIA CA",7,1,1,0,0,1,-122.1603012,38.04900742
227,"BENSENVILLE IL",7,3,1,2,0,3,-87.94012451,41.95510483
227,"BENSON NC",7,1,0,1,0,1,-78.54795074,35.38231659
227,"BENTON HARBOR MI",7,6,2,0,4,6,-86.45429993,42.11692429
227,"BENTON KY",7,1,0,0,1,1,-88.35020447,36.85724258
227,"BENTONVILLE AR",7,11,3,3,5,11,-94.20933533,36.3728447
227,"BEREA KY",7,1,1,0,0,1,-84.29612732,37.5687027
227,"BEREA OH",7,4,1,1,2,4,-81.85396576,41.36633301
227,"BERGENFIELD NJ",7,1,0,0,1,1,-73.99640656,40.92791748
227,"BERKELEY CA",7,245,78,65,102,245,-122.2752533,37.87145615
227,"BERKELEY HEIGHTS NJ",7,2,1,0,1,2,-74.44181824,40.68349838
227,"BERKELEY MO",7,3,0,0,3,3,-90.33169556,38.75470734
227,"BERKLEY MI",7,1,0,0,1,1,-83.18341827,42.50307083
227,"BERRYVILLE VA",7,2,1,0,1,2,-77.9814682,39.15181732
227,"BERTHOUD CO",7,1,0,1,0,1,-105.0858917,40.30111313
227,"BERWYN IL",7,1,0,1,0,1,-87.79390717,41.85061646
227,"BESSEMER AL",7,4,2,0,2,4,-86.95465851,33.40222549
227,"BESSEMER CITY NC",7,1,0,0,1,1,-81.28375244,35.28520966
227,"BETHALTO IL",7,3,2,0,1,3,-90.04077911,38.90911865
227,"BETHEL PARK PA",7,2,0,0,2,2,-80.01592255,40.33843613
227,"BETHLEHEM PA",7,18,8,5,5,18,-75.36949921,40.62598801
227,"BETTENDORF IA",7,2,0,0,2,2,-90.51612854,41.52465439
227,"BEVERLY HILLS CA",7,43,19,8,16,43,-118.4019775,34.07383347
227,"BEVERLY MA",7,3,1,0,2,3,-70.87913513,42.55848312
227,"BEXLEY OH",7,1,0,0,1,1,-82.93772888,39.96929932
227,"BICKNELL IN",7,1,0,0,1,1,-87.30805969,38.77451324
227,"BIDDEFORD ME",7,1,0,1,0,1,-70.45225525,43.49275208
227,"BIG RAPIDS MI",7,1,1,0,0,1,-85.48376465,43.69808578
227,"BIG SANDY MT",7,2,0,2,0,2,-110.1191177,48.17901993
227,"BIG SPRING TX",7,5,1,0,4,5,-101.4811173,32.25181198
227,"BIG STONE GAP VA",7,1,0,0,1,1,-82.74668884,36.88179398
227,"BILLINGS MT",7,10,3,4,3,10,-108.504631,45.7833786
227,"BILOXI MS",7,3,1,1,1,3,-88.89369202,30.40021133
227,"BINGHAMTON NY",7,12,3,4,5,12,-75.91755676,42.0986557
227,"BIRMINGHAM AL",7,260,84,71,105,260,-86.80226898,33.52098846
227,"BIRMINGHAM MI",7,18,6,5,7,18,-83.21121216,42.54697418
227,"BISBEE AZ",7,29,11,9,9,29,-109.9298477,31.44821548
227,"BISCAYNE PARK FL",7,1,1,0,0,1,-80.18003845,25.88322449
227,"BISHOPVILLE SC",7,1,0,0,1,1,-80.24495697,34.21529007
227,"BISMARCK ND",7,3,0,1,2,3,-100.7789612,46.80673981
227,"BIXBY OK",7,1,0,0,1,1,-95.88382721,35.94215775
227,"BLACK MOUNTAIN NC",7,3,0,1,2,3,-82.32103729,35.61796188
227,"BLACKFOOT ID",7,3,1,0,2,3,-112.3463059,43.1905098
227,"BLACKSBURG VA",7,21,6,8,7,21,-80.41369629,37.22999573
227,"BLAND MO",7,2,1,1,0,2,-91.63315582,38.30200195
227,"BLOOMFIELD NJ",7,3,1,1,1,3,-74.18488312,40.8069458
227,"BLOOMINGTON IL",7,8,2,1,5,8,-88.99375916,40.48418045
227,"BLOOMINGTON IN",7,61,17,19,25,61,-86.53382874,39.16920471
227,"BLOOMINGTON MN",7,7,1,4,2,7,-93.29154205,44.82648849
227,"BLUE EARTH MN",7,3,2,0,1,3,-94.1026535,43.63752365
227,"BLUE HILL NE",7,3,1,2,0,3,-98.4491806,40.3325882
227,"BLUE ISLAND IL",7,1,0,0,1,1,-87.67993927,41.657444
227,"BLUE SPRINGS MO",7,3,0,2,1,3,-94.2820816,39.01689148
227,"BLUFF CITY TN",7,2,1,1,0,2,-82.26051331,36.47451019
227,"BLUFFTON GA",7,2,0,0,2,2,-84.86750031,31.5231266
227,"BLUFFTON SC",7,1,0,0,1,1,-80.86026001,32.23733902
227,"BLYTHEWOOD SC",7,1,1,0,0,1,-80.97387695,34.21453476
227,"BOCA RATON FL",7,26,9,7,10,26,-80.08280182,26.35960197
227,"BOILING SPRINGS NC",7,1,0,1,0,1,-81.66678619,35.25450516
227,"BOLINGBROOK IL",7,17,6,6,5,17,-88.06878662,41.69866562
227,"BONHAM TX",7,1,0,1,0,1,-96.17896271,33.57743454
227,"BONNE TERRE MO",7,1,0,0,1,1,-90.55574036,37.92339325
227,"BONNEY LAKE WA",7,1,0,0,1,1,-122.1883698,47.17679596
227,"BOONE NC",7,10,4,2,4,10,-81.67436218,36.21696472
227,"BOONTON NJ",7,3,0,3,0,3,-74.4063797,40.90301514
227,"BORDENTOWN NJ",7,3,3,0,0,3,-74.7159729,40.15003586
227,"BOSSIER CITY LA",7,5,0,5,0,5,-93.73249817,32.51643753
227,"BOSTON MA",7,1371,458,368,545,1371,-71.05905151,42.35883713
227,"BOTHELL WA",7,11,3,2,6,11,-122.2075424,47.75966263
227,"BOULDER CO",7,96,27,29,40,96,-105.2715302,40.01483917
227,"BOUND BROOK NJ",7,2,0,0,2,2,-74.53753662,40.5687561
227,"BOWIE MD",7,21,8,5,8,21,-76.77848816,39.00718689
227,"BOWLING GREEN KY",7,11,4,2,5,11,-86.4437027,36.99057388
227,"BOWLING GREEN OH",7,12,4,1,7,12,-83.65102386,41.37505341
227,"BOXFORD MA",7,5,2,0,3,5,-70.99541473,42.66123581
227,"BOYNTON BEACH FL",7,9,3,2,4,9,-80.066185,26.52592087
227,"BOZEMAN MT",7,12,5,2,5,12,-111.0471649,45.6803093
227,"BRADENTON FL",7,14,4,2,8,14,-82.57459259,27.49969101
227,"BRADFORD PA",7,1,0,1,0,1,-78.64337921,41.95611572
227,"BRADLEY IL",7,2,1,1,0,2,-87.86099243,41.14196014
227,"BRANSON MO",7,3,1,0,2,3,-93.21912384,36.64381409
227,"BRAZIL IN",7,1,0,0,1,1,-87.12501526,39.52391434
227,"BREMERTON WA",7,2,1,1,0,2,-122.6345291,47.56690598
227,"BRENHAM TX",7,1,0,0,1,1,-96.39807129,30.16748047
227,"BRENTWOOD CA",7,5,2,1,2,5,-121.6984329,37.93167496
227,"BREVARD NC",7,4,1,2,1,4,-82.73400116,35.23363113
227,"BREWSTER OH",7,2,1,0,1,2,-81.5980072,40.70691681
227,"BREWTON AL",7,1,0,1,0,1,-87.07205963,31.10564423
227,"BRIDGEPORT CT",7,14,4,4,6,14,-73.2040863,41.16743088
227,"BRIDGETON MO",7,2,2,0,0,2,-90.41161346,38.76696396
227,"BRIDGETON NJ",7,2,1,0,1,2,-75.23321533,39.42769623
227,"BRIGHTON CO",7,1,0,0,1,1,-104.8175278,39.97783661
227,"BRIGHTON IL",7,6,3,1,2,6,-90.14067841,39.03963089
227,"BRIGHTON MI",7,2,1,0,1,2,-83.78043365,42.52965546
227,"BRISTOL CT",7,14,6,2,6,14,-72.94853973,41.67193222
227,"BRISTOL PA",7,1,0,0,1,1,-74.85106659,40.10090637
227,"BRISTOL RI",7,1,0,0,1,1,-71.26984406,41.67538452
227,"BRISTOL TN",7,15,3,4,8,15,-82.17338562,36.58886719
227,"BRISTOL VA",7,1,0,1,0,1,-82.18840027,36.59663391
227,"BROADVIEW HEIGHTS OH",7,2,0,1,1,2,-81.68503571,41.31410217
227,"BROADVIEW IL",7,2,1,1,0,2,-87.85337067,41.86410522
227,"BROCKPORT NY",7,16,7,5,4,16,-77.93889618,43.213871
227,"BROCKTON MA",7,3,1,0,2,3,-71.01748657,42.08340454
227,"BROKEN ARROW OK",7,3,2,0,1,3,-95.79160309,36.05273056
227,"BRONXVILLE NY",7,1,1,0,0,1,-73.83145905,40.93828583
227,"BROOKFIELD IL",7,1,1,0,0,1,-87.85184479,41.82412338
227,"BROOKFIELD WI",7,2,1,1,0,2,-88.10640717,43.06070328
227,"BROOKINGS OR",7,1,0,0,1,1,-124.2865219,42.05229187
227,"BROOKLINE MA",7,7,1,2,4,7,-71.12002563,42.33176804
227,"BROOKLYN OH",7,2,1,1,0,2,-81.73506165,41.43965912
227,"BROOKLYN PARK MN",7,2,1,1,0,2,-93.35662079,45.09407043
227,"BROOKSIDE VILLAGE TX",7,4,1,1,2,4,-95.32555389,29.58737183
227,"BROOKSVILLE FL",7,3,0,1,2,3,-82.38734436,28.55600739
227,"BROOMFIELD CO",7,3,0,2,1,3,-105.0877686,39.92069244
227,"BROWNFIELD TX",7,1,1,0,0,1,-102.2751923,33.18150711
227,"BROWNWOOD TX",7,1,0,1,0,1,-98.99180603,31.70943642
227,"BRUNSWICK GA",7,6,3,2,1,6,-81.49102783,31.1502285
227,"BRUNSWICK OH",7,2,0,1,1,2,-81.84169769,41.23830795
227,"BRYAN TX",7,10,3,4,3,10,-96.3704071,30.67456818
227,"BRYANT AR",7,3,0,1,2,3,-92.48953247,34.59588242
227,"BUCHANAN MI",7,1,1,0,0,1,-86.3614502,41.82715225
227,"BUCKEYE AZ",7,6,2,1,3,6,-112.5852661,33.37036896
227,"BUCKHANNON WV",7,2,0,1,1,2,-80.22968292,38.99204254
227,"BUENA PARK CA",7,3,2,1,0,3,-117.999939,33.86748123
227,"BUENA VISTA CO",7,4,1,1,2,4,-106.1334534,38.84151459
227,"BUFFALO GAP TX",7,1,0,0,1,1,-99.82436371,32.2901001
227,"BUFFALO GROVE IL",7,1,1,0,0,1,-87.95986176,42.15155411
227,"BUFFALO NY",7,196,55,58,83,196,-78.87787628,42.8867836
227,"BUFFALO WY",7,1,0,1,0,1,-106.6996536,44.3480072
227,"BUFORD GA",7,2,1,0,1,2,-84.00788879,34.11735535
227,"BUNKER HILL IL",7,1,0,1,0,1,-89.95170593,39.04272842
227,"BURBANK CA",7,29,8,4,17,29,-118.3104782,34.18065262
227,"BURLESON TX",7,2,1,1,0,2,-97.32151794,32.54247665
227,"BURLINGAME CA",7,2,0,0,2,2,-122.3685074,37.58408737
227,"BURLINGTON NC",7,1,1,0,0,1,-79.43729401,36.09585953
227,"BURLINGTON NJ",7,1,1,0,0,1,-74.86417389,40.07125092
227,"BURLINGTON VT",7,71,24,16,31,71,-73.20542908,44.47687531
227,"BURNET TX",7,1,0,1,0,1,-98.22889709,30.75881004
227,"BURNSVILLE MN",7,3,0,0,3,3,-93.27822113,44.76760483
227,"BUTLER PA",7,1,0,1,0,1,-79.89468384,40.86117172
227,"BYRON WY",7,1,0,1,0,1,-108.5082169,44.79620361
227,"CAHOKIA IL",7,2,0,1,1,2,-90.19016266,38.57118225
227,"CAIRO GA",7,10,3,0,7,10,-84.20102692,30.87791824
227,"CAIRO IL",7,1,1,0,0,1,-89.1803894,37.00523758
227,"CALABASAS CA",7,4,3,0,1,4,-118.6473236,34.1558876
227,"CALDWELL OH",7,1,0,0,1,1,-81.51609039,39.7481575
227,"CALDWELL TX",7,1,0,0,1,1,-96.69367218,30.53148842
227,"CALEDONIA MI",7,2,1,1,0,2,-85.51702118,42.78935623
227,"CALERA AL",7,3,1,0,2,3,-86.75354004,33.10300064
227,"CALIFORNIA MO",7,1,0,0,1,1,-92.56713104,38.62768555
227,"CALIFORNIA PA",7,2,1,0,1,2,-79.89154053,40.06599426
227,"CALIMESA CA",7,2,0,1,1,2,-117.0634689,34.00385666
227,"CALUMET MI",7,3,1,1,1,3,-88.45446777,47.24640274
227,"CAMARILLO CA",7,16,5,7,4,16,-119.0400391,34.21628952
227,"CAMAS WA",7,1,0,1,0,1,-122.4054489,45.58965683
227,"CAMBRIDGE MA",7,141,56,34,51,141,-71.10369873,42.36532593
227,"CAMBRIDGE OH",7,12,5,1,6,12,-81.58615875,40.02525711
227,"CAMDEN AR",7,1,0,0,1,1,-92.83481598,33.58491898
227,"CAMDEN NJ",7,29,10,7,12,29,-75.118927,39.92608261
227,"CAMPBELL CA",7,5,2,1,2,5,-121.951973,37.287117
227,"CANAL WINCHESTER OH",7,3,2,1,0,3,-82.80456543,39.84274673
227,"CANANDAIGUA NY",7,4,2,0,2,4,-77.28107452,42.88830948
227,"CANBY OR",7,2,0,1,1,2,-122.6948166,45.26276779
227,"CANONSBURG PA",7,2,1,1,0,2,-80.1868515,40.26278687
227,"CANTON GA",7,1,1,0,0,1,-84.48571014,34.23356628
227,"CANTON IL",7,5,4,0,1,5,-90.03516388,40.55800247
227,"CANTON MS",7,2,0,0,2,2,-90.03672028,32.61313248
227,"CANTON NC",7,2,1,1,0,2,-82.83691406,35.53314209
227,"CANTON NY",7,2,1,1,0,2,-75.16870117,44.59575272
227,"CANTON OH",7,31,8,6,17,31,-81.37824249,40.79906845
227,"CAPE CANAVERAL FL",7,2,0,1,1,2,-80.60503387,28.4044838
227,"CAPE CORAL FL",7,4,0,0,4,4,-81.9491806,26.56343079
227,"CAPE GIRARDEAU MO",7,40,11,16,13,40,-89.51838684,37.30613327
227,"CAPE MAY NJ",7,2,1,0,1,2,-74.90522766,38.93513107
227,"CAPITOL HEIGHTS MD",7,8,3,1,4,8,-76.91506195,38.88552475
227,"CARBONDALE IL",7,23,4,6,13,23,-89.2168808,37.7274704
227,"CARENCRO LA",7,1,0,0,1,1,-92.04903412,30.31741714
227,"CARLISLE PA",7,6,4,2,0,6,-77.18848419,40.20173264
227,"CARLSBAD CA",7,8,1,3,4,8,-117.3528137,33.1580162
227,"CARLSBAD NM",7,2,0,1,1,2,-104.2350617,32.41680527
227,"CARLTON MN",7,1,0,0,1,1,-92.42503357,46.66386795
227,"CARLYLE IL",7,1,0,0,1,1,-89.37243652,38.61019897
227,"CARMEL IN",7,1,0,0,1,1,-86.12607574,39.97961426
227,"CAROL STREAM IL",7,2,2,0,0,2,-88.13473511,41.91279221
227,"CARPINTERIA CA",7,7,1,2,4,7,-119.5201263,34.39894485
227,"CARRBORO NC",7,9,3,2,4,9,-79.07286835,35.91213989
227,"CARRIZO SPRINGS TX",7,2,0,0,2,2,-99.86119843,28.52256584
227,"CARROLLTON GA",7,4,0,2,2,4,-85.07631683,33.58019638
227,"CARROLLTON MO",7,1,0,1,0,1,-93.4960556,39.35842896
227,"CARROLLTON OH",7,1,0,0,1,1,-81.08522034,40.57297134
227,"CARROLLTON TX",7,4,1,1,2,4,-96.89080811,32.95380783
227,"CARSON CA",7,10,6,2,2,10,-118.2837448,33.8312645
227,"CARSON CITY NV",7,9,3,1,5,9,-119.7687988,39.16352844
227,"CARTERET NJ",7,3,0,2,1,3,-74.2276535,40.57754135
227,"CARTERSVILLE GA",7,6,2,2,2,6,-84.79982758,34.1654892
227,"CARTHAGE MO",7,3,3,0,0,3,-94.31087494,37.17650223
227,"CARUTHERSVILLE MO",7,1,0,1,0,1,-89.65577698,36.19351578
227,"CARY NC",7,28,11,3,14,28,-78.78055573,35.79200745
227,"CASA GRANDE AZ",7,10,3,2,5,10,-111.7590179,32.87965393
227,"CASCADE LOCKS OR",7,2,0,1,1,2,-121.8928452,45.66971588
227,"CASNOVIA MI",7,1,0,1,0,1,-85.79045105,43.23496628
227,"CASPER WY",7,1,0,0,1,1,-106.3147507,42.86667633
227,"CASTALIA OH",7,1,1,0,0,1,-82.80828857,41.40028
227,"CASTLE ROCK CO",7,3,0,0,3,3,-104.857811,39.37207031
227,"CASTLE SHANNON PA",7,1,0,1,0,1,-80.021698,40.3650856
227,"CATHEDRAL CITY CA",7,3,1,0,2,3,-116.4663467,33.77960205
227,"CATSKILL NY",7,1,0,1,0,1,-73.86399841,42.21760178
227,"CAZENOVIA NY",7,2,1,0,1,2,-75.85186005,42.93000031
227,"CEDAR FALLS IA",7,2,2,0,0,2,-92.44594574,42.52773285
227,"CEDAR HILL TX",7,12,2,1,3,6,-99.08098985,33.36628723
227,"CEDAR PARK TX",7,2,1,0,1,2,-97.82061005,30.50554466
227,"CEDAR RAPIDS IA",7,42,14,4,24,42,-91.66259766,41.98337555
227,"CEDARBURG WI",7,1,0,0,1,1,-87.9877243,43.29684067
227,"CENTER LINE MI",7,3,2,0,1,3,-83.02747345,42.48490524
227,"CENTER POINT AL",7,1,1,0,0,1,-86.68362427,33.64584732
227,"CENTERVILLE IA",7,1,1,0,0,1,-92.87467957,40.73418045
227,"CENTERVILLE OH",7,1,0,1,0,1,-84.15953064,39.6285553
227,"CENTREVILLE IL",7,3,0,0,3,3,-90.12549591,38.58330154
227,"CERES CA",7,13,4,6,3,13,-120.9599075,37.59457016
227,"CERRITOS CA",7,3,0,0,3,3,-118.0665054,33.85832214
227,"CHADRON NE",7,1,1,0,0,1,-102.9998169,42.83535004
227,"CHAMBERSBURG PA",7,2,0,2,0,2,-77.66046906,39.93768692
227,"CHAMPAIGN IL",7,50,16,13,21,50,-88.24346161,40.11659622
227,"CHANDLER AZ",7,59,18,12,29,59,-111.8428345,33.3062439
227,"CHANHASSEN MN",7,1,1,0,0,1,-93.53160858,44.86223221
227,"CHANUTE KS",7,1,1,0,0,1,-95.45789337,37.67946243
227,"CHAPEL HILL NC",7,91,28,34,29,91,-79.05697632,35.91110611
227,"CHARDON OH",7,2,1,1,0,2,-81.2011795,41.58335114
227,"CHARLES TOWN WV",7,1,1,0,0,1,-77.86264038,39.29033279
227,"CHARLESTON IL",7,2,0,1,1,2,-88.17610931,39.49612045
227,"CHARLESTON MO",7,1,0,0,1,1,-89.35055542,36.92086792
227,"CHARLESTON SC",7,159,54,32,73,159,-79.93032074,32.77671814
227,"CHARLESTON WV",7,22,5,3,14,22,-81.63149261,38.34872055
227,"CHARLOTTE NC",7,775,237,220,318,775,-80.84257507,35.22746277
227,"CHARLOTTESVILLE VA",7,90,24,26,40,90,-78.49123383,38.03798676
227,"CHASE CITY VA",7,2,2,0,0,2,-78.45783997,36.79962921
227,"CHATHAM IL",7,1,1,0,0,1,-89.70467377,39.67619324
227,"CHATHAM NY",7,1,0,0,1,1,-73.59416199,42.3643074
227,"CHATHAM VA",7,1,1,0,0,1,-79.39749146,36.82584
227,"CHATSWORTH GA",7,2,1,0,1,2,-84.76963043,34.76615524
227,"CHATTANOOGA TN",7,76,21,22,33,76,-85.30583954,35.04058456
227,"CHAZY NY",7,1,0,0,1,1,-73.43500519,44.89001465
227,"CHECOTAH OK",7,3,1,2,0,3,-95.52338409,35.47038651
227,"CHEEKTOWAGA NY",7,4,0,4,0,4,-78.75413513,42.90357208
227,"CHELSEA MA",7,1,1,0,0,1,-71.03151703,42.39189529
227,"CHENEY WA",7,1,1,0,0,1,-117.5782547,47.48730087
227,"CHERRY HILL NJ",7,9,6,1,2,9,-75.03024292,39.93510437
227,"CHESAPEAKE BEACH MD",7,4,2,0,2,4,-76.53400421,38.68645096
227,"CHESAPEAKE VA",7,46,13,16,17,46,-76.27422333,36.81948853
227,"CHESHIRE CT",7,2,0,1,1,2,-72.89962006,41.50049591
227,"CHESTER PA",7,4,2,2,0,4,-75.35475159,39.84973145
227,"CHESTER SC",7,7,1,2,4,7,-81.2141037,34.7049675
227,"CHESTERFIELD MO",7,21,9,3,9,21,-90.5772934,38.6631279
227,"CHEVERLY MD",7,1,0,0,1,1,-76.91530609,38.92858505
227,"CHEVY CHASE MD",7,5,2,1,2,5,-77.07595825,38.97138977
227,"CHEWELAH WA",7,1,0,1,0,1,-117.7169418,48.27609634
227,"CHEYENNE WY",7,4,1,0,3,4,-104.8183899,41.13345718
227,"CHICAGO HEIGHTS IL",7,1,0,1,0,1,-87.63541412,41.506073
227,"CHICAGO IL",7,2755,900,740,1115,2755,-87.6503067,41.85000992
227,"CHICKAMAUGA GA",7,2,1,0,1,2,-85.29045105,34.87113571
227,"CHICO CA",7,74,26,22,26,74,-121.839447,39.72846222
227,"CHICOPEE MA",7,2,0,0,2,2,-72.60691071,42.14902496
227,"CHILLICOTHE MO",7,3,1,0,2,3,-93.55298615,39.79542542
227,"CHILLICOTHE OH",7,3,1,0,2,3,-82.98206329,39.33310699
227,"CHINA GROVE NC",7,7,1,3,3,7,-80.58115387,35.56945801
227,"CHOCTAW OK",7,1,1,0,0,1,-97.26795197,35.49282074
227,"CHRISTIANSBURG VA",7,1,0,1,0,1,-80.40843201,37.1302948
227,"CHULA VISTA CA",7,23,5,11,7,23,-117.0857468,32.64037704
227,"CINCINNATI OH",7,269,83,85,101,269,-84.51939392,39.10413742
227,"CINNAMINSON NJ",7,1,0,1,0,1,-74.99165344,39.9969101
227,"CIRCLEVILLE OH",7,1,0,0,1,1,-82.94564056,39.6006813
227,"CITRUS HEIGHTS CA",7,1,0,0,1,1,-121.2829208,38.70672607
227,"CLANTON AL",7,1,0,1,0,1,-86.62932587,32.83919907
227,"CLAREMONT CA",7,15,6,7,2,15,-117.7214508,34.09675217
227,"CLAREMORE OK",7,1,1,0,0,1,-95.61654663,36.31294632
227,"CLARENDON HILLS IL",7,1,0,0,1,1,-87.95468903,41.79769516
227,"CLARKSBURG WV",7,2,1,0,1,2,-80.34414673,39.28092575
227,"CLARKSVILLE TN",7,9,3,3,3,9,-87.35944366,36.52993011
227,"CLAYTON MO",7,4,3,0,1,4,-90.32382965,38.64260101
227,"CLAYTON NC",7,3,0,1,2,3,-78.45562744,35.6511879
227,"CLEAR LAKE SHORES TX",7,57,22,14,21,57,-95.03226471,29.54773712
227,"CLEARWATER FL",7,38,10,16,12,38,-82.79984283,27.9665451
227,"CLEBURNE TX",7,4,1,2,1,4,-97.38722992,32.34804535
227,"CLEMMONS NC",7,4,1,1,2,4,-80.38154602,36.02172089
227,"CLEMSON SC",7,4,1,1,2,4,-82.83683014,34.68382645
227,"CLEVELAND HEIGHTS OH",7,4,2,1,1,4,-81.55568695,41.52017975
227,"CLEVELAND OH",7,559,163,188,208,559,-81.69516754,41.49978256
227,"CLEVELAND TN",7,2,2,0,0,2,-84.87675476,35.15940094
227,"CLIFFSIDE PARK NJ",7,3,0,0,3,3,-73.98683167,40.82172394
227,"CLIFTON NJ",7,3,1,2,0,3,-74.16278076,40.85860062
227,"CLIFTON PARK NY",7,4,3,1,0,4,-73.76983643,42.8658638
227,"CLINTON IA",7,11,2,3,6,11,-90.19799042,41.84345627
227,"CLINTON IN",7,1,0,1,0,1,-87.39801025,39.65688324
227,"CLINTON KY",7,1,1,0,0,1,-88.99338531,36.66743469
227,"CLINTON MA",7,1,1,0,0,1,-71.69485474,42.42619705
227,"CLIO MI",7,2,1,1,0,2,-83.73412323,43.17772293
227,"CLIVE IA",7,2,1,0,1,2,-93.72477722,41.60302734
227,"CLOVIS CA",7,11,5,4,2,11,-119.7047043,36.82522583
227,"CLOVIS NM",7,1,0,0,1,1,-103.2067108,34.40181732
227,"CLUTE TX",7,1,1,0,0,1,-95.39927673,29.02498436
227,"COATESVILLE PA",7,6,1,1,4,6,-75.82329559,39.98334885
227,"COATS NC",7,2,0,1,1,2,-78.6716156,35.40827179
227,"COCOA BEACH FL",7,16,6,6,4,16,-80.6068573,28.3203907
227,"COCOA FL",7,2,2,0,0,2,-80.74181366,28.38667297
227,"COLD SPRING NY",7,2,0,0,2,2,-73.9535675,41.42040253
227,"COLLEGE PARK GA",7,24,10,7,7,24,-84.44933319,33.65347672
227,"COLLEGE PARK MD",7,40,8,9,23,40,-76.93619537,38.98080444
227,"COLLEGE STATION TX",7,45,8,17,20,45,-96.33758545,30.62316895
227,"COLLEGEVILLE PA",7,1,0,1,0,1,-75.4506073,40.18598557
227,"COLLEYVILLE TX",7,1,1,0,0,1,-97.15543365,32.88101959
227,"COLLIERVILLE TN",7,2,0,1,1,2,-89.66448212,35.0423317
227,"COLLINGSWOOD NJ",7,3,1,1,1,3,-75.07028961,39.9186058
227,"COLLINSTON LA",7,1,1,0,0,1,-91.87198639,32.69124222
227,"COLLINSVILLE IL",7,4,1,2,1,4,-89.98478699,38.67050171
227,"COLMA CA",7,1,0,0,1,1,-122.4610977,37.67665482
227,"COLORADO SPRINGS CO",7,81,36,15,30,81,-104.8225174,38.83369446
227,"COLTON CA",7,3,0,1,2,3,-117.3153687,34.0738945
227,"COLUMBIA FALLS MT",7,1,1,0,0,1,-114.1933212,48.36879349
227,"COLUMBIA HEIGHTS MN",7,1,0,1,0,1,-93.24828339,45.04322815
227,"COLUMBIA IL",7,7,3,1,3,7,-90.20130157,38.44375992
227,"COLUMBIA MO",7,266,109,58,99,266,-92.33429718,38.95169067
227,"COLUMBIA SC",7,222,73,65,84,222,-81.04045105,34.00138855
227,"COLUMBIA TN",7,4,0,2,2,4,-87.03533173,35.61502457
227,"COLUMBUS GA",7,94,28,16,50,94,-84.98313141,32.46828842
227,"COLUMBUS IN",7,1,0,1,0,1,-85.92284393,39.20959473
227,"COLUMBUS NC",7,1,1,0,0,1,-82.19678497,35.25350189
227,"COLUMBUS NE",7,1,0,1,0,1,-97.36936188,41.42973709
227,"COLUMBUS OH",7,639,213,155,271,639,-82.99890137,39.96136475
227,"COMMERCE TX",7,10,5,2,3,10,-95.90060425,33.24729538
227,"COMPTON CA",7,19,4,5,10,19,-118.2218704,33.89606857
227,"CONCORD CA",7,9,3,3,3,9,-122.0333328,37.97780228
227,"CONCORD NC",7,12,2,4,6,12,-80.57880402,35.4092598
227,"CONCORD NH",7,7,1,3,3,7,-71.53688812,43.20820999
227,"CONCORDIA KS",7,1,0,0,1,1,-97.66313934,39.57102203
227,"CONCORDIA MO",7,1,0,0,1,1,-93.56906128,38.98339462
227,"CONNELLSVILLE PA",7,2,0,2,0,2,-79.58900452,40.01786041
227,"CONNERSVILLE IN",7,1,0,1,0,1,-85.13545227,39.64817047
227,"CONOVER NC",7,8,4,3,1,8,-81.21835327,35.70663834
227,"CONROE TX",7,2,0,2,0,2,-95.45646667,30.31249237
227,"CONWAY AR",7,12,7,3,2,12,-92.4426651,35.08877563
227,"CONWAY SC",7,3,0,2,1,3,-79.04202271,33.83802795
227,"CONYERS GA",7,2,0,1,1,2,-84.0175705,33.66764832
227,"COOKEVILLE TN",7,3,1,1,1,3,-85.50189972,36.16290665
227,"COON RAPIDS MN",7,1,1,0,0,1,-93.32348633,45.16527176
227,"COOS BAY OR",7,2,0,0,2,2,-124.219841,43.36757278
227,"COPPELL TX",7,2,0,2,0,2,-97.01548004,32.95487213
227,"CORAL GABLES FL",7,19,5,6,8,19,-80.26779938,25.72242165
227,"CORINTH MS",7,6,1,3,2,6,-88.52302551,34.93960571
227,"CORINTH TX",7,1,0,0,1,1,-99.87008667,32.85448456
227,"CORONA CA",7,20,8,6,6,20,-117.5688171,33.87516785
227,"CORONADO CA",7,5,3,1,1,5,-117.1846619,32.6861763
227,"CORPUS CHRISTI TX",7,27,6,9,12,27,-97.42076874,27.77859879
227,"CORSICANA TX",7,1,1,0,0,1,-96.46954346,32.09554291
227,"CORTLAND NY",7,6,2,2,2,6,-76.17972565,42.60138702
227,"CORVALLIS OR",7,9,2,2,5,9,-123.2646637,44.56417084
227,"COSTA MESA CA",7,3,1,1,1,3,-117.9204407,33.64131927
227,"COTATI CA",7,5,0,4,1,5,-122.7091904,38.32655334
227,"COUNCIL BLUFFS IA",7,6,2,3,1,6,-95.86154938,41.26196289
227,"COUNCIL GROVE KS",7,6,3,1,2,6,-96.49236298,38.66096115
227,"COURTLAND MS",7,1,0,0,1,1,-89.94303894,34.24124146
227,"COVINA CA",7,3,1,0,2,3,-117.8919067,34.09014511
227,"COVINGTON GA",7,6,1,2,3,6,-83.86009216,33.59708405
227,"COVINGTON KY",7,3,1,2,0,3,-84.50816345,39.08356476
227,"CRAIG CO",7,1,0,0,1,1,-107.5479813,40.51535034
227,"CRANSTON RI",7,1,1,0,0,1,-71.43634033,41.77997971
227,"CRAWFORDSVILLE IN",7,2,0,2,0,2,-86.89406586,40.04439926
227,"CRESTVIEW FL",7,4,0,2,2,4,-86.57064819,30.76231766
227,"CREVE COEUR MO",7,1,1,0,0,1,-90.42288971,38.66108322
227,"CROSSVILLE TN",7,5,1,0,4,5,-85.0270462,35.9490509
227,"CROTON-ON-HUDSON NY",7,9,2,3,4,9,-73.89041901,41.2085762
227,"CROWN POINT IN",7,6,1,2,3,6,-87.36541748,41.41695023
227,"CRYSTAL LAKE IL",7,2,0,0,2,2,-88.3161087,42.2411499
227,"CUBA MO",7,4,2,0,2,4,-91.40387726,38.06311035
227,"CUERO TX",7,5,2,0,3,5,-97.28947449,29.09457397
227,"CULPEPER VA",7,5,2,1,2,5,-77.99610901,38.47347641
227,"CUMBERLAND MD",7,4,0,3,1,4,-78.76217651,39.65284729
227,"CUMBY TX",7,2,2,0,0,2,-95.8399353,33.13761902
227,"CUMMING GA",7,12,4,4,4,12,-84.1401825,34.2074852
227,"CUPERTINO CA",7,7,2,2,3,7,-122.0342026,37.32306671
227,"CUT AND SHOOT TX",7,17,5,8,4,17,-95.35832214,30.33357811
227,"CUYAHOGA FALLS OH",7,8,3,2,3,8,-81.48397064,41.1338768
227,"DACULA GA",7,5,2,1,2,5,-83.89762878,33.9887352
227,"DAHLONEGA GA",7,2,0,1,1,2,-83.98484802,34.53287125
227,"DALHART TX",7,1,0,1,0,1,-102.5146484,36.05970764
227,"DALLAS GA",7,3,1,0,2,3,-84.84075165,33.92391586
227,"DALLAS TX",7,1320,433,336,551,1320,-96.80088043,32.78369904
227,"DALTON GA",7,13,3,3,7,13,-84.97008514,34.76976776
227,"DALY CITY CA",7,20,2,8,10,20,-122.4645081,37.70376968
227,"DANBURY CT",7,8,2,3,3,8,-73.45310974,41.39499664
227,"DANFORTH ME",7,1,0,0,1,1,-67.86733246,45.66029358
227,"DANVILLE CA",7,3,0,1,2,3,-122.0023193,37.82156754
227,"DANVILLE IL",7,3,1,0,2,3,-87.62978363,40.12442398
227,"DANVILLE IN",7,3,0,3,0,3,-86.52632904,39.76076126
227,"DANVILLE KY",7,1,0,1,0,1,-84.77213287,37.6458931
227,"DANVILLE VA",7,1,1,0,0,1,-79.39437866,36.58641434
227,"DAPHNE AL",7,2,1,0,1,2,-87.90383148,30.60381317
227,"DARIEN CT",7,1,1,0,0,1,-73.46835327,41.0790329
227,"DAVENPORT FL",7,1,0,1,0,1,-81.60109711,28.1620388
227,"DAVENPORT IA",7,13,3,3,7,13,-90.57814026,41.52380753
227,"DAVIDSON NC",7,2,0,0,2,2,-80.8433075,35.49843216
227,"DAVIE FL",7,2,1,1,0,2,-80.23148346,26.0657177
227,"DAVIS CA",7,23,10,6,7,23,-121.7421722,38.54467773
227,"DAYTON KY",7,2,0,1,1,2,-84.47278595,39.11274338
227,"DAYTON OH",7,117,38,34,45,117,-84.19126892,39.75915146
227,"DAYTON TN",7,2,1,0,1,2,-85.01251221,35.49424744
227,"DAYTONA BEACH FL",7,49,11,13,25,49,-81.02253723,29.21147537
227,"DE PERE WI",7,1,1,0,0,1,-88.06053925,44.4486618
227,"DE SOTO MO",7,1,0,0,1,1,-90.55529022,38.13964462
227,"DEARBORN MI",7,28,6,12,10,28,-83.1758728,42.32239914
227,"DEBARY FL",7,2,0,1,1,2,-81.30838776,28.88345909
227,"DECATUR AL",7,7,2,2,3,7,-86.98355103,34.60622406
227,"DECATUR GA",7,36,17,6,13,36,-84.29631805,33.77489471
227,"DECATUR IL",7,2,1,0,1,2,-88.95516968,39.84060287
227,"DECATUR IN",7,1,0,0,1,1,-84.93001556,40.82580566
227,"DEDHAM MA",7,2,1,1,0,2,-71.16512299,42.24193954
227,"DEER CREEK OK",7,8,2,4,2,8,-97.51993561,36.80317307
227,"DEERFIELD BEACH FL",7,16,7,4,5,16,-80.09928131,26.31905365
227,"DEERFIELD IL",7,3,1,0,2,3,-87.84490204,42.17103577
227,"DEFIANCE OH",7,2,1,1,0,2,-84.35565948,41.28461838
227,"DEL MAR CA",7,2,1,1,0,2,-117.2663345,32.95969391
227,"DEL RIO TX",7,1,1,0,0,1,-100.8970642,29.36329842
227,"DELANO CA",7,1,0,0,1,1,-119.2488785,35.76877975
227,"DELAVAN WI",7,1,0,1,0,1,-88.644104,42.6329422
227,"DELAWARE CITY DE",7,7,4,0,3,7,-75.59502411,39.57416534
227,"DELAWARE OH",7,4,0,2,2,4,-83.06757355,40.29886627
227,"DELPHOS OH",7,2,0,1,1,2,-84.34170532,40.84327698
227,"DELRAY BEACH FL",7,14,3,8,3,14,-80.07209778,26.46233368
227,"DELTA CO",7,4,2,0,2,4,-108.0698395,38.74222946
227,"DENHAM SPRINGS LA",7,2,0,2,0,2,-90.95632935,30.4871006
227,"DENISON IA",7,1,0,1,0,1,-95.35573578,42.01762009
227,"DENTON NC",7,3,0,2,1,3,-80.1153183,35.63389587
227,"DENTON TX",7,82,27,21,34,82,-97.13349915,33.21514893
227,"DENVER CO",7,710,242,166,302,710,-104.9853745,39.73901749
227,"DEPEW NY",7,1,0,1,0,1,-78.69154358,42.90420532
227,"DERBY KS",7,1,0,1,0,1,-97.26980591,37.54567719
227,"DES MOINES IA",7,114,33,42,39,114,-93.6210022,41.59817123
227,"DES PERES MO",7,1,0,1,0,1,-90.43345642,38.60096741
227,"DES PLAINES IL",7,4,1,2,1,4,-87.8833847,42.03343964
227,"DESTIN FL",7,6,1,1,4,6,-86.49551392,30.39405632
227,"DETROIT MI",7,534,170,140,224,534,-83.04567719,42.33172226
227,"DIBOLL TX",7,1,0,1,0,1,-94.78146362,31.18740463
227,"DICKINSON TX",7,1,0,1,0,1,-95.05158234,29.46142769
227,"DILLON SC",7,2,0,1,1,2,-79.37909698,34.41096115
227,"DISTRICT HEIGHTS MD",7,2,0,2,0,2,-76.88869476,38.85776138
227,"DIXON CA",7,1,1,0,0,1,-121.8243713,38.44569778
227,"DOLGEVILLE NY",7,1,0,1,0,1,-74.77229309,43.10081863
227,"DOLTON IL",7,1,1,0,0,1,-87.6072998,41.63914108
227,"DONIPHAN MO",7,5,2,2,1,5,-90.82394409,36.62110138
227,"DONORA PA",7,1,0,1,0,1,-79.85721588,40.17367935
227,"DOTHAN AL",7,4,3,0,1,4,-85.39019775,31.22351265
227,"DOUGLAS GA",7,12,7,1,4,12,-82.84980011,31.50903511
227,"DOUGLASVILLE GA",7,10,5,1,4,10,-84.74777222,33.75165939
227,"DOVER DE",7,5,0,1,4,5,-75.52090454,39.15853882
227,"DOVER NH",7,1,0,1,0,1,-70.88840485,43.2059021
227,"DOYLESTOWN OH",7,2,1,1,0,2,-81.69629669,40.96931458
227,"DOYLESTOWN PA",7,5,1,2,2,5,-75.1292038,40.31054688
227,"DU QUOIN IL",7,1,1,0,0,1,-89.2414856,38.01353455
227,"DUARTE CA",7,1,0,1,0,1,-117.9786072,34.13949966
227,"DUBLIN CA",7,4,1,2,1,4,-121.9383392,37.70181274
227,"DUBUQUE IA",7,10,6,2,2,10,-90.67155457,42.51130295
227,"DULUTH MN",7,8,3,2,3,8,-92.10697174,46.78300858
227,"DUNCAN OK",7,1,1,0,0,1,-97.95820618,34.50245667
227,"DUNCANNON PA",7,1,0,0,1,1,-77.03134155,40.38898087
227,"DUNCANVILLE TX",7,6,1,3,2,6,-96.9091568,32.65229034
227,"DUNEDIN FL",7,4,0,3,1,4,-82.77127838,28.02050591
227,"DURANGO CO",7,1,0,1,0,1,-107.8810043,37.27463913
227,"DURHAM NC",7,225,73,60,92,225,-78.89787292,35.99412918
227,"DURHAM NH",7,1,0,1,0,1,-70.92732239,43.13511276
227,"EAGAN MN",7,3,3,0,0,3,-93.16746521,44.80387878
227,"EAGLE ID",7,1,0,1,0,1,-116.3559189,43.69528198
227,"EAGLE PASS TX",7,2,0,1,1,2,-100.5002899,28.70978737
227,"EARTH TX",7,3,2,1,0,3,-102.4116135,34.23358154
227,"EAST GREENWICH RI",7,7,2,2,3,7,-71.45487976,41.66058731
227,"EAST HAMPTON NY",7,1,0,0,1,1,-72.18353271,40.96551895
227,"EAST HARTFORD CT",7,4,2,0,2,4,-72.64693451,41.77160263
227,"EAST HELENA MT",7,8,3,2,3,8,-111.9177475,46.58939743
227,"EAST HILLS NY",7,1,1,0,0,1,-73.62597656,40.79386902
227,"EAST LANSING MI",7,70,23,16,31,70,-84.48403931,42.73703384
227,"EAST LIVERPOOL OH",7,2,0,0,2,2,-80.57673645,40.61891556
227,"EAST MCKEESPORT PA",7,10,4,2,4,10,-79.80618286,40.38326645
227,"EAST MOLINE IL",7,1,0,1,0,1,-90.44459534,41.50070953
227,"EAST ORANGE NJ",7,41,13,9,19,41,-74.21418762,40.76618958
227,"EAST PALO ALTO CA",7,1,0,0,1,1,-122.143013,37.46857452
227,"EAST POINT GA",7,24,9,5,10,24,-84.43933868,33.67996979
227,"EAST PROVIDENCE RI",7,3,2,0,1,3,-71.36916351,41.81398392
227,"EAST TROY WI",7,1,0,0,1,1,-88.40551758,42.78525925
227,"EASTON MD",7,2,0,1,1,2,-76.07592773,38.77448654
227,"EASTON PA",7,5,1,2,2,5,-75.21966553,40.68871689
227,"EAU CLAIRE WI",7,5,2,2,1,5,-91.49876404,44.81137466
227,"EDEN PRAIRIE MN",7,11,3,4,4,11,-93.48716736,44.85310745
227,"EDINBORO PA",7,11,1,5,5,11,-80.13100433,41.87437439
227,"EDINBURG TX",7,15,7,1,7,15,-98.16417694,26.30259705
227,"EDINBURGH IN",7,1,0,1,0,1,-85.96690369,39.35437775
227,"EDMOND OK",7,27,9,10,8,27,-97.48453522,35.65326309
227,"EDMONDS WA",7,17,11,1,5,17,-122.3799057,47.81037521
227,"EDWARDSVILLE IL",7,57,24,12,21,57,-89.95322418,38.8115654
227,"EFFINGHAM IL",7,1,1,0,0,1,-88.54359436,39.12008667
227,"EL CAJON CA",7,1,0,1,0,1,-116.9467392,32.83002472
227,"EL CENTRO CA",7,1,1,0,0,1,-115.5646057,32.79199982
227,"EL CERRITO CA",7,17,12,2,3,17,-122.3142548,37.91544342
227,"EL DORADO AR",7,1,0,1,0,1,-92.66680908,33.20800018
227,"EL LAGO TX",7,1,1,0,0,1,-95.04547119,29.56394196
227,"EL MONTE CA",7,3,1,0,2,3,-118.0298996,34.06880569
227,"EL PASO TX",7,63,27,10,26,63,-106.4620514,31.78388405
227,"EL RENO OK",7,1,0,0,1,1,-97.95549011,35.53218842
227,"EL SEGUNDO CA",7,6,3,0,3,6,-118.4185257,33.91943741
227,"ELBA AL",7,1,0,1,0,1,-86.06761169,31.41489601
227,"ELGIN IL",7,5,0,3,2,5,-88.28123474,42.03733444
227,"ELGIN MN",7,1,0,1,0,1,-92.25218964,44.13041306
227,"ELGIN SC",7,5,0,5,0,5,-80.79399872,34.17118073
227,"ELIDA OH",7,1,0,0,1,1,-84.20368195,40.78894424
227,"ELIZABETH CITY NC",7,2,1,1,0,2,-76.22274017,36.3025322
227,"ELIZABETH CO",7,1,0,1,0,1,-104.5973434,39.36034393
227,"ELIZABETH NJ",7,5,0,3,2,5,-74.21881866,40.66823578
227,"ELIZABETHTOWN KY",7,1,0,1,0,1,-85.85932159,37.69418716
227,"ELIZABETHTOWN PA",7,7,2,3,2,7,-76.60209656,40.15314865
227,"ELK GROVE CA",7,72,20,24,28,72,-121.3743591,38.40848923
227,"ELK POINT SD",7,1,0,0,1,1,-96.68419647,42.68325424
227,"ELKHART IN",7,16,6,3,7,16,-85.97689056,41.68212128
227,"ELKHORN WI",7,1,1,0,0,1,-88.54447174,42.67270279
227,"ELKTON MD",7,1,1,0,0,1,-75.83261108,39.60694122
227,"ELLENSBURG WA",7,4,2,1,1,4,-120.5507507,46.99611664
227,"ELMIRA NY",7,11,2,4,5,11,-76.80737305,42.08998108
227,"ELMORE AL",7,1,0,0,1,1,-86.31501007,32.53902054
227,"ELMWOOD IL",7,2,2,0,0,2,-89.96702576,40.77780151
227,"ELMWOOD PARK NJ",7,1,0,1,0,1,-74.1175766,40.90429306
227,"ELYRIA OH",7,6,1,1,4,6,-82.10734558,41.36825562
227,"EMERYVILLE CA",7,1,0,0,1,1,-122.2871475,37.83127975
227,"EMMAUS PA",7,2,1,1,0,2,-75.49610138,40.53958893
227,"EMPORIA KS",7,1,0,0,1,1,-96.18218994,38.40393448
227,"ENCINITAS CA",7,3,1,1,1,3,-117.2937012,33.0371666
227,"ENGLEWOOD CO",7,5,3,0,2,5,-104.9884491,39.6479187
227,"ENGLEWOOD NJ",7,3,3,0,0,3,-73.97172546,40.8928833
227,"ENTERPRISE AL",7,1,0,0,1,1,-85.85494995,31.31528282
227,"EPHRATA PA",7,1,1,0,0,1,-76.17801666,40.17980194
227,"ERIE PA",7,35,11,7,17,35,-80.08492279,42.12926483
227,"ERLANGER KY",7,1,1,0,0,1,-84.60089111,39.01673508
227,"ESCANABA MI",7,1,0,1,0,1,-87.06468964,45.74517822
227,"ESCONDIDO CA",7,2,1,1,0,2,-117.0886231,33.11952591
227,"ESSEX JUNCTION VT",7,1,0,1,0,1,-73.11017609,44.49057007
227,"ESSEXVILLE MI",7,1,0,1,0,1,-83.84166718,43.61558151
227,"EUCLID OH",7,1,0,0,1,1,-81.52645111,41.59303284
227,"EUGENE OR",7,128,57,21,50,128,-123.0898361,44.05194855
227,"EULESS TX",7,6,2,1,3,6,-97.08273315,32.83728409
227,"EUREKA CA",7,2,1,1,0,2,-124.1653366,40.80156708
227,"EUREKA MO",7,3,3,0,0,3,-90.62799835,38.50252533
227,"EUSTIS FL",7,1,0,0,1,1,-81.68483734,28.85318184
227,"EVANS CO",7,2,1,1,0,2,-104.6938095,40.37656403
227,"EVANSTON IL",7,44,15,14,15,44,-87.69037628,42.04132843
227,"EVANSTON WY",7,12,3,6,3,12,-110.9652634,41.26803589
227,"EVANSVILLE IN",7,18,5,4,9,18,-87.56850433,37.97795486
227,"EVERETT MA",7,6,2,3,1,6,-71.05252075,42.40878296
227,"EVERETT WA",7,12,5,4,3,12,-122.2045441,47.97843552
227,"EVERGREEN PARK IL",7,1,0,1,0,1,-87.70169067,41.72086334
227,"EXETER CA",7,1,0,1,0,1,-119.1437607,36.29608917
227,"EXETER NH",7,13,6,2,5,13,-70.95800781,42.98471451
227,"FAIR HAVEN NJ",7,9,5,1,3,9,-74.03659821,40.35977936
227,"FAIRBANKS AK",7,10,2,3,5,10,-147.7185669,64.83367157
227,"FAIRBORN OH",7,2,0,2,0,2,-84.01902771,39.82121658
227,"FAIRFAX CA",7,1,0,1,0,1,-122.5909805,37.98677063
227,"FAIRFAX VA",7,42,14,9,19,42,-77.30588531,38.84661865
227,"FAIRFIELD AL",7,1,0,0,1,1,-86.91445923,33.49562073
227,"FAIRFIELD CA",7,6,1,0,5,6,-122.0420914,38.24917603
227,"FAIRFIELD CT",7,3,0,0,3,3,-73.26300049,41.14122772
227,"FAIRFIELD IA",7,1,0,1,0,1,-91.96311188,41.00863266
227,"FAIRFIELD OH",7,1,0,0,1,1,-84.56064606,39.34600449
227,"FAIRHAVEN MA",7,2,2,0,0,2,-70.902565,41.63794327
227,"FAIRMOUNT GA",7,1,1,0,0,1,-84.69966888,34.43648911
227,"FALL RIVER MA",7,2,2,0,0,2,-71.15414429,41.70151138
227,"FALLS CHURCH VA",7,7,3,2,2,7,-77.17056274,38.88268661
227,"FARGO ND",7,35,11,10,14,35,-96.79805756,46.87498474
227,"FARMERS BRANCH TX",7,4,1,1,2,4,-96.89679718,32.92665482
227,"FARMINGTON HILLS MI",7,2,0,1,1,2,-83.3771286,42.48558807
227,"FARMINGTON MI",7,3,1,0,2,3,-83.37620544,42.46465302
227,"FARMINGTON MN",7,1,0,0,1,1,-93.14386749,44.64002991
227,"FARMINGTON MO",7,4,1,0,3,4,-90.4220047,37.78110504
227,"FARMINGTON NM",7,4,0,3,1,4,-108.2051544,36.73355865
227,"FAYETTE MO",7,2,2,0,0,2,-92.68386078,39.14609146
227,"FAYETTEVILLE AR",7,38,13,10,15,38,-94.15759277,36.06256104
227,"FAYETTEVILLE NC",7,36,6,7,23,36,-78.87771606,35.05313873
227,"FAYETTEVILLE NY",7,3,1,1,1,3,-76.0059433,43.02997971
227,"FAYETTEVILLE TN",7,2,2,0,0,2,-86.57073212,35.15206146
227,"FEDERAL WAY WA",7,29,12,8,9,29,-122.314415,47.32177734
227,"FENTON MI",7,2,0,1,1,2,-83.70490265,42.79768372
227,"FENTON MO",7,39,10,8,21,39,-90.43593597,38.51305771
227,"FERGUSON MO",7,98,43,25,30,98,-90.306633,38.74429321
227,"FERNANDINA BEACH FL",7,7,2,3,2,7,-81.46240234,30.66996193
227,"FERNDALE MI",7,12,1,4,7,12,-83.13441467,42.46089172
227,"FERNDALE WA",7,1,0,1,0,1,-122.5937119,48.84636688
227,"FESTUS MO",7,1,0,0,1,1,-90.39609528,38.22088623
227,"FINDLAY OH",7,3,0,2,1,3,-83.64990997,41.04424286
227,"FISHERS IN",7,9,4,4,1,9,-86.0140152,39.95565414
227,"FITCHBURG MA",7,1,0,0,1,1,-71.79621124,42.58549881
227,"FITZGERALD GA",7,1,1,0,0,1,-83.25261688,31.71505928
227,"FLAGLER BEACH FL",7,8,3,3,2,8,-81.12680054,29.47527695
227,"FLAGSTAFF AZ",7,18,9,6,3,18,-111.6533051,35.19802475
227,"FLINT MI",7,36,8,8,20,36,-83.68744659,43.01246643
227,"FLORAL PARK NY",7,1,0,0,1,1,-73.70424652,40.72377777
227,"FLORENCE AL",7,7,1,1,5,7,-87.67726898,34.7997818
227,"FLORENCE CO",7,3,2,1,0,3,-105.119751,38.39019012
227,"FLORENCE KY",7,1,1,0,0,1,-84.62657166,38.99923706
227,"FLORENCE SC",7,28,6,8,14,28,-79.76351166,34.19935226
227,"FLORIDA CITY FL",7,1,0,0,1,1,-80.47893524,25.44846153
227,"FLORISSANT MO",7,185,86,31,68,185,-90.32299042,38.78946304
227,"FOLEY AL",7,1,1,0,0,1,-87.68378448,30.40701675
227,"FOND DU LAC WI",7,6,3,2,1,6,-88.44734955,43.77285004
227,"FONTANA CA",7,4,1,1,2,4,-117.4363785,34.09202576
227,"FOREST GROVE OR",7,2,0,2,0,2,-123.1123581,45.51952362
227,"FOREST MS",7,1,1,0,0,1,-89.47438812,32.36502075
227,"FOREST PARK IL",7,1,1,0,0,1,-87.81355286,41.87948608
227,"FORNEY TX",7,6,1,3,2,6,-96.47270966,32.74848175
227,"FORSYTH GA",7,1,0,1,0,1,-83.93824768,33.03457642
227,"FORT ATKINSON WI",7,4,0,1,3,4,-88.83695984,42.92907715
227,"FORT COLLINS CO",7,91,31,27,33,91,-105.0858688,40.58546066
227,"FORT LAUDERDALE FL",7,120,37,37,46,120,-80.14283752,26.12309074
227,"FORT LEE NJ",7,2,1,1,0,2,-73.96900177,40.85113907
227,"FORT LUPTON CO",7,1,0,1,0,1,-104.8086929,40.07614517
227,"FORT MILL SC",7,6,3,0,3,6,-80.94496155,35.00762558
227,"FORT MITCHELL KY",7,2,1,0,1,2,-84.54763031,39.05939865
227,"FORT MYERS FL",7,20,4,11,5,20,-81.87184143,26.64133644
227,"FORT PAYNE AL",7,1,1,0,0,1,-85.71984863,34.44424438
227,"FORT PIERCE FL",7,2,2,0,0,2,-80.32531738,27.44716644
227,"FORT SMITH AR",7,5,4,0,1,5,-94.39919281,35.3862114
227,"FORT VALLEY GA",7,1,0,0,1,1,-83.88742828,32.5541687
227,"FORT WALTON BEACH FL",7,10,5,1,4,10,-86.61834717,30.40767479
227,"FORT WAYNE IN",7,59,15,14,30,59,-85.13967896,41.07278061
227,"FORT WORTH TX",7,282,91,69,122,282,-97.32135773,32.72562027
227,"FOSTER CITY CA",7,3,0,0,3,3,-122.2733917,37.55817413
227,"FOWLERVILLE MI",7,1,1,0,0,1,-84.07279205,42.66091537
227,"FRAMINGHAM MA",7,5,2,1,2,5,-71.41543579,42.27958298
227,"FRANKENMUTH MI",7,1,1,0,0,1,-83.73799896,43.33162689
227,"FRANKFORT KY",7,5,3,1,1,5,-84.87322235,38.20124054
227,"FRANKLIN LA",7,3,0,2,1,3,-91.50192261,29.79652786
227,"FRANKLIN TN",7,11,4,2,5,11,-86.87760162,35.92164993
227,"FREDERICK MD",7,20,5,6,9,20,-77.40981293,39.41444397
227,"FREDERICKSBURG TX",7,4,1,2,1,4,-98.87243652,30.27570152
227,"FREDERICKSBURG VA",7,13,4,3,6,13,-77.45996094,38.30348969
227,"FREDONIA NY",7,1,1,0,0,1,-79.33128357,42.4403038
227,"FREEDOM PA",7,1,0,0,1,1,-80.25327301,40.68782806
227,"FREEPORT FL",7,6,3,2,1,6,-86.13587189,30.49859619
227,"FREEPORT IL",7,1,1,0,0,1,-89.62126923,42.29691696
227,"FREEPORT NY",7,3,1,0,2,3,-73.58229065,40.65803146
227,"FREEPORT TX",7,3,2,0,1,3,-95.35985565,28.95484543
227,"FREMONT CA",7,26,6,1,19,26,-121.9740372,37.55101776
227,"FREMONT OH",7,1,0,1,0,1,-83.12195587,41.35057831
227,"FRENCHTOWN NJ",7,1,1,0,0,1,-75.06065369,40.52624512
227,"FRESNO CA",7,70,23,16,31,70,-119.7739868,36.74755478
227,"FRIDLEY MN",7,5,2,2,1,5,-93.2636261,45.08617401
227,"FRIENDSWOOD TX",7,2,0,1,1,2,-95.20127106,29.53010368
227,"FRISCO TX",7,35,8,15,12,35,-96.82434082,33.15098572
227,"FRONT ROYAL VA",7,4,2,1,1,4,-78.19395447,38.91853714
227,"FRONTENAC MO",7,1,0,0,1,1,-90.41536713,38.63556671
227,"FROSTBURG MD",7,1,0,0,1,1,-78.92780304,39.65832138
227,"FULLERTON CA",7,11,4,2,5,11,-117.9268646,33.87014771
227,"FULSHEAR TX",7,1,1,0,0,1,-95.90010071,29.69036102
227,"FULTON MO",7,1,0,0,1,1,-91.94814301,38.84679031
227,"GADSDEN AL",7,2,1,0,1,2,-86.00675201,34.01457596
227,"GAHANNA OH",7,1,0,1,0,1,-82.87860107,40.02072525
227,"GAINESVILLE FL",7,105,35,32,38,105,-82.32462311,29.65203285
227,"GAINESVILLE GA",7,3,1,0,2,3,-83.82389832,34.29787827
227,"GAITHERSBURG MD",7,11,5,5,1,11,-77.20072174,39.14352417
227,"GALESBURG IL",7,15,7,0,8,15,-90.37152863,40.9480629
227,"GALLATIN TN",7,1,0,1,0,1,-86.44691467,36.38848495
227,"GALVESTON TX",7,4,0,3,1,4,-94.79576111,29.30070114
227,"GARDEN CITY MI",7,1,0,1,0,1,-83.33091736,42.32582092
227,"GARDEN CITY MO",7,1,0,0,1,1,-94.19150543,38.56124496
227,"GARDEN CITY NY",7,1,0,0,1,1,-73.63320923,40.72684097
227,"GARDEN GROVE CA",7,6,4,1,1,6,-117.943718,33.77397156
227,"GARDENA CA",7,6,0,4,2,6,-118.3105164,33.88837814
227,"GARDNER KS",7,7,2,1,4,7,-94.92789459,38.81066132
227,"GARLAND TX",7,18,4,5,9,18,-96.63926697,32.91297531
227,"GARNER NC",7,8,3,3,2,8,-78.61359406,35.71166992
227,"GARY IN",7,16,7,3,6,16,-87.33873749,41.59325409
227,"GASTON OR",7,2,2,0,0,2,-123.141571,45.43574142
227,"GASTONIA NC",7,9,2,2,5,9,-81.18706512,35.26216507
227,"GATESVILLE TX",7,1,0,1,0,1,-97.74459839,31.43569565
227,"GENESEO IL",7,1,0,0,1,1,-90.15467072,41.44804764
227,"GENEVA IL",7,2,2,0,0,2,-88.30541992,41.8876915
227,"GENOA CITY WI",7,1,0,1,0,1,-88.32978821,42.49824905
227,"GEORGETOWN KY",7,5,0,4,1,5,-84.55860138,38.21012115
227,"GEORGETOWN TX",7,9,3,2,4,9,-97.67801666,30.6329689
227,"GERMANTOWN TN",7,1,0,1,0,1,-89.80731201,35.08958817
227,"GETTYSBURG PA",7,5,0,1,4,5,-77.23023224,39.83097076
227,"GIG HARBOR WA",7,9,5,2,2,9,-122.590683,47.32983398
227,"GILBERT AZ",7,15,5,7,3,15,-111.7899933,33.35302353
227,"GILLESPIE IL",7,2,2,0,0,2,-89.81998444,39.12971115
227,"GILROY CA",7,5,1,0,4,5,-121.570343,37.00583267
227,"GLADSTONE MO",7,9,3,2,4,9,-94.55509186,39.20398331
227,"GLASGOW KY",7,8,2,3,3,8,-85.91189575,36.99584961
227,"GLENDALE AZ",7,8,4,1,3,8,-112.1871796,33.5386467
227,"GLENDALE CA",7,52,14,14,24,52,-118.2566681,34.1423645
227,"GLENDORA CA",7,2,0,1,1,2,-117.8665314,34.13615417
227,"GLENNVILLE GA",7,1,1,0,0,1,-81.92810822,31.93696594
227,"GLENS FALLS NY",7,1,1,0,0,1,-73.64286041,43.30945969
227,"GLENVIEW IL",7,1,1,0,0,1,-87.78792572,42.06991196
227,"GLENWOOD SPRINGS CO",7,5,2,2,1,5,-107.3256455,39.55069733
227,"GLOUCESTER CITY NJ",7,8,1,3,4,8,-75.11563873,39.89209747
227,"GLOUCESTER MA",7,1,0,1,0,1,-70.66117096,42.61589432
227,"GODFREY IL",7,3,2,1,0,3,-90.18669891,38.95780182
227,"GOLDEN CO",7,1,0,1,0,1,-105.2226791,39.75567627
227,"GOLDEN VALLEY MN",7,5,2,2,1,5,-93.33234406,44.98583603
227,"GOLDENDALE WA",7,1,1,0,0,1,-120.8248444,45.82035828
227,"GOLETA CA",7,1,1,0,0,1,-119.8299332,34.43574142
227,"GONZALES LA",7,3,1,1,1,3,-90.92044067,30.23900986
227,"GOODRICH TX",7,10,4,3,3,10,-94.9467926,30.60574341
227,"GOOSE CREEK SC",7,3,1,1,1,3,-80.03201294,32.98114395
227,"GOSHEN IN",7,3,1,1,1,3,-85.8345871,41.58250046
227,"GOWRIE IA",7,1,0,0,1,1,-94.29121399,42.28058243
227,"GRAND BLANC MI",7,2,0,0,2,2,-83.62955475,42.92750168
227,"GRAND FORKS ND",7,7,3,0,4,7,-97.03855133,47.92044067
227,"GRAND HAVEN MI",7,6,0,3,3,6,-86.22866058,43.06328964
227,"GRAND ISLAND NE",7,3,2,0,1,3,-98.34256744,40.92502213
227,"GRAND JUNCTION CO",7,9,1,4,4,9,-108.5520706,39.06374741
227,"GRAND LEDGE MI",7,1,0,1,0,1,-84.74642944,42.7535553
227,"GRAND PRAIRIE TX",7,4,1,1,2,4,-96.99823761,32.74625015
227,"GRAND RAPIDS MI",7,105,34,33,38,105,-85.66797638,42.96317291
227,"GRAND RAPIDS MN",7,1,0,1,0,1,-93.53067017,47.23724747
227,"GRANDVILLE MI",7,1,1,0,0,1,-85.76309204,42.90962982
227,"GRANITE CITY IL",7,78,27,23,28,78,-90.14891815,38.70147705
227,"GRANTHAM NH",7,2,1,1,0,2,-72.13131714,43.47785568
227,"GRANTS PASS OR",7,3,1,0,2,3,-123.3306351,42.43851471
227,"GRANVILLE OH",7,4,3,1,0,4,-82.51766205,40.06572723
227,"GRAPEVINE TX",7,13,2,2,9,13,-97.07859802,32.93464279
227,"GRASS VALLEY CA",7,4,3,0,1,4,-121.0632553,39.21873856
227,"GRAY COURT SC",7,1,1,0,0,1,-82.11286926,34.60851669
227,"GREAT BEND KS",7,7,3,2,2,7,-98.76521301,38.36428452
227,"GREAT FALLS MT",7,3,1,2,0,3,-111.2823257,47.50692368
227,"GREAT NECK NY",7,3,0,0,3,3,-73.72780609,40.80078125
227,"GREECE NY",7,4,0,1,3,4,-77.69234467,43.21003342
227,"GREELEY CO",7,7,3,0,4,7,-104.7104645,40.42345047
227,"GREEN BAY WI",7,53,16,18,19,53,-88.01370239,44.51335907
227,"GREENBELT MD",7,24,8,6,10,24,-76.87561035,39.00544357
227,"GREENDALE WI",7,1,0,1,0,1,-87.99612427,42.94078827
227,"GREENEVILLE TN",7,9,3,2,4,9,-82.83133698,36.16376495
227,"GREENFIELD IN",7,2,0,1,1,2,-85.76914978,39.78491974
227,"GREENFIELD WI",7,1,0,0,1,1,-88.01258087,42.96144104
227,"GREENSBORO MD",7,1,0,0,1,1,-75.80445862,38.97415161
227,"GREENSBORO NC",7,151,51,35,65,151,-79.79152679,36.0729599
227,"GREENSBURG PA",7,4,0,3,1,4,-79.53821564,40.30168915
227,"GREENVILLE MS",7,2,0,0,2,2,-91.05704498,33.40253448
227,"GREENVILLE NC",7,22,8,5,9,22,-77.37215424,35.61170959
227,"GREENVILLE OH",7,3,1,1,1,3,-84.63294983,40.10294342
227,"GREENVILLE SC",7,66,18,21,27,66,-82.39870453,34.84753418
227,"GREENWICH CT",7,7,2,3,2,7,-73.62783051,41.02645111
227,"GREENWOOD IN",7,8,4,1,3,8,-86.10647583,39.61371994
227,"GREENWOOD SC",7,4,1,2,1,4,-82.16146088,34.19546509
227,"GREENWOOD VILLAGE CO",7,1,1,0,0,1,-104.9518585,39.61724091
227,"GRESHAM OR",7,3,3,0,0,3,-122.4333954,45.4980278
227,"GRETNA LA",7,1,1,0,0,1,-90.05435181,29.91518021
227,"GRIFFIN GA",7,1,1,0,0,1,-84.26403046,33.24713135
227,"GRIFFITH IN",7,3,0,2,1,3,-87.42803955,41.52181625
227,"GRINNELL IA",7,1,0,0,1,1,-92.72964478,41.7466507
227,"GROSSE POINTE PARK MI",7,1,1,0,0,1,-82.93411255,42.37599182
227,"GROSSE POINTE WOODS MI",7,1,1,0,0,1,-82.90637207,42.4438858
227,"GROTON CT",7,10,6,1,3,10,-72.07763672,41.3502121
227,"GROTON NY",7,1,1,0,0,1,-76.36643982,42.58802032
227,"GROVE CITY OH",7,2,0,1,1,2,-83.09304047,39.88161087
227,"GROVETOWN GA",7,1,1,0,0,1,-82.19797516,33.45065308
227,"GRUNDY VA",7,1,0,1,0,1,-82.09902191,37.27806091
227,"GULF BREEZE FL",7,1,0,0,1,1,-87.16386414,30.35763931
227,"GULF SHORES AL",7,3,2,1,0,3,-87.70103455,30.24625969
227,"GULFPORT FL",7,4,2,0,2,4,-82.70953369,27.74733734
227,"GULFPORT MS",7,15,7,3,5,15,-89.09369659,30.37276649
227,"GUNNISON CO",7,2,1,0,1,2,-106.9267273,38.54576874
227,"GUNTERSVILLE AL",7,1,1,0,0,1,-86.29457855,34.3585434
227,"GUNTOWN MS",7,2,1,1,0,2,-88.66011047,34.44345093
227,"GURNEE IL",7,1,1,0,0,1,-87.90226746,42.37029648
227,"GUSTINE CA",7,9,2,4,3,9,-121.001297,37.25769043
227,"GUTHRIE OK",7,1,0,0,1,1,-97.42609406,35.87893677
227,"GUYTON GA",7,3,2,0,1,3,-81.3910675,32.3367691
227,"GYPSUM CO",7,2,0,0,2,2,-106.9528198,39.64703369
227,"HACKETTSTOWN NJ",7,1,0,0,1,1,-74.82810974,40.85408401
227,"HADDONFIELD NJ",7,39,10,14,15,39,-75.03710937,39.89155197
227,"HAGERSTOWN MD",7,4,2,0,2,4,-77.71956635,39.641819
227,"HAINES CITY FL",7,1,1,0,0,1,-81.61740875,28.1145668
227,"HALF MOON BAY CA",7,8,4,2,2,8,-122.4299774,37.46336365
227,"HALLSTEAD PA",7,18,8,6,4,18,-75.74239349,41.96153259
227,"HALTOM CITY TX",7,2,0,0,2,2,-97.26971436,32.79956055
227,"HAMBURG NY",7,2,0,1,1,2,-78.82896423,42.71609879
227,"HAMDEN CT",7,2,0,0,2,2,-72.89596558,41.39611816
227,"HAMILTON NJ",7,1,1,0,0,1,-74.0803299,40.20712662
227,"HAMILTON OH",7,9,1,1,7,9,-84.56098175,39.39949799
227,"HAMMOND IN",7,5,1,1,3,5,-87.50006104,41.58346558
227,"HAMMOND LA",7,2,1,0,1,2,-90.46140289,30.50458908
227,"HAMPTON GA",7,1,1,0,0,1,-84.28277588,33.3870697
227,"HAMPTON VA",7,25,7,10,8,25,-76.34473419,37.03002548
227,"HAMTRAMCK MI",7,2,0,2,0,2,-83.04947662,42.39274597
227,"HANAHAN SC",7,1,0,1,0,1,-80.01743317,32.92184448
227,"HANOVER PA",7,1,1,0,0,1,-76.98248291,39.80073929
227,"HARBOR BEACH MI",7,1,0,0,1,1,-82.65100861,43.84455872
227,"HARBOR SPRINGS MI",7,1,0,1,0,1,-84.99181366,45.43172455
227,"HARKER HEIGHTS TX",7,3,2,1,0,3,-97.66394806,31.08788109
227,"HARLINGEN TX",7,6,1,3,2,6,-97.69669342,26.19152069
227,"HARRIMAN TN",7,1,1,0,0,1,-84.55221558,35.93426514
227,"HARRINGTON PARK NJ",7,1,0,0,1,1,-73.97896576,40.98410034
227,"HARRISBURG IL",7,1,1,0,0,1,-88.54049683,37.73853302
227,"HARRISBURG NC",7,1,0,0,1,1,-80.65539551,35.32398224
227,"HARRISBURG PA",7,47,12,8,27,47,-76.88382721,40.27407455
227,"HARRISONBURG VA",7,46,11,18,17,46,-78.86815643,38.44975281
227,"HARTFORD CT",7,89,29,28,32,89,-72.68445587,41.76383591
227,"HARTLAND WI",7,2,1,1,0,2,-88.34208679,43.1048317
227,"HARTSVILLE SC",7,14,6,4,4,14,-80.07303619,34.37445068
227,"HARVEY IL",7,1,0,0,1,1,-87.64677429,41.61020279
227,"HASLET TX",7,1,0,1,0,1,-97.3484726,32.97494125
227,"HASTINGS MN",7,1,0,0,1,1,-92.85280609,44.7434082
227,"HASTINGS NE",7,3,2,1,0,3,-98.38917542,40.58628845
227,"HATFIELD PA",7,1,0,0,1,1,-75.29840088,40.28004074
227,"HATTIESBURG MS",7,12,5,4,3,12,-89.29040527,31.32738686
227,"HAVELOCK NC",7,1,1,0,0,1,-76.90039825,34.87951279
227,"HAW RIVER NC",7,1,0,0,1,1,-79.36388397,36.09186172
227,"HAWTHORNE CA",7,6,2,3,1,6,-118.3549194,33.91656113
227,"HAYMARKET VA",7,1,1,0,0,1,-77.63591766,38.81214142
227,"HAYS KS",7,3,0,2,1,3,-99.32746887,38.87940598
227,"HAYWARD CA",7,7,1,1,5,7,-122.0832672,37.66890335
227,"HAYWARD WI",7,1,1,0,0,1,-91.48522949,46.01277161
227,"HAZELTON ND",7,3,1,2,0,3,-100.2808533,46.48171997
227,"HAZELWOOD MO",7,1,0,1,0,1,-90.37133789,38.77171707
227,"HAZLEHURST MS",7,1,1,0,0,1,-90.39607239,31.86094666
227,"HAZLETON PA",7,3,1,0,2,3,-75.97418213,40.95857239
227,"HEALDSBURG CA",7,5,1,2,2,5,-122.8713226,38.6101799
227,"HEBER SPRINGS AR",7,1,0,1,0,1,-92.03152466,35.49176788
227,"HELENA MT",7,17,4,8,5,17,-112.0374527,46.59269333
227,"HELOTES TX",7,1,0,0,1,1,-98.69043732,29.57864761
227,"HEMET CA",7,1,1,0,0,1,-116.9736557,33.74770737
227,"HEMPSTEAD NY",7,3,0,1,2,3,-73.61798096,40.70619965
227,"HENDERSON KY",7,2,1,0,1,2,-87.58986664,37.8363266
227,"HENDERSON NC",7,4,1,2,1,4,-78.39831543,36.3300705
227,"HENDERSON NV",7,72,28,20,24,72,-114.9741058,36.03540421
227,"HENDERSONVILLE NC",7,7,1,1,5,7,-82.46079254,35.31912994
227,"HENDERSONVILLE TN",7,2,0,0,2,2,-86.61997986,36.30472565
227,"HENRIETTA NY",7,1,1,0,0,1,-77.61167145,43.05939865
227,"HERCULES CA",7,5,0,2,3,5,-122.2900772,38.01711655
227,"HERKIMER NY",7,1,1,0,0,1,-74.98493195,43.02587128
227,"HERMANN MO",7,2,0,1,1,2,-91.43791199,38.70432281
227,"HERMOSA BEACH CA",7,3,0,1,2,3,-118.401619,33.86245728
227,"HERNDON VA",7,4,2,2,0,4,-77.38563538,38.96995544
227,"HERRIN IL",7,1,1,0,0,1,-89.02784729,37.80303574
227,"HESPERIA CA",7,2,0,1,1,2,-117.3026352,34.42634964
227,"HIALEAH FL",7,11,3,2,6,11,-80.27757263,25.85853386
227,"HICKORY NC",7,7,4,0,3,7,-81.34054565,35.72800827
227,"HICKSVILLE OH",7,9,2,1,6,9,-84.76192474,41.29306412
227,"HIGH POINT NC",7,7,4,1,2,7,-80.00497437,35.95609665
227,"HIGHLAND BEACH FL",7,1,0,0,1,1,-80.06530762,26.40010643
227,"HIGHLAND CA",7,3,1,1,1,3,-117.2105789,34.12824631
227,"HIGHLAND IL",7,2,1,0,1,2,-89.6713562,38.73976135
227,"HIGHLAND PARK IL",7,1,0,0,1,1,-87.80068207,42.18181992
227,"HIGHLAND PARK NJ",7,5,0,3,2,5,-74.4232254,40.49617386
227,"HIGHLAND PARK TX",7,1,0,0,1,1,-96.80493164,32.8320961
227,"HIGHWOOD IL",7,1,1,0,0,1,-87.80953979,42.19964218
227,"HILLIARD OH",7,5,3,0,2,5,-83.15856171,40.03361511
227,"HILLSBORO IL",7,2,2,0,0,2,-89.4937439,39.16139603
227,"HILLSBORO MO",7,1,0,1,0,1,-90.56336975,38.23225021
227,"HILLSBORO OH",7,3,0,2,1,3,-83.61119843,39.20261765
227,"HILLSBORO OR",7,44,12,9,23,44,-122.9927826,45.52270508
227,"HILLSBORO TX",7,1,0,0,1,1,-97.13063812,32.01124573
227,"HILLSBOROUGH NC",7,4,2,1,1,4,-79.09932709,36.07565308
227,"HILLSDALE MI",7,2,0,2,0,2,-84.63027191,41.91994095
227,"HILLSIDE IL",7,1,1,0,0,1,-87.90297699,41.87789917
227,"HINSDALE NH",7,1,1,0,0,1,-72.48535156,42.78657913
227,"HIRAM OH",7,1,0,0,1,1,-81.14317322,41.31268311
227,"HOBART IN",7,2,1,0,1,2,-87.24478912,41.53391266
227,"HOBOKEN NJ",7,23,6,9,8,23,-74.0316925,40.7443428
227,"HOGANSVILLE GA",7,1,0,0,1,1,-84.91479492,33.17349243
227,"HOLCOMB KS",7,1,1,0,0,1,-100.9902344,37.98623276
227,"HOLDEN MA",7,1,0,1,0,1,-71.86223602,42.35177994
227,"HOLDREGE NE",7,1,0,1,0,1,-99.3705368,40.44029999
227,"HOLLAND MI",7,12,4,1,7,12,-86.10916138,42.78744507
227,"HOLLISTER CA",7,2,1,1,0,2,-121.4038849,36.85258865
227,"HOLLISTON MA",7,1,0,1,0,1,-71.42358398,42.2000885
227,"HOLLY SPRINGS NC",7,3,1,0,2,3,-78.83320618,35.65140915
227,"HOLLYWOOD FL",7,50,13,21,16,50,-80.14926147,26.01175499
227,"HOLTON KS",7,2,0,1,1,2,-95.73680115,39.46525955
227,"HOLYOKE MA",7,5,1,2,2,5,-72.61522675,42.20437241
227,"HOMER MI",7,1,0,0,1,1,-84.80869293,42.14587021
227,"HOMESTEAD FL",7,1,0,0,1,1,-80.47710419,25.46927071
227,"HOMETOWN IL",7,1,0,0,1,1,-87.73152924,41.73308182
227,"HOMEWOOD AL",7,3,1,0,2,3,-86.80097961,33.47186661
227,"HONEOYE FALLS NY",7,2,1,1,0,2,-77.58958435,42.95241547
227,"HOOD RIVER OR",7,1,0,1,0,1,-121.5108719,45.70785141
227,"HOPE AR",7,1,1,0,0,1,-93.59211731,33.66746902
227,"HOPE MILLS NC",7,3,2,1,0,3,-78.94456482,34.97066498
227,"HOPKINS MN",7,4,4,0,0,4,-93.39242554,44.92610168
227,"HORN LAKE MS",7,1,0,0,1,1,-90.03000641,34.96072769
227,"HORNELL NY",7,1,0,1,0,1,-77.66078949,42.3279686
227,"HORSEHEADS NY",7,1,0,1,0,1,-76.81996155,42.16708755
227,"HOT SPRINGS AR",7,20,3,8,9,20,-93.05556488,34.5039978
227,"HOUGHTON MI",7,3,1,1,1,3,-88.56951141,47.12665558
227,"HOUSTON MS",7,1,0,1,0,1,-88.99927521,33.89876556
227,"HOUSTON TX",7,1874,591,518,765,1874,-95.36399841,29.76376343
227,"HOWELL MI",7,2,0,1,1,2,-83.92946625,42.6072464
227,"HUDSON NC",7,2,0,1,1,2,-81.49536133,35.84866714
227,"HUDSON OH",7,1,1,0,0,1,-81.44026947,41.2401619
227,"HUMBLE TX",7,11,1,3,7,11,-95.26166534,29.99774551
227,"HUNTERSVILLE NC",7,6,1,2,3,6,-80.83785248,35.41359711
227,"HUNTINGTON BEACH CA",7,18,2,4,12,18,-118.0006027,33.66012955
227,"HUNTINGTON NY",7,1,0,0,1,1,-73.42463684,40.86833191
227,"HUNTINGTON UT",7,1,0,1,0,1,-110.966156,39.32650757
227,"HUNTINGTON WV",7,15,5,2,8,15,-82.44620514,38.4181366
227,"HUNTSVILLE AL",7,114,46,24,44,114,-86.58609772,34.73073959
227,"HUNTSVILLE TX",7,5,3,0,2,5,-95.55122375,30.72374153
227,"HUNTSVILLE UT",7,1,0,0,1,1,-111.7737732,41.26464844
227,"HURRICANE UT",7,1,0,0,1,1,-113.2914887,37.17508316
227,"HURST TX",7,3,1,1,1,3,-97.17115021,32.82357407
227,"HUTCHINSON KS",7,9,2,6,1,9,-97.93050385,38.06093216
227,"HUTTO TX",7,1,0,0,1,1,-97.54733276,30.54326057
227,"HYATTSVILLE MD",7,53,5,45,3,53,-76.94467163,38.95636749
227,"HYDE PARK NY",7,1,0,0,1,1,-73.93060303,41.79148865
227,"IDA MI",7,1,0,0,1,1,-83.57371521,41.91075516
227,"IDAHO FALLS ID",7,4,0,1,3,4,-112.035408,43.46630478
227,"IMPERIAL CA",7,6,1,2,3,6,-115.5716705,32.84782791
227,"INDEPENDENCE KY",7,2,2,0,0,2,-84.54380035,38.94332886
227,"INDEPENDENCE MO",7,8,1,4,3,8,-94.41611481,39.09104538
227,"INDIAN ROCKS BEACH FL",7,4,1,1,2,4,-82.85096741,27.87600517
227,"INDIANA PA",7,2,0,0,2,2,-79.15187073,40.6216507
227,"INDIANAPOLIS IN",7,308,96,84,128,308,-86.15828705,39.76844788
227,"INDIANOLA IA",7,2,1,0,1,2,-93.55815887,41.35812378
227,"INDIO CA",7,4,2,2,0,4,-116.2173004,33.72047043
227,"INGLEWOOD CA",7,45,15,11,19,45,-118.354805,33.96157074
227,"INGLIS FL",7,3,1,1,1,3,-82.66842651,29.03089333
227,"INKSTER MI",7,1,0,0,1,1,-83.31001282,42.29439926
227,"INMAN SC",7,2,0,1,1,2,-82.09005737,35.04743958
227,"INTERLACHEN FL",7,1,0,1,0,1,-81.8901062,29.62431526
227,"IOWA CITY IA",7,71,24,18,29,71,-91.53023529,41.66130066
227,"IPSWICH MA",7,3,1,0,2,3,-70.84001923,42.67964554
227,"IRMO SC",7,1,0,1,0,1,-81.18247223,34.08623123
227,"IRONDEQUOIT NY",7,1,0,0,1,1,-77.57932281,43.21369171
227,"IRRIGON OR",7,1,1,0,0,1,-119.4932404,45.89543915
227,"IRVINE CA",7,60,16,24,20,60,-117.8243942,33.66952515
227,"IRVING TX",7,16,4,5,7,16,-96.94924927,32.81419754
227,"IRVINGTON NY",7,3,2,1,0,3,-73.86441803,41.03897858
227,"ISSAQUAH WA",7,3,2,0,1,3,-122.0345993,47.52977753
227,"ITHACA NY",7,37,8,14,15,37,-76.49575043,42.44075775
227,"ITTA BENA MS",7,1,0,1,0,1,-90.32006073,33.49521255
227,"JACKSON MI",7,2,0,1,1,2,-84.40149689,42.24575043
227,"JACKSON MO",7,1,1,0,0,1,-89.66656494,37.38225174
227,"JACKSON MS",7,163,32,62,69,163,-90.19654846,32.298172
227,"JACKSON TN",7,58,12,16,30,58,-88.81397247,35.61472321
227,"JACKSON WY",7,6,2,4,0,6,-110.7644806,43.4798851
227,"JACKSONVILLE AL",7,5,4,0,1,5,-85.76148987,33.81370163
227,"JACKSONVILLE AR",7,4,2,1,1,4,-92.11023712,34.86617279
227,"JACKSONVILLE BEACH FL",7,27,9,8,10,27,-81.39300537,30.29505539
227,"JACKSONVILLE FL",7,242,86,58,98,242,-81.65545654,30.33253288
227,"JACKSONVILLE IL",7,3,0,2,1,3,-90.22943115,39.73405838
227,"JACKSONVILLE NC",7,3,2,0,1,3,-77.42939758,34.75283813
227,"JAMESTOWN ND",7,1,1,0,0,1,-98.70591736,46.90496063
227,"JAMESTOWN PA",7,1,1,0,0,1,-80.43720245,41.48487091
227,"JANESVILLE WI",7,6,2,0,4,6,-89.01893616,42.68303299
227,"JASPER IN",7,1,0,1,0,1,-86.93096161,38.39162445
227,"JEANNETTE PA",7,1,0,0,1,1,-79.61497498,40.32809448
227,"JEFFERSON CITY MO",7,38,12,10,16,38,-92.17385864,38.57698441
227,"JEFFERSON CITY TN",7,4,1,1,2,4,-83.48968506,36.11675644
227,"JEFFERSONVILLE IN",7,4,3,0,1,4,-85.73719788,38.27765656
227,"JENNINGS MO",7,1,0,0,1,1,-90.26077271,38.71944046
227,"JEROME AZ",7,1,0,0,1,1,-112.1151428,34.74900055
227,"JERSEY CITY NJ",7,120,41,26,53,120,-74.07667542,40.72816849
227,"JERSEYVILLE IL",7,1,0,0,1,1,-90.32881165,39.12010956
227,"JESUP GA",7,1,0,0,1,1,-81.88517761,31.60768127
227,"JIM THORPE PA",7,2,1,0,1,2,-75.73157501,40.87605667
227,"JOHNSON CITY TN",7,19,5,7,7,19,-82.35308075,36.31352615
227,"JOHNSONBURG PA",7,2,1,0,1,2,-78.67443848,41.49089432
227,"JOHNSTOWN PA",7,3,1,1,1,3,-78.92127228,40.326931
227,"JOLIET IL",7,47,14,8,25,47,-88.08213043,41.52493668
227,"JONESBORO AR",7,16,5,6,5,16,-90.70430756,35.84226608
227,"JONESBORO GA",7,7,2,0,5,7,-84.35381317,33.52181625
227,"JONESBORO IL",7,4,2,0,2,4,-89.26836395,37.45198059
227,"JOPLIN MO",7,20,9,6,5,20,-94.5140686,37.08442688
227,"JUNCTION CITY KS",7,1,0,0,1,1,-96.8317337,39.02863693
227,"JUPITER FL",7,52,17,18,17,52,-80.09382629,26.9349556
227,"JUSTIN TX",7,2,1,1,0,2,-97.29656219,33.08527374
227,"KALAMAZOO MI",7,69,22,18,29,69,-85.58725739,42.29179764
227,"KALISPELL MT",7,5,1,1,3,5,-114.3166199,48.20161438
227,"KALONA IA",7,2,2,0,0,2,-91.70626831,41.48318481
227,"KANKAKEE IL",7,1,0,0,1,1,-87.86149597,41.12018204
227,"KANNAPOLIS NC",7,4,1,1,2,4,-80.62119293,35.48755264
227,"KANSAS CITY KS",7,16,5,5,6,16,-94.62808228,39.1141777
227,"KANSAS CITY MO",7,822,284,172,366,822,-94.57884979,39.09976578
227,"KASSON MN",7,1,0,1,0,1,-92.75143433,44.02982712
227,"KATY TX",7,36,11,12,13,36,-95.82484436,29.78606224
227,"KAUFMAN TX",7,1,0,0,1,1,-96.30930328,32.58925247
227,"KAYSVILLE UT",7,1,1,0,0,1,-111.9401856,41.03524399
227,"KEARNEY NE",7,2,0,2,0,2,-99.08208466,40.69932938
227,"KEARNY NJ",7,5,2,0,3,5,-74.14439392,40.76873398
227,"KEENE NH",7,1,0,1,0,1,-72.27714539,42.93392563
227,"KELLER TX",7,4,0,2,2,4,-97.25247192,32.93486786
227,"KENAI AK",7,3,1,0,2,3,-151.2597809,60.55926895
227,"KENDALLVILLE IN",7,2,1,1,0,2,-85.27036285,41.44488525
227,"KENMORE NY",7,1,1,0,0,1,-78.86985779,42.96615982
227,"KENMORE WA",7,3,3,0,0,3,-122.2464905,47.7568779
227,"KENNER LA",7,1,1,0,0,1,-90.24167633,29.99442101
227,"KENNESAW GA",7,8,3,4,1,8,-84.61528015,34.02365875
227,"KENNEWICK WA",7,1,0,0,1,1,-119.1395264,46.2107811
227,"KENOSHA WI",7,3,2,1,0,3,-87.82134247,42.58494949
227,"KENSINGTON MD",7,3,1,0,2,3,-77.07564545,39.02577972
227,"KENT OH",7,16,7,3,6,16,-81.35736084,41.15368271
227,"KENT WA",7,16,1,9,6,16,-122.2377701,47.38068008
227,"KERRVILLE TX",7,1,1,0,0,1,-99.14083099,30.04796982
227,"KETTERING OH",7,2,2,0,0,2,-84.1687088,39.68964005
227,"KEY BISCAYNE FL",7,1,0,0,1,1,-80.16217804,25.6944294
227,"KEY WEST FL",7,28,7,11,10,28,-81.78218079,24.556427
227,"KEYPORT NJ",7,1,1,0,0,1,-74.1986084,40.4332695
227,"KEYSTONE HEIGHTS FL",7,1,1,0,0,1,-82.03114319,29.78640366
227,"KILLEEN TX",7,6,2,3,1,6,-97.72832489,31.11753464
227,"KING NC",7,1,0,0,1,1,-80.35888672,36.28079987
227,"KINGDOM CITY MO",7,1,1,0,0,1,-91.93247223,38.96003342
227,"KINGFISHER OK",7,1,1,0,0,1,-97.93222809,35.8614006
227,"KINGMAN AZ",7,3,0,2,1,3,-114.0542908,35.18925858
227,"KINGSLAND GA",7,10,3,2,5,10,-81.68964386,30.80049896
227,"KINGSPORT TN",7,16,1,5,10,16,-82.56182861,36.54841232
227,"KINGSTON MA",7,1,0,0,1,1,-70.72354889,41.99478531
227,"KINGSTON NY",7,4,3,0,1,4,-73.99665833,41.92714691
227,"KINGSTON TN",7,2,0,1,1,2,-84.51077271,35.87340546
227,"KINGSVILLE TX",7,1,0,0,1,1,-97.86582184,27.51676559
227,"KINLOCH MO",7,1,0,0,1,1,-90.32682037,38.74011612
227,"KINSTON NC",7,1,1,0,0,1,-77.58128357,35.26295471
227,"KIRKLAND WA",7,20,8,3,9,20,-122.2108688,47.6813736
227,"KIRKSVILLE MO",7,2,1,0,1,2,-92.58364105,40.19476318
227,"KIRKWOOD MO",7,20,12,2,6,20,-90.40686798,38.5832901
227,"KISSIMMEE FL",7,27,12,8,7,27,-81.40729523,28.29271317
227,"KITTY HAWK NC",7,2,1,1,0,2,-75.70478058,36.06485367
227,"KLAMATH FALLS OR",7,2,1,1,0,2,-121.7844772,42.2244873
227,"KNIGHTDALE NC",7,1,0,0,1,1,-78.48007202,35.78808975
227,"KNOXVILLE TN",7,101,33,33,35,101,-83.92067719,35.96077728
227,"KODIAK AK",7,1,0,0,1,1,-152.3966675,57.7966423
227,"KOKOMO IN",7,4,0,4,0,4,-86.12706757,40.48566818
227,"KUTZTOWN PA",7,2,0,0,2,2,-75.77677917,40.51739502
227,"KYLE TX",7,2,1,1,0,2,-97.87797546,29.9895649
227,"LA CENTER WA",7,1,0,0,1,1,-122.67276,45.86193466
227,"LA CROSSE WI",7,14,10,0,4,14,-91.23967743,43.80151367
227,"LA HABRA CA",7,2,0,0,2,2,-117.9494629,33.93001556
227,"LA JUNTA CO",7,1,0,0,1,1,-103.544075,37.98753738
227,"LA MESA CA",7,2,1,1,0,2,-117.0447464,32.76841354
227,"LA MIRADA CA",7,1,1,0,0,1,-118.0295639,33.85194778
227,"LA PORTE TX",7,1,0,1,0,1,-95.01729584,29.66588402
227,"LA VERGNE TN",7,2,1,0,1,2,-86.58178711,36.01600266
227,"LA VERNE CA",7,1,1,0,0,1,-117.7696304,34.1006546
227,"LACEY WA",7,8,3,0,5,8,-122.8096161,47.03732681
227,"LACONIA NH",7,8,1,1,2,4,-71.46888733,43.52740097
227,"LADY LAKE FL",7,5,2,1,2,5,-81.92842865,28.92837715
227,"LAFAYETTE CA",7,7,2,1,4,7,-122.1200104,37.88574982
227,"LAFAYETTE CO",7,26,13,8,5,26,-105.0904388,39.99370956
227,"LAFAYETTE IN",7,14,3,3,8,14,-86.88406372,40.42077255
227,"LAFAYETTE LA",7,46,14,14,18,46,-92.01987457,30.22468185
227,"LAFAYETTE OR",7,1,0,0,1,1,-123.1177979,45.24378967
227,"LAGUNA BEACH CA",7,12,4,4,4,12,-117.7847061,33.54205322
227,"LAKE BLUFF IL",7,1,0,0,1,1,-87.83427429,42.2790184
227,"LAKE CHARLES LA",7,7,1,0,6,7,-93.21766663,30.22713852
227,"LAKE CITY SC",7,1,0,0,1,1,-79.75487518,33.87107086
227,"LAKE FOREST IL",7,2,2,0,0,2,-87.84095764,42.25865555
227,"LAKE GENEVA WI",7,3,2,0,1,3,-88.43348694,42.59184265
227,"LAKE MARY FL",7,1,0,0,1,1,-81.31755829,28.75924492
227,"LAKE PLACID NY",7,1,0,1,0,1,-73.97898865,44.27967072
227,"LAKE STATION IN",7,1,0,1,0,1,-87.23908997,41.57525253
227,"LAKE STEVENS WA",7,6,0,2,4,6,-122.0684662,48.01782227
227,"LAKE WALES FL",7,1,1,0,0,1,-81.58531189,27.90217018
227,"LAKE WORTH FL",7,8,0,3,5,8,-80.05649567,26.61662102
227,"LAKE ZURICH IL",7,2,0,1,1,2,-88.09326935,42.1971283
227,"LAKELAND FL",7,29,9,4,16,29,-81.95620728,28.04432487
227,"LAKEVILLE MN",7,1,1,0,0,1,-93.24331665,44.64937973
227,"LAKEWOOD CA",7,2,1,0,1,2,-118.1357193,33.85370636
227,"LAKEWOOD CO",7,6,0,4,2,6,-105.0827332,39.70486069
227,"LAKEWOOD NJ",7,4,0,3,1,4,-74.21684265,40.09822845
227,"LAKEWOOD OH",7,10,2,5,3,10,-81.79773712,41.48223114
227,"LAKEWOOD WA",7,4,0,0,2,2,-122.3653679,47.661533355
227,"LAMAR CO",7,1,0,1,0,1,-102.6111527,38.08679581
227,"LANCASTER CA",7,8,2,1,5,8,-118.1386871,34.69804001
227,"LANCASTER NY",7,1,0,1,0,1,-78.67009735,42.90063477
227,"LANCASTER PA",7,23,8,5,10,23,-76.30498505,40.03824234
227,"LANCASTER TX",7,1,0,1,0,1,-96.75682831,32.59244156
227,"LANDOVER HILLS MD",7,5,3,0,2,5,-76.89152527,38.94342804
227,"LANGLEY WA",7,2,1,1,0,2,-122.4162674,48.03789139
227,"LANSDOWNE PA",7,23,7,8,8,23,-75.27108765,39.93852234
227,"LANSING IL",7,7,1,2,4,7,-87.5393219,41.56502151
227,"LANSING MI",7,85,24,27,34,85,-84.55532074,42.73265839
227,"LAPEER MI",7,5,2,1,2,5,-83.31890869,43.05135345
227,"LAPEL IN",7,1,1,0,0,1,-85.84798431,40.06825638
227,"LARAMIE WY",7,4,0,1,3,4,-105.592804,41.3115387
227,"LAREDO TX",7,6,2,3,1,6,-99.50824738,27.50720978
227,"LARGO FL",7,20,6,5,9,20,-82.78675079,27.91026115
227,"LAS CRUCES NM",7,5,3,2,0,5,-106.7798538,32.31209564
227,"LAS VEGAS NV",7,511,156,131,224,511,-115.1382141,36.17488098
227,"LATHROP CA",7,2,2,0,0,2,-121.2790833,37.82243729
227,"LAUDERDALE LAKES FL",7,4,0,3,1,4,-80.20793915,26.1671524
227,"LAUREL MS",7,1,1,0,0,1,-89.13054657,31.69452286
227,"LAUREL NE",7,1,1,0,0,1,-97.09031677,42.4295311
227,"LAVONIA GA",7,9,2,6,1,9,-83.10657501,34.4361496
227,"LAWNDALE CA",7,7,3,2,2,7,-118.3547897,33.88746262
227,"LAWRENCE KS",7,144,43,37,64,144,-95.23565674,38.97153091
227,"LAWRENCE MA",7,1,1,0,0,1,-71.15792084,42.70630646
227,"LAWRENCEBURG KY",7,1,0,0,1,1,-84.89624023,38.03728867
227,"LAWRENCEBURG TN",7,1,0,0,1,1,-87.33492279,35.24256897
227,"LAWRENCEVILLE GA",7,13,5,4,4,13,-83.98753357,33.95662308
227,"LAWTON OK",7,15,7,4,4,15,-98.39124298,34.60861969
227,"LAYTON UT",7,1,0,0,1,1,-111.9724808,41.06021118
227,"LEAGUE CITY TX",7,4,0,2,2,4,-95.09550476,29.50793457
227,"LEANDER TX",7,3,3,0,0,3,-97.85368347,30.57936287
227,"LEAVENWORTH KS",7,2,0,1,1,2,-94.92282867,39.31124115
227,"LEAWOOD KS",7,1,0,0,1,1,-94.61756897,38.96688461
227,"LEBANON KY",7,1,0,1,0,1,-85.25253296,37.56981277
227,"LEBANON MO",7,1,1,0,0,1,-92.66392517,37.68081284
227,"LEBANON OH",7,4,0,2,2,4,-84.20275879,39.43528748
227,"LEBANON OR",7,1,0,0,1,1,-122.9096909,44.53636551
227,"LEBANON PA",7,2,0,1,1,2,-76.41091156,40.34118652
227,"LEBANON TN",7,4,1,2,1,4,-86.29133606,36.20846939
227,"LECOMPTE LA",7,1,0,1,0,1,-92.40045929,31.09491348
227,"LEESBURG FL",7,6,1,1,4,6,-81.87727356,28.81123161
227,"LEESBURG VA",7,5,1,1,3,5,-77.56890869,39.11256027
227,"LEESPORT PA",7,1,1,0,0,1,-75.96580505,40.44723892
227,"LELAND NC",7,1,1,0,0,1,-78.04415131,34.25672913
227,"LEMOORE CA",7,1,0,0,1,1,-119.7849197,36.30083084
227,"LENEXA KS",7,2,2,0,0,2,-94.73374176,38.95368576
227,"LEWES DE",7,1,1,0,0,1,-75.1359024,38.77365494
227,"LEWISBURG PA",7,3,0,2,1,3,-76.88389587,40.96484756
227,"LEWISTON ID",7,1,0,0,1,1,-117.0198975,46.41637421
227,"LEWISTON ME",7,3,1,0,2,3,-70.21377563,44.10037231
227,"LEWISTON NY",7,1,0,1,0,1,-79.03521729,43.17250061
227,"LEWISVILLE TX",7,23,11,6,6,23,-96.99449921,33.04630661
227,"LEXINGTON IN",7,1,0,0,1,1,-85.62545776,38.65218353
227,"LEXINGTON MA",7,3,0,1,2,3,-71.22381592,42.44742584
227,"LEXINGTON SC",7,7,3,4,0,7,-81.23597717,33.98204041
227,"LEXINGTON VA",7,1,0,0,1,1,-79.4422226,37.78420639
227,"LIBERAL KS",7,2,2,0,0,2,-100.9224777,37.04306412
227,"LIBERAL MO",7,4,2,1,1,4,-94.52056122,37.55810547
227,"LIBERTY MO",7,7,4,1,2,7,-94.4196167,39.24604034
227,"LIBERTY MS",7,8,4,3,1,8,-90.81230927,31.15865898
227,"LIGONIER PA",7,2,0,0,2,2,-79.23710632,40.24316025
227,"LIMA OH",7,5,1,1,3,5,-84.10490417,40.74259186
227,"LINCOLN CA",7,1,0,0,1,1,-121.2951202,38.89149475
227,"LINCOLN NE",7,50,15,9,26,50,-96.6674118,40.80001068
227,"LINCOLNSHIRE IL",7,1,0,0,1,1,-87.90823364,42.18999863
227,"LINO LAKES MN",7,2,0,1,1,2,-93.08938599,45.16019058
227,"LISLE IL",7,1,0,0,1,1,-88.07471466,41.80134964
227,"LITCHFIELD CT",7,1,0,0,1,1,-73.18777466,41.74758911
227,"LITITZ PA",7,2,0,2,0,2,-76.30600739,40.15749741
227,"LITTLE ROCK AR",7,121,42,40,39,121,-92.28178406,34.7369194
227,"LITTLETON CO",7,6,3,0,3,6,-105.0176163,39.6132431
227,"LIVE OAK FL",7,1,0,1,0,1,-82.98397064,30.29559708
227,"LIVERMORE CA",7,5,0,4,1,5,-121.7701416,37.68147659
227,"LIVERPOOL NY",7,1,0,0,1,1,-76.21547699,43.10769653
227,"LIVINGSTON MT",7,1,0,0,1,1,-110.5622253,45.66219711
227,"LIVONIA MI",7,8,4,1,3,8,-83.35256958,42.36862564
227,"LOCKPORT NY",7,5,0,2,3,5,-78.69011688,43.17089081
227,"LOCUST NC",7,2,1,0,1,2,-80.42564392,35.26195145
227,"LODI CA",7,4,0,1,3,4,-121.2742386,38.12984467
227,"LOGAN OH",7,2,1,0,1,2,-82.40658569,39.54026794
227,"LOGAN UT",7,14,4,3,7,14,-111.8171616,41.73900604
227,"LOGANSPORT IN",7,1,0,0,1,1,-86.36410522,40.75329208
227,"LOGANVILLE GA",7,1,0,1,0,1,-83.90035248,33.83914948
227,"LOMBARD IL",7,3,1,2,0,3,-88.00775909,41.8800621
227,"LOMIRA WI",7,27,4,8,15,27,-88.44380188,43.59117126
227,"LOMITA CA",7,4,0,2,2,4,-118.3169556,33.79204941
227,"LOMPOC CA",7,1,0,0,1,1,-120.4598694,34.63894272
227,"LONG BEACH CA",7,113,36,24,53,113,-118.1908112,33.7670517
227,"LONG BEACH MS",7,1,0,1,0,1,-89.15268707,30.35081673
227,"LONG BEACH NY",7,7,3,0,4,7,-73.6654129,40.58349991
227,"LONGMONT CO",7,6,3,0,3,6,-105.1026764,40.16700745
227,"LONGVIEW TX",7,22,8,5,9,22,-94.73707581,32.4966507
227,"LONGVIEW WA",7,1,0,1,0,1,-122.9404221,46.1375885
227,"LONGWOOD FL",7,1,0,0,1,1,-81.34702301,28.69888687
227,"LORAIN OH",7,3,0,0,3,3,-82.17118073,41.45874023
227,"LORIS SC",7,1,0,0,1,1,-78.89011383,34.05680084
227,"LOS ALTOS CA",7,9,2,2,5,9,-122.1163025,37.38525772
227,"LOS ANGELES CA",7,2989,970,755,1264,2989,-118.2459106,34.05225754
227,"LOS GATOS CA",7,2,0,1,1,2,-121.9771652,37.22674561
227,"LOUDON TN",7,1,0,0,1,1,-84.33385468,35.73310471
227,"LOUISA VA",7,2,0,0,2,2,-78.00349426,38.0253067
227,"LOUISBURG KS",7,3,2,0,1,3,-94.68140411,38.61960602
227,"LOUISBURG NC",7,1,1,0,0,1,-78.30069733,36.09918594
227,"LOUISVILLE CO",7,1,1,0,0,1,-105.1326523,39.97768402
227,"LOVELAND CO",7,8,2,2,4,8,-105.0755997,40.39763641
227,"LOVELAND OH",7,2,1,1,0,2,-84.25993347,39.26356506
227,"LOWELL IN",7,2,0,2,0,2,-87.42073059,41.29130173
227,"LOWELL MA",7,19,7,4,8,19,-71.31530762,42.63344574
227,"LUBBOCK TX",7,33,11,4,18,33,-101.8544312,33.59677505
227,"LUCEDALE MS",7,1,1,0,0,1,-88.59013367,30.92567635
227,"LUFKIN TX",7,1,0,1,0,1,-94.72932434,31.33858681
227,"LUMBERTON NC",7,2,0,0,2,2,-79.00803375,34.61832428
227,"LUMBERTON NJ",7,1,0,0,1,1,-74.80423737,39.9662323
227,"LYNBROOK NY",7,1,1,0,0,1,-73.67084503,40.65480042
227,"LYNCHBURG VA",7,10,4,0,6,10,-79.14174652,37.41383362
227,"LYNDEN WA",7,4,0,2,2,4,-122.455101,48.94639969
227,"LYNDHURST NJ",7,1,0,0,1,1,-74.12353516,40.81222153
227,"LYNN MA",7,9,1,5,3,9,-70.94833374,42.46699905
227,"LYNNWOOD WA",7,6,3,1,2,6,-122.3175736,47.82042313
227,"LYNWOOD CA",7,21,8,5,8,21,-118.2135544,33.93053055
227,"LYNWOOD IL",7,3,0,1,2,3,-87.53853607,41.52642059
227,"MADELIA MN",7,2,0,1,1,2,-94.42191315,44.05470276
227,"MADISON AL",7,6,1,1,1,3,-86.487213135,33.561834335
227,"MADISON CT",7,1,0,0,1,1,-72.59211731,41.28052902
227,"MADISON HEIGHTS MI",7,1,0,0,1,1,-83.10519409,42.48604965
227,"MADISON IL",7,2,1,0,1,2,-90.15700531,38.68284988
227,"MADISON MS",7,2,0,1,1,2,-90.11543274,32.46231079
227,"MADISON NE",7,1,0,1,0,1,-97.45545959,41.82836151
227,"MADISON NJ",7,1,0,0,1,1,-74.41627502,40.76013184
227,"MADISON SD",7,2,0,0,2,2,-97.11444855,44.00682449
227,"MADISON WI",7,233,75,79,79,233,-89.40128326,43.07303619
227,"MADISON WV",7,1,0,1,0,1,-81.82273102,38.06180191
227,"MADISONVILLE TN",7,1,0,1,0,1,-84.3633728,35.5197525
227,"MAGNOLIA AR",7,1,0,0,1,1,-93.23983765,33.26739883
227,"MAGNOLIA TX",7,1,0,0,1,1,-95.75150299,30.20981598
227,"MAIZE KS",7,4,2,0,2,4,-97.46515656,37.77322006
227,"MALDEN MA",7,7,1,3,3,7,-71.06546783,42.42518234
227,"MALDEN MO",7,1,0,1,0,1,-89.96641541,36.55708313
227,"MALVERN AR",7,3,1,2,0,3,-92.81313324,34.36237717
227,"MALVERN PA",7,12,5,2,5,12,-75.51319885,40.03642654
227,"MAMMOTH LAKES CA",7,2,1,0,1,2,-119.0125961,37.60457611
227,"MANALAPAN NJ",7,1,1,0,0,1,-74.39516449,40.25764465
227,"MANASSAS PARK VA",7,1,0,0,1,1,-77.46895599,38.7841301
227,"MANASSAS VA",7,10,4,2,4,10,-77.47459412,38.75112534
227,"MANCHESTER CT",7,2,1,1,0,2,-72.52075958,41.77622986
227,"MANCHESTER NH",7,23,8,7,8,23,-71.45406342,42.99581528
227,"MANDEVILLE LA",7,2,2,0,0,2,-90.06562805,30.35881805
227,"MANHATTAN BEACH CA",7,5,0,2,3,5,-118.4129181,33.88484192
227,"MANHATTAN KS",7,13,7,0,6,13,-96.57228851,39.18354034
227,"MANISTEE MI",7,1,0,0,1,1,-86.3241806,44.24435043
227,"MANITOU SPRINGS CO",7,1,0,0,1,1,-104.9184494,38.85948944
227,"MANKATO MN",7,10,4,2,4,10,-94.02125549,44.15895462
227,"MANNING SC",7,50,14,10,26,50,-80.21025085,33.69546509
227,"MANOR TX",7,1,1,0,0,1,-97.55760193,30.34129524
227,"MANSFIELD OH",7,7,1,1,5,7,-82.51545715,40.75864792
227,"MANSFIELD TX",7,5,0,2,3,5,-97.14230347,32.56362152
227,"MANTECA CA",7,2,1,0,1,2,-121.2179031,37.79747391
227,"MANTORVILLE MN",7,1,0,1,0,1,-92.75609589,44.06903458
227,"MAPLE GROVE MN",7,7,1,2,4,7,-93.47679138,45.14711761
227,"MAPLE SHADE NJ",7,6,4,1,1,6,-74.9913559,39.95294571
227,"MAPLE VALLEY WA",7,2,0,2,0,2,-122.0403976,47.40601349
227,"MAPLETON UT",7,1,0,0,1,1,-111.5824585,40.13248444
227,"MAPLEWOOD MO",7,22,8,5,9,22,-90.32471466,38.6126976
227,"MAPLEWOOD NJ",7,7,2,2,3,7,-74.27243805,40.77401733
227,"MARATHON FL",7,1,0,1,0,1,-81.09011841,24.71463966
227,"MARBLEHEAD MA",7,1,1,0,0,1,-70.85662079,42.50020599
227,"MARFA TX",7,1,0,1,0,1,-104.0205383,30.30808449
227,"MARIANNA FL",7,17,5,3,9,17,-85.22673798,30.77488518
227,"MARICOPA AZ",7,1,0,1,0,1,-112.0491562,33.05832672
227,"MARIETTA GA",7,48,16,17,15,48,-84.54958344,33.9527359
227,"MARIETTA OK",7,1,0,1,0,1,-97.11754608,33.93697739
227,"MARINA CA",7,2,0,2,0,2,-121.8042831,36.6841507
227,"MARINETTE WI",7,1,0,1,0,1,-87.63109589,45.10002518
227,"MARION AL",7,2,1,1,0,2,-87.31942749,32.63277054
227,"MARION AR",7,2,0,1,1,2,-90.19646454,35.21472931
227,"MARION IA",7,4,0,2,2,4,-91.60752869,42.032547
227,"MARION IL",7,2,0,1,1,2,-88.93344116,37.73056412
227,"MARION IN",7,3,1,0,2,3,-85.65896606,40.55827332
227,"MARION MS",7,3,2,0,1,3,-88.64802551,32.41785049
227,"MARISSA IL",7,3,1,0,2,3,-89.7505188,38.25014496
227,"MARKHAM IL",7,3,1,0,2,3,-87.69510651,41.59363937
227,"MARKS MS",7,6,2,0,4,6,-90.27207947,34.25684357
227,"MARLBOROUGH MA",7,1,0,0,1,1,-71.55128479,42.34592819
227,"MARQUETTE MI",7,3,1,0,2,3,-87.39571381,46.54323196
227,"MARS PA",7,1,1,0,0,1,-80.01100159,40.69602585
227,"MARSHALL MI",7,2,0,1,1,2,-84.9631424,42.27227402
227,"MARSHALL MN",7,3,2,0,1,3,-95.78921509,44.4466362
227,"MARSHALL MO",7,1,0,0,1,1,-93.19745636,39.12294769
227,"MARSHALLTOWN IA",7,7,1,3,3,7,-92.90861511,42.04956055
227,"MARTHASVILLE MO",7,1,0,1,0,1,-91.05782318,38.62841034
227,"MARTINS FERRY OH",7,2,1,0,1,2,-80.72425842,40.09586716
227,"MARTINSBURG WV",7,1,0,1,0,1,-77.96557617,39.45707703
227,"MARTINSVILLE VA",7,6,4,1,1,6,-79.87229156,36.69199371
227,"MARVELL AR",7,1,0,1,0,1,-90.91059113,34.5550499
227,"MARYLAND HEIGHTS MO",7,1,0,1,0,1,-90.43025208,38.71334076
227,"MARYSVILLE CA",7,1,1,0,0,1,-121.5933762,39.14567947
227,"MARYSVILLE WA",7,6,3,2,1,6,-122.179451,48.05155182
227,"MARYVILLE MO",7,4,2,2,0,4,-94.87281036,40.34609604
227,"MARYVILLE TN",7,1,0,0,1,1,-83.96243286,35.76000977
227,"MASON CITY IA",7,1,0,0,1,1,-93.20175934,43.15355301
227,"MASON OH",7,35,9,7,19,35,-84.30989075,39.36032104
227,"MASSAPEQUA PARK NY",7,1,0,0,1,1,-73.45436859,40.68052292
227,"MASSENA NY",7,2,0,1,1,2,-74.89122772,44.92828751
227,"MASSILLON OH",7,5,2,1,2,5,-81.52096558,40.7966156
227,"MATAWAN NJ",7,1,0,1,0,1,-74.22887421,40.41519547
227,"MATFIELD GREEN KS",7,2,2,0,0,2,-96.56110382,38.15935516
227,"MAYNARD MA",7,1,0,0,1,1,-71.44880676,42.43361664
227,"MAYVILLE WI",7,7,2,1,4,7,-88.54499817,43.49409103
227,"MAYWOOD IL",7,1,0,0,1,1,-87.84314728,41.87941742
227,"MCALLEN TX",7,18,3,7,8,18,-98.23077393,26.20433426
227,"MCCOMB MS",7,1,0,0,1,1,-90.45623016,31.2437973
227,"MCDONOUGH GA",7,1,0,1,0,1,-84.1467514,33.44765472
227,"MCHENRY IL",7,4,2,2,0,4,-88.2740097,42.34480286
227,"MCKINNEY TX",7,14,4,6,4,14,-96.6155777,33.19782257
227,"MCMINNVILLE OR",7,5,2,2,1,5,-123.2019272,45.20968628
227,"MEADVILLE PA",7,2,0,1,1,2,-80.15116119,41.64140701
227,"MEBANE NC",7,4,0,1,3,4,-79.26649475,36.09629059
227,"MECHANICSBURG PA",7,1,1,0,0,1,-77.00779724,40.21432114
227,"MEDFORD MA",7,4,2,1,1,4,-71.10526276,42.41849518
227,"MEDFORD OR",7,11,4,2,5,11,-122.8773193,42.32625961
227,"MEDIA PA",7,2,0,0,2,2,-75.38693237,39.91692734
227,"MEDICAL LAKE WA",7,1,0,0,1,1,-117.682518,47.57226944
227,"MEDINA OH",7,7,2,2,3,7,-81.86336517,41.13858795
227,"MELBOURNE AR",7,1,0,1,0,1,-91.90882111,36.05977631
227,"MELBOURNE FL",7,22,6,6,10,22,-80.60625458,28.07838249
227,"MELISSA TX",7,1,1,0,0,1,-96.57331848,33.28625488
227,"MELROSE MA",7,4,2,1,1,4,-71.07271576,42.45837784
227,"MELROSE PARK IL",7,1,0,0,1,1,-87.85682678,41.90048218
227,"MEMPHIS TN",7,466,155,112,199,466,-90.01696014,35.1194191
227,"MENA AR",7,18,2,10,6,18,-94.24035645,34.58638
227,"MENLO PARK CA",7,17,4,4,9,17,-122.1842423,37.45361328
227,"MENOMONEE FALLS WI",7,1,0,1,0,1,-88.11719513,43.17907715
227,"MENOMONIE WI",7,1,0,0,1,1,-91.92002106,44.87564468
227,"MENTOR OH",7,6,1,0,5,6,-81.33918762,41.66637421
227,"MERCED CA",7,12,2,5,5,12,-120.4848785,37.30197525
227,"MEREDITH NH",7,2,1,0,1,2,-71.50298309,43.65645218
227,"MERIDIAN ID",7,2,0,1,1,2,-116.3941193,43.611866
227,"MERIDIAN MS",7,3,2,1,0,3,-88.70374298,32.36473846
227,"MERRIAM KS",7,1,0,1,0,1,-94.69395447,39.02367401
227,"MERRILLVILLE IN",7,1,0,0,1,1,-87.33312988,41.48298645
227,"MESA AZ",7,38,7,11,20,38,-111.8239059,33.42222214
227,"MESQUITE NV",7,1,1,0,0,1,-114.0683136,36.80557251
227,"MESQUITE TX",7,43,17,11,15,43,-96.59959412,32.76692581
227,"METUCHEN NJ",7,2,2,0,0,2,-74.36269379,40.543293
227,"MEXIA TX",7,1,0,0,1,1,-96.48291016,31.68026352
227,"MIAMI BEACH FL",7,26,9,8,9,26,-80.12982178,25.79146576
227,"MIAMI FL",7,632,176,180,276,632,-80.19329071,25.77483749
227,"MIAMI OK",7,1,0,1,0,1,-94.87779999,36.87476349
227,"MIAMISBURG OH",7,7,4,0,3,7,-84.28652191,39.643116
227,"MICHIGAN CITY IN",7,5,1,1,3,5,-86.89486694,41.70751572
227,"MIDDLEBURY IN",7,1,0,1,0,1,-85.71139526,41.67531967
227,"MIDDLEBURY VT",7,10,3,4,3,10,-73.16629028,44.01540756
227,"MIDDLETON WI",7,2,0,0,2,2,-89.50476074,43.09717941
227,"MIDDLETOWN CT",7,2,1,0,1,2,-72.64955902,41.56232071
227,"MIDDLETOWN DE",7,6,3,1,2,6,-75.71700287,39.44935226
227,"MIDDLETOWN NJ",7,1,1,0,0,1,-74.11607361,40.39449692
227,"MIDDLETOWN NY",7,2,0,1,1,2,-74.4223938,41.44607544
227,"MIDDLETOWN OH",7,6,0,2,4,6,-84.39844513,39.51361084
227,"MIDLAND MI",7,7,4,1,2,7,-84.24700928,43.61585236
227,"MIDLAND TX",7,8,3,1,4,8,-102.0793686,31.99754143
227,"MIDLOTHIAN TX",7,1,1,0,0,1,-96.99511719,32.4827919
227,"MIDWEST CITY OK",7,1,0,0,1,1,-97.39709473,35.44970703
227,"MIFFLINBURG PA",7,1,0,0,1,1,-77.04728699,40.91789627
227,"MIFFLINTOWN PA",7,2,1,0,1,2,-77.39626312,40.56981659
227,"MILFORD CT",7,1,0,1,0,1,-73.05560303,41.2226181
227,"MILFORD DE",7,2,1,0,1,2,-75.42737579,38.9128685
227,"MILFORD MA",7,5,1,1,3,5,-71.51522064,42.14015198
227,"MILFORD NY",7,8,3,2,3,8,-74.94455719,42.59064865
227,"MILFORD OH",7,1,1,0,0,1,-84.29400635,39.17559433
227,"MILL VALLEY CA",7,7,2,4,1,7,-122.5473328,37.90579224
227,"MILLBRAE CA",7,1,0,0,1,1,-122.3894043,37.59856033
227,"MILLBROOK NY",7,1,0,0,1,1,-73.69306183,41.78520966
227,"MILLEDGEVILLE GA",7,6,3,0,3,6,-83.23179626,33.08055878
227,"MILLTOWN NJ",7,1,0,1,0,1,-74.44260406,40.45628738
227,"MILPITAS CA",7,1,0,1,0,1,-121.9090805,37.42808533
227,"MILTON FL",7,1,0,0,1,1,-87.03953552,30.63289833
227,"MILTON WI",7,1,0,1,0,1,-88.9439621,42.77545547
227,"MILTON WV",7,1,0,1,0,1,-82.12947845,38.43808746
227,"MILWAUKEE WI",7,309,94,95,120,309,-87.90684509,43.03887939
227,"MILWAUKIE OR",7,2,0,2,0,2,-122.6417084,45.44596481
227,"MINDEN LA",7,102,32,15,55,102,-93.28716278,32.61589432
227,"MINERSVILLE PA",7,1,0,0,1,1,-76.26126862,40.69085693
227,"MINNEAPOLIS MN",7,563,234,150,179,563,-93.26397705,44.97980118
227,"MINNEOLA FL",7,1,0,1,0,1,-81.74643707,28.57386589
227,"MINNETONKA MN",7,8,3,1,4,8,-93.43367004,44.92795181
227,"MINOT ND",7,2,0,1,1,2,-101.2953949,48.23139572
227,"MIRAMAR FL",7,15,4,4,7,15,-80.23181915,25.98794746
227,"MISHAWAKA IN",7,4,2,0,2,4,-86.18048859,41.65872574
227,"MISSION KS",7,17,3,7,7,17,-94.65638733,39.02796173
227,"MISSION SD",7,1,1,0,0,1,-100.6579437,43.30659866
227,"MISSION TX",7,2,2,0,0,2,-98.32580566,26.21655273
227,"MISSION VIEJO CA",7,4,2,1,1,4,-117.6737366,33.59992218
227,"MISSOULA MT",7,25,12,3,10,25,-113.9832687,46.87278366
227,"MISSOURI CITY TX",7,16,5,1,10,16,-95.5381012,29.61878204
227,"MOAB UT",7,1,0,1,0,1,-109.5508347,38.57315063
227,"MOBILE AL",7,36,9,9,18,36,-88.04309845,30.69476128
227,"MODESTO CA",7,23,6,7,10,23,-120.9991455,37.63897324
227,"MOLINE IL",7,3,1,2,0,3,-90.51522064,41.5069809
227,"MONETT MO",7,1,0,1,0,1,-93.92830658,36.92906952
227,"MONONA WI",7,1,1,0,0,1,-89.33418274,43.06205368
227,"MONROE LA",7,21,9,6,6,21,-92.11960602,32.50980759
227,"MONROE MI",7,1,0,0,1,1,-83.39758301,41.91663742
227,"MONROE NC",7,1,0,0,1,1,-80.54924011,34.98587036
227,"MONROE NY",7,3,0,1,2,3,-74.18616486,41.33085632
227,"MONROE WA",7,1,0,0,1,1,-121.9735718,47.85487747
227,"MONROEVILLE OH",7,1,1,0,0,1,-82.69579315,41.24438477
227,"MONROVIA CA",7,8,4,1,3,8,-118.0006485,34.14796829
227,"MONTAGUE MI",7,2,1,0,1,2,-86.35713959,43.41694641
227,"MONTCLAIR NJ",7,8,2,3,3,8,-74.20848083,40.82605362
227,"MONTEBELLO CA",7,2,0,0,2,2,-118.1069412,34.00930023
227,"MONTEREY CA",7,15,1,8,6,15,-121.8974838,36.6002388
227,"MONTEREY PARK CA",7,2,1,0,1,2,-118.1248398,34.06269836
227,"MONTEREY TN",7,1,0,1,0,1,-85.26838684,36.14765167
227,"MONTEVALLO AL",7,2,1,0,1,2,-86.86419678,33.10087967
227,"MONTGOMERY AL",7,78,20,24,34,78,-86.29966736,32.36724472
227,"MONTGOMERY TX",7,1,0,0,1,1,-95.69664001,30.38855171
227,"MONTPELIER VT",7,4,0,3,1,4,-72.57458496,44.26039124
227,"MOORE OK",7,9,3,3,3,9,-97.48735046,35.33969498
227,"MOOREFIELD WV",7,1,1,0,0,1,-78.96636963,39.06458664
227,"MOORESVILLE NC",7,5,2,2,1,5,-80.80976868,35.58535004
227,"MOORHEAD MN",7,8,0,6,2,8,-96.76844025,46.87382507
227,"MOREHEAD CITY NC",7,1,0,0,1,1,-76.72536469,34.72343445
227,"MORGAN HILL CA",7,3,1,1,1,3,-121.6563797,37.1303978
227,"MORGANTON NC",7,1,0,1,0,1,-81.68434906,35.74584961
227,"MORGANTOWN WV",7,21,3,7,11,21,-79.95038605,39.63131714
227,"MORRILL KS",7,1,1,0,0,1,-95.69260406,39.92824936
227,"MORRIS MN",7,2,1,1,0,2,-95.91436005,45.58617401
227,"MORRISON CO",7,1,0,1,0,1,-105.1927185,39.65348434
227,"MORRISTOWN NJ",7,2,1,1,0,2,-74.48057556,40.79689789
227,"MORRO BAY CA",7,3,1,1,1,3,-120.8519135,35.36568451
227,"MORROW GA",7,8,2,2,4,8,-84.33943939,33.58339691
227,"MORROW OH",7,1,0,1,0,1,-84.12705231,39.35469437
227,"MOSCOW ID",7,18,5,7,6,18,-117.0021973,46.73223877
227,"MOSES LAKE WA",7,4,1,2,1,4,-119.2802811,47.12987137
227,"MOULTON AL",7,6,2,1,3,6,-87.29332733,34.48143387
227,"MOULTRIE GA",7,7,2,3,2,7,-83.78891754,31.18035507
227,"MOUNDSVILLE WV",7,20,10,1,9,20,-80.74716949,39.92013931
227,"MOUNDVILLE AL",7,1,0,0,1,1,-87.63011169,32.99803162
227,"MOUNT AIRY NC",7,2,1,0,1,2,-80.60665131,36.49975586
227,"MOUNT CLEMENS MI",7,1,1,0,0,1,-82.87785339,42.59724808
227,"MOUNT HOLLY NJ",7,1,0,1,0,1,-74.78692627,39.99301147
227,"MOUNT JOY PA",7,2,1,0,1,2,-76.50283051,40.10977936
227,"MOUNT MORRIS NY",7,1,0,1,0,1,-77.87361145,42.72562408
227,"MOUNT PLEASANT MI",7,2,0,1,1,2,-84.76785278,43.59777832
227,"MOUNT PLEASANT SC",7,5,0,1,4,5,-79.86242676,32.79427719
227,"MOUNT POCONO PA",7,1,1,0,0,1,-75.36369324,41.12226868
227,"MOUNT RAINIER MD",7,6,3,1,2,6,-76.96430206,38.9414978
227,"MOUNT VERNON IL",7,1,1,0,0,1,-88.90307617,38.31738663
227,"MOUNT VERNON NY",7,6,2,1,0,3,-76.36322403,41.83351135
227,"MOUNT VERNON WA",7,1,0,0,1,1,-122.3365784,48.4208374
227,"MOUNTAIN HOME ID",7,12,3,7,2,12,-115.6928406,43.13270187
227,"MOUNTAIN VIEW CA",7,30,13,6,11,30,-122.0861969,37.3859024
227,"MOWEAQUA IL",7,1,0,0,1,1,-89.01890564,39.62461472
227,"MUKILTEO WA",7,1,0,0,1,1,-122.3008041,47.94359589
227,"MULVANE KS",7,1,0,0,1,1,-97.24430847,37.47423935
227,"MUNCIE IN",7,29,10,10,9,29,-85.38398743,40.18970871
227,"MUNDELEIN IL",7,1,0,0,1,1,-88.00391388,42.26291275
227,"MUNHALL PA",7,1,1,0,0,1,-79.89945984,40.39241409
227,"MUNSTER IN",7,1,0,0,1,1,-87.51268768,41.56475449
227,"MURFREESBORO TN",7,24,7,4,13,24,-86.39038086,35.84575653
227,"MURPHY NC",7,3,2,0,1,3,-84.03442383,35.08757019
227,"MURPHY TX",7,1,0,0,1,1,-96.61357117,33.01515198
227,"MURRAY KY",7,6,3,2,1,6,-88.31504059,36.61037827
227,"MURRAY UT",7,1,1,0,0,1,-111.8896103,40.66687012
227,"MURRIETA CA",7,2,1,0,1,2,-117.2157898,33.55398941
227,"MUSKEGON MI",7,2,0,1,0,1,-86.25441742,43.23139763
227,"MUSKOGEE OK",7,24,2,12,10,24,-95.36999512,35.74824142
227,"MYRTLE BEACH SC",7,18,6,2,10,18,-78.88601685,33.69656372
227,"MYRTLE CREEK OR",7,2,0,1,1,2,-123.2955856,43.0200119
227,"NACOGDOCHES TX",7,1,0,0,1,1,-94.6559906,31.60386467
227,"NAMPA ID",7,3,1,1,1,3,-116.5658188,43.54054642
227,"NAPA CA",7,9,3,2,4,9,-122.2872086,38.29692841
227,"NAPERVILLE IL",7,17,6,5,6,17,-88.14768219,41.78578949
227,"NAPLES FL",7,24,4,5,15,24,-81.79434204,26.14280128
227,"NASHVILLE IL",7,1,0,0,1,1,-89.3805542,38.34370804
227,"NASSAU BAY TX",7,1,0,1,0,1,-95.09243011,29.54221344
227,"NATALIA TX",7,4,1,0,3,4,-98.86307526,29.19000626
227,"NATCHITOCHES LA",7,1,0,0,1,1,-93.08662415,31.76096535
227,"NATICK MA",7,8,5,1,2,8,-71.3484726,42.2836113
227,"NAUGATUCK CT",7,16,9,4,3,16,-73.04972076,41.4863205
227,"NAUVOO IL",7,1,1,0,0,1,-91.3849411,40.55012131
227,"NAZARETH PA",7,2,1,1,0,2,-75.30902863,40.74064255
227,"NECHE ND",7,7,2,2,3,7,-97.54907227,48.97986603
227,"NEDERLAND CO",7,1,0,1,0,1,-105.5114899,39.96115494
227,"NEEDHAM MA",7,3,1,1,1,3,-71.21767426,42.27159119
227,"NEEDLES CA",7,1,0,0,1,1,-114.6156082,34.84807587
227,"NEENAH WI",7,2,0,0,2,2,-88.4626236,44.18569183
227,"NEOSHO MO",7,1,0,1,0,1,-94.36846161,36.86910629
227,"NEW ALBANY IN",7,8,3,1,4,8,-85.80917358,38.29167938
227,"NEW BEDFORD MA",7,9,5,1,3,9,-70.93328857,41.63626862
227,"NEW BERN NC",7,8,3,2,3,8,-77.04354095,35.10897827
227,"NEW BRAUNFELS TX",7,14,4,6,4,14,-98.12486267,29.70325089
227,"NEW BRIGHTON MN",7,1,1,0,0,1,-93.19654083,45.06001663
227,"NEW BRITAIN CT",7,3,1,1,1,3,-72.77884674,41.6615181
227,"NEW BRUNSWICK NJ",7,3,0,1,2,3,-74.45104218,40.48620987
227,"NEW CARROLLTON MD",7,4,2,1,1,4,-76.8794632,38.97011185
227,"NEW CASTLE DE",7,11,3,3,5,11,-75.56227875,39.66440964
227,"NEW HARMONY IN",7,4,2,2,0,4,-87.93526459,38.12969589
227,"NEW HARTFORD NY",7,1,0,0,1,1,-75.28686523,43.07355118
227,"NEW HAVEN CT",7,182,53,62,67,182,-72.92726898,41.3084259
227,"NEW HOLLAND PA",7,1,0,0,1,1,-76.0844574,40.10216141
227,"NEW IBERIA LA",7,1,0,1,0,1,-91.81869507,30.0039444
227,"NEW KENSINGTON PA",7,1,1,0,0,1,-79.76441956,40.57001114
227,"NEW LONDON CT",7,7,3,2,2,7,-72.09841156,41.35572815
227,"NEW LONDON MN",7,2,1,0,1,2,-94.94470978,45.30108261
227,"NEW MADRID MO",7,2,0,0,2,2,-89.52796936,36.58650589
227,"NEW ORLEANS LA",7,687,197,203,287,687,-90.07525635,29.95483589
227,"NEW PALTZ NY",7,3,1,2,0,3,-74.08605194,41.74787903
227,"NEW PORT RICHEY FL",7,3,2,1,0,3,-82.71899414,28.24477577
227,"NEW ROCHELLE NY",7,2,0,1,1,2,-73.78160858,40.91175842
227,"NEW YORK NY",7,3026,965,831,1230,3026,-74.00528717,40.7145195
227,"NEWARK DE",7,59,16,24,19,59,-75.74462128,39.68774414
227,"NEWARK NJ",7,164,54,38,72,164,-74.17185211,40.73570633
227,"NEWARK OH",7,1,0,0,1,1,-82.40110779,40.05843353
227,"NEWBURGH NY",7,11,1,3,7,11,-74.00939941,41.50367737
227,"NEWBURYPORT MA",7,6,2,2,2,6,-70.8768692,42.81164551
227,"NEWCASTLE WA",7,15,1,5,9,15,-122.1575165,47.53847504
227,"NEWINGTON CT",7,1,0,0,1,1,-72.72303772,41.69794464
227,"NEWMARKET NH",7,1,0,0,1,1,-70.94036102,43.07514191
227,"NEWNAN GA",7,1,0,1,0,1,-84.79645538,33.37108231
227,"NEWPORT KY",7,1,0,1,0,1,-84.49560547,39.09162521
227,"NEWPORT NEWS VA",7,26,4,6,16,26,-76.42758942,36.97909927
227,"NEWPORT NH",7,1,1,0,0,1,-72.16677856,43.36210251
227,"NEWPORT PA",7,1,0,0,1,1,-77.12986755,40.47818375
227,"NEWPORT RI",7,10,6,1,3,10,-71.31213379,41.49024963
227,"NEWPORT TN",7,1,0,1,0,1,-83.18756104,35.96707916
227,"NEWTON KS",7,10,4,3,3,10,-97.3455658,38.04684067
227,"NEWTON MA",7,16,6,4,6,16,-71.20809937,42.33743286
227,"NEWTON NC",7,1,0,0,1,1,-81.22117615,35.67030334
227,"NEWTOWN PA",7,2,1,1,0,2,-74.93606567,40.22966003
227,"NIAGARA FALLS NY",7,23,8,6,9,23,-79.05632019,43.09456253
227,"NICEVILLE FL",7,1,0,1,0,1,-86.50150299,30.52109146
227,"NICHOLASVILLE KY",7,1,0,0,1,1,-84.57271576,37.88071442
227,"NICHOLSON GA",7,3,1,0,2,3,-83.43130493,34.11414719
227,"NICKERSON NE",7,1,0,0,1,1,-96.47119141,41.53437424
227,"NILES MI",7,4,1,1,2,4,-86.25424194,41.82971573
227,"NILES OH",7,1,0,0,1,1,-80.76469421,41.18286133
227,"NISKAYUNA NY",7,2,1,0,1,2,-73.84505463,42.77999115
227,"NIXA MO",7,21,8,3,10,21,-93.29502869,37.04324341
227,"NOBLESVILLE IN",7,4,2,0,2,4,-86.01766205,40.03728104
227,"NODAWAY IA",7,1,0,1,0,1,-94.89551544,40.93712997
227,"NOEL MO",7,9,3,1,5,9,-94.4858551,36.54568481
227,"NORCROSS GA",7,13,2,4,7,13,-84.21324158,33.94129181
227,"NORFOLK VA",7,183,65,43,75,183,-76.28334045,36.84831619
227,"NORMAL IL",7,4,0,2,2,4,-88.99052429,40.51409912
227,"NORMAN OK",7,47,16,8,23,47,-97.44689178,35.22203827
227,"NORTH ADAMS MA",7,1,0,0,1,1,-73.10797882,42.70087814
227,"NORTH ANDOVER MA",7,5,2,1,2,5,-71.13425446,42.69897079
227,"NORTH AUGUSTA SC",7,7,2,2,3,7,-81.96509552,33.5021019
227,"NORTH BEND WA",7,19,9,4,6,19,-121.7899017,47.49547195
227,"NORTH BERGEN NJ",7,13,5,7,1,13,-74.0112381,40.8045845
227,"NORTH CANTON OH",7,1,0,0,1,1,-81.40194702,40.87594223
227,"NORTH CHARLESTON SC",7,6,2,2,2,6,-79.97457886,32.85499191
227,"NORTH CHICAGO IL",7,6,2,2,2,6,-87.8412323,42.3254509
227,"NORTH HAVEN CT",7,3,0,3,0,3,-72.85857391,41.39123535
227,"NORTH LAS VEGAS NV",7,9,3,2,4,9,-115.1192093,36.19900131
227,"NORTH LIBERTY IN",7,2,0,1,1,2,-86.42704773,41.5342598
227,"NORTH LITTLE ROCK AR",7,13,3,4,6,13,-92.26677704,34.76465988
227,"NORTH MIAMI BEACH FL",7,14,5,4,5,14,-80.16223907,25.93397713
227,"NORTH MIAMI FL",7,2,1,0,1,2,-80.18624115,25.8908596
227,"NORTH OLMSTED OH",7,1,0,0,1,1,-81.92334747,41.41566849
227,"NORTH PLATTE NE",7,2,1,1,0,2,-100.7660141,41.12404633
227,"NORTH POLE AK",7,1,0,0,1,1,-147.3626251,64.7430191
227,"NORTH READING MA",7,1,0,0,1,1,-71.0776062,42.57518387
227,"NORTH RIDGEVILLE OH",7,5,2,1,2,5,-82.04491425,41.37031937
227,"NORTHAMPTON MA",7,17,5,8,4,17,-72.64012146,42.32544708
227,"NORTHBROOK IL",7,2,0,0,2,2,-87.82922363,42.12767792
227,"NORTHFIELD MN",7,6,2,1,3,6,-93.16210175,44.45811081
227,"NORTHPORT NY",7,1,0,1,0,1,-73.34220123,40.90099335
227,"NORWALK CA",7,2,1,0,1,2,-118.0839539,33.90219116
227,"NORWALK CT",7,7,2,3,2,7,-73.40729523,41.11759949
227,"NORWAY MI",7,1,0,0,1,1,-87.90382385,45.78662491
227,"NORWICH CT",7,9,4,3,2,9,-72.07475281,41.52449036
227,"NORWOOD MA",7,6,2,2,2,6,-71.1987915,42.19477844
227,"NORWOOD OH",7,2,1,0,1,2,-84.45967865,39.15586853
227,"NOVATO CA",7,2,2,0,0,2,-122.576561,38.11727142
227,"NOVI MI",7,3,1,2,0,3,-83.47566223,42.48064423
227,"NUCLA CO",7,1,0,0,1,1,-108.5491257,38.26947784
227,"NUTLEY NJ",7,9,4,5,0,9,-74.15930939,40.82229996
227,"NYACK NY",7,11,4,2,5,11,-73.91687012,41.09091568
227,"O'FALLON MO",7,21,7,5,9,21,-90.69979095,38.8109436
227,"OAK BLUFFS MA",7,2,1,1,0,2,-70.56096649,41.45436859
227,"OAK LAWN IL",7,1,0,1,0,1,-87.7545929,41.721138
227,"OAK PARK IL",7,9,4,1,4,9,-87.78443909,41.88500595
227,"OAK PARK MI",7,2,1,0,0,1,-84.21956253,42.40898132
227,"OAK RIDGE TN",7,2,0,2,0,2,-84.26974487,36.01036072
227,"OAKDALE LA",7,3,2,1,0,3,-92.66092682,30.8165493
227,"OAKLAND CA",7,633,203,178,252,633,-122.2733154,37.80438614
227,"OAKLAND ME",7,1,0,0,1,1,-69.72122192,44.54064941
227,"OBERLIN OH",7,2,0,0,2,2,-82.21720886,41.29413223
227,"OCALA FL",7,12,3,2,7,12,-82.13973236,29.18780708
227,"OCEAN CITY MD",7,2,1,0,1,2,-75.08437347,38.33656311
227,"OCEAN CITY NJ",7,1,0,0,1,1,-74.57369232,39.2779808
227,"OCEAN SPRINGS MS",7,1,0,1,0,1,-88.82833862,30.41417313
227,"OCEANSIDE CA",7,24,10,6,8,24,-117.3814011,33.19587326
227,"OCOEE FL",7,1,0,0,1,1,-81.54336548,28.56987
227,"ODESSA TX",7,10,1,4,5,10,-102.3682938,31.84587097
227,"OGALLALA NE",7,23,6,6,11,23,-101.7200775,41.1279068
227,"OGDEN AR",7,2,0,1,1,2,-94.04294586,33.58304214
227,"OGDEN UT",7,24,10,4,10,24,-111.9730225,41.22582626
227,"OHATCHEE AL",7,1,1,0,0,1,-86.00268555,33.78360748
227,"OHIO IL",7,1,0,0,1,1,-89.46100616,41.55773544
227,"OJAI CA",7,3,0,1,2,3,-119.2175903,34.4372139
227,"OKEECHOBEE FL",7,6,2,2,2,6,-80.82913971,27.24450302
227,"OKLAHOMA CITY OK",7,120,31,28,61,120,-97.51699829,35.46761322
227,"OKMULGEE OK",7,1,1,0,0,1,-95.96085358,35.62366486
227,"OLATHE KS",7,33,10,9,14,33,-94.81970215,38.88142395
227,"OLD BRIDGE NJ",7,3,1,1,1,3,-74.36474609,40.41495895
227,"OLD ORCHARD BEACH ME",7,2,2,0,0,2,-70.37640381,43.51769257
227,"OLEAN NY",7,4,1,2,1,4,-78.42921448,42.07747269
227,"OLIVE BRANCH MS",7,3,1,0,2,3,-89.82355499,34.96377563
227,"OLYMPIA FIELDS IL",7,2,0,1,1,2,-87.67446899,41.51344299
227,"OLYMPIA WA",7,67,23,14,30,67,-122.8909378,47.04053497
227,"OMAHA NE",7,133,33,40,60,133,-95.93825531,41.25878906
227,"ONEONTA NY",7,4,1,2,1,4,-75.0631485,42.45296097
227,"ONTARIO CA",7,11,3,4,4,11,-117.6528702,34.06340408
227,"ONTARIO OR",7,1,0,0,1,1,-116.9652557,44.02645111
227,"OPELIKA AL",7,3,1,1,1,3,-85.3780365,32.64568329
227,"ORANGE CA",7,21,6,5,10,21,-117.8544846,33.7877388
227,"ORANGE CITY IA",7,4,1,1,2,4,-96.05925751,43.00707626
227,"ORANGE PARK FL",7,4,2,0,2,4,-81.70614624,30.16655731
227,"ORANGE TX",7,2,0,2,0,2,-93.73699951,30.09343147
227,"ORANGE VA",7,1,0,1,0,1,-78.11038208,38.2454834
227,"ORANGEBURG SC",7,5,2,1,2,5,-80.86129761,33.48974228
227,"OREGON CITY OR",7,2,1,0,1,2,-122.6096726,45.35689163
227,"OREM UT",7,3,2,1,0,3,-111.6960449,40.29695892
227,"ORLANDO FL",7,445,127,125,193,445,-81.3789978,28.53886795
227,"ORMOND BEACH FL",7,19,4,8,7,19,-81.05541992,29.28623772
227,"OSHKOSH WI",7,3,2,1,0,3,-88.54268646,44.02453613
227,"OSKALOOSA IA",7,1,1,0,0,1,-92.64469147,41.29632568
227,"OSSINING NY",7,5,2,2,1,5,-73.86093903,41.16327286
227,"OSWEGO IL",7,2,0,1,1,2,-88.3513031,41.68288422
227,"OSWEGO NY",7,1,0,0,1,1,-76.50988007,43.45563889
227,"OTTAWA IL",7,1,1,0,0,1,-88.8425827,41.34545898
227,"OTTAWA KS",7,5,3,2,0,5,-95.26805878,38.61549759
227,"OTTAWA OH",7,4,1,1,2,4,-84.04722595,41.01917267
227,"OTTUMWA IA",7,2,0,0,2,2,-92.41059113,41.01459122
227,"OVERLAND MO",7,5,2,1,2,5,-90.36277008,38.70130157
227,"OVERLAND PARK KS",7,49,13,12,24,49,-94.67124939,38.98216248
227,"OVIEDO FL",7,1,0,1,0,1,-81.20778656,28.67054749
227,"OWASSO OK",7,1,0,0,1,1,-95.85546875,36.26954651
227,"OWATONNA MN",7,2,0,2,0,2,-93.22633362,44.08358383
227,"OWENSBORO KY",7,13,4,3,6,13,-87.11345673,37.77421188
227,"OWINGSVILLE KY",7,1,0,1,0,1,-83.76404572,38.14480591
227,"OXFORD MS",7,27,9,9,9,27,-89.52319336,34.37203979
227,"OXFORD NC",7,1,0,0,1,1,-78.59002686,36.31116486
227,"OXFORD OH",7,2,0,1,1,2,-84.74536133,39.50694275
227,"OXNARD CA",7,9,1,5,3,9,-119.1790085,34.19766998
227,"OZARK MO",7,2,2,0,0,2,-93.20661163,37.02112198
227,"PACIFIC GROVE CA",7,1,1,0,0,1,-121.9299164,36.62815475
227,"PACIFIC MO",7,2,1,0,1,2,-90.74199677,38.48199081
227,"PACIFICA CA",7,6,1,0,5,6,-122.4893951,37.61383438
227,"PADUCAH KY",7,11,1,0,10,11,-88.60009766,37.08333206
227,"PAHOKEE FL",7,1,1,0,0,1,-80.66488647,26.82079887
227,"PALATINE IL",7,1,0,0,1,1,-88.03440857,42.11017609
227,"PALATKA FL",7,1,1,0,0,1,-81.63694763,29.6489048
227,"PALESTINE TX",7,3,0,1,2,3,-95.6313324,31.76263046
227,"PALISADES PARK NJ",7,6,3,1,2,6,-73.9969635,40.84852982
227,"PALM BAY FL",7,12,3,2,7,12,-80.58313751,28.03806496
227,"PALM BEACH FL",7,16,4,4,8,16,-80.03616333,26.70643616
227,"PALM BEACH GARDENS FL",7,5,1,1,3,5,-80.07454681,26.8109169
227,"PALM DESERT CA",7,1,0,1,0,1,-116.3907166,33.72164154
227,"PALM SPRINGS CA",7,35,7,13,15,35,-116.5467758,33.83036423
227,"PALM SPRINGS FL",7,1,1,0,0,1,-80.09664154,26.63662338
227,"PALMDALE CA",7,6,3,0,3,6,-118.118454,34.57925034
227,"PALMER AK",7,5,0,2,3,5,-149.1138458,61.59459305
227,"PALO ALTO CA",7,33,12,7,14,33,-122.1449661,37.44177628
227,"PANAMA CITY BEACH FL",7,12,3,4,5,12,-85.80211639,30.1792717
227,"PANAMA CITY FL",7,12,3,5,4,12,-85.65970612,30.16412926
227,"PARADISE CA",7,3,1,2,0,3,-121.6395493,39.74609756
227,"PARADISE VALLEY AZ",7,1,0,1,0,1,-111.9442825,33.53105164
227,"PARAGOULD AR",7,4,2,2,0,4,-90.5002594,36.05854034
227,"PARAMOUNT CA",7,2,0,0,2,2,-118.161644,33.88947678
227,"PARDEEVILLE WI",7,1,1,0,0,1,-89.30020142,43.53787613
227,"PARIS IL",7,7,2,3,2,7,-87.69623566,39.61117172
227,"PARIS TX",7,5,2,2,1,5,-95.55589294,33.66113663
227,"PARK CITY IL",7,9,1,4,4,9,-87.88415527,42.34825897
227,"PARK CITY UT",7,93,31,24,38,93,-111.5018539,40.65143204
227,"PARKER CO",7,7,3,1,3,7,-104.7624359,39.51849365
227,"PARKERSBURG WV",7,1,0,0,1,1,-81.54850006,39.28261948
227,"PARKVILLE MO",7,1,1,0,0,1,-94.68252563,39.19501114
227,"PARLIER CA",7,1,0,0,1,1,-119.5286789,36.61136627
227,"PARMA OH",7,5,1,2,2,5,-81.72257996,41.40510178
227,"PASADENA CA",7,101,38,30,33,101,-118.1466675,34.14794922
227,"PASADENA TX",7,1,1,0,0,1,-95.20979309,29.69150162
227,"PASCAGOULA MS",7,2,2,0,0,2,-88.55257416,30.36789703
227,"PASS CHRISTIAN MS",7,1,0,0,1,1,-89.24402618,30.32174683
227,"PATERSON NJ",7,20,9,5,6,20,-74.17102051,40.91714478
227,"PATTERSON CA",7,4,1,0,3,4,-121.1320572,37.47135162
227,"PAULSBORO NJ",7,1,1,0,0,1,-75.23970032,39.83067322
227,"PAVILION NY",7,1,0,0,1,1,-78.02204895,42.87609482
227,"PAWTUCKET RI",7,3,2,0,1,3,-71.38137054,41.87892532
227,"PAYETTE ID",7,5,3,1,1,5,-116.9361572,44.07813263
227,"PAYSON UT",7,1,0,0,1,1,-111.7331848,40.04447937
227,"PEABODY MA",7,2,0,1,1,2,-70.92794037,42.52825928
227,"PEARL MS",7,1,1,0,0,1,-90.13196564,32.27502441
227,"PEARLAND TX",7,2,0,2,0,2,-95.28644562,29.56411743
227,"PECULIAR MO",7,1,1,0,0,1,-94.4588623,38.71911621
227,"PEKIN IL",7,2,1,1,0,2,-89.64067841,40.56766891
227,"PEMBERTON NJ",7,1,0,1,0,1,-74.68242645,39.97236252
227,"PEMBROKE PINES FL",7,16,6,5,5,16,-80.22357941,26.00384903
227,"PEN ARGYL PA",7,1,0,0,1,1,-75.25401306,40.86899567
227,"PENDLETON OR",7,6,2,1,3,6,-118.7900848,45.67152786
227,"PENDLETON SC",7,1,0,1,0,1,-82.78354645,34.65194321
227,"PENN HILLS PA",7,1,0,0,1,1,-79.85767365,40.46170044
227,"PENSACOLA FL",7,49,18,9,22,49,-87.21669006,30.42154694
227,"PEORIA AZ",7,6,1,3,2,6,-112.2390747,33.58084106
227,"PEORIA IL",7,25,3,5,17,25,-89.59487152,40.70241928
227,"PERKASIE PA",7,1,1,0,0,1,-75.29193115,40.37245178
227,"PERRIS CA",7,3,1,0,2,3,-117.2306519,33.78261948
227,"PERRYSBURG OH",7,10,3,2,5,10,-83.62700653,41.55728531
227,"PERRYVILLE MO",7,4,2,0,2,4,-89.86131287,37.72448349
227,"PERTH AMBOY NJ",7,8,1,2,5,8,-74.26480103,40.5068779
227,"PETAL MS",7,2,1,0,1,2,-89.26022339,31.34682083
227,"PETALUMA CA",7,6,4,0,2,6,-122.6394272,38.23221207
227,"PETERSBURG VA",7,1,0,1,0,1,-77.40148926,37.2280426
227,"PFLUGERVILLE TX",7,6,0,2,4,6,-97.62039948,30.4396553
227,"PHARR TX",7,1,0,0,1,1,-98.1840744,26.19566154
227,"PHENIX CITY AL",7,2,1,1,0,2,-85.00059509,32.4714241
227,"PHILADELPHIA PA",7,1203,395,306,502,1203,-75.16322327,39.95243835
227,"PHILLIPSBURG NJ",7,2,0,0,2,2,-75.18927002,40.69387054
227,"PHOENIX AZ",7,432,146,96,190,432,-112.0752716,33.44825363
227,"PHOENIX OR",7,1,0,0,1,1,-122.8203583,42.27503967
227,"PHOENIXVILLE PA",7,5,0,3,2,5,-75.51416779,40.13076401
227,"PINE BLUFF AR",7,9,3,1,5,9,-92.00374603,34.22846222
227,"PINE HILL NJ",7,1,1,0,0,1,-74.99139404,39.78429031
227,"PINOLE CA",7,1,1,0,0,1,-122.3012772,38.00416565
227,"PISMO BEACH CA",7,4,2,2,0,4,-120.6432953,35.1427269
227,"PITTSBURG CA",7,19,6,2,11,19,-121.8871613,38.02787781
227,"PITTSBURG KS",7,3,1,2,0,3,-94.70526123,37.41111374
227,"PITTSBURGH PA",7,674,230,176,268,674,-79.99537659,40.44091415
227,"PITTSFIELD MA",7,22,8,5,9,22,-73.24451447,42.45004272
227,"PLACERVILLE CA",7,16,7,4,5,16,-120.8002701,38.72951508
227,"PLAINFIELD IL",7,3,0,3,0,3,-88.20417786,41.62700653
227,"PLAINFIELD NJ",7,4,1,3,0,4,-74.40673065,40.63404083
227,"PLAINSBORO NJ",7,1,0,0,1,1,-74.59952545,40.33381653
227,"PLAINVIEW TX",7,2,0,1,1,2,-101.7073975,34.18512726
227,"PLANO IL",7,1,0,1,0,1,-88.5372467,41.66307449
227,"PLANO TX",7,35,12,8,15,35,-96.69931793,33.01993942
227,"PLANTATION FL",7,10,3,2,5,10,-80.23281097,26.12825966
227,"PLAQUEMINE LA",7,4,0,2,2,4,-91.23427582,30.28962708
227,"PLATTSBURGH NY",7,3,0,1,2,3,-73.45239258,44.69951248
227,"PLEASANT HILL CA",7,2,0,0,2,2,-122.0632401,37.94770813
227,"PLEASANT VALLEY MO",7,1,1,0,0,1,-94.48001099,39.21652985
227,"PLEASANTON CA",7,1,1,0,0,1,-121.8771362,37.66220856
227,"PLEASANTVILLE NJ",7,2,1,0,1,2,-74.52319336,39.3899765
227,"PLEASANTVILLE NY",7,1,0,1,0,1,-73.792099,41.13287354
227,"PLYMOUTH MA",7,6,3,1,2,6,-70.67458344,41.95769882
227,"PLYMOUTH MN",7,4,2,2,0,4,-93.45163727,45.02838898
227,"POCATELLO ID",7,9,4,0,5,9,-112.4475937,42.87098694
227,"POINT PLEASANT NJ",7,4,1,2,1,4,-74.06723022,40.08329391
227,"POMONA CA",7,14,3,5,6,14,-117.7534485,34.05541611
227,"POMPANO BEACH FL",7,10,3,4,3,10,-80.12407684,26.23855591
227,"PONTIAC IL",7,1,0,0,1,1,-88.62986755,40.88091278
227,"PONTIAC MI",7,5,1,1,3,5,-83.29104614,42.63900757
227,"POPLAR BLUFF MO",7,2,0,0,2,2,-90.3928833,36.75717545
227,"POQUOSON VA",7,1,1,0,0,1,-76.39202881,37.14147568
227,"PORT ANGELES WA",7,5,3,1,1,5,-123.4329224,48.11795044
227,"PORT ARTHUR TX",7,27,8,7,12,27,-93.93045807,29.90067863
227,"PORT LAVACA TX",7,1,0,0,1,1,-96.62651062,28.61569214
227,"PORT ORANGE FL",7,4,1,2,1,4,-81.00856781,29.13491631
227,"PORT ORFORD OR",7,5,2,2,1,5,-124.4993668,42.74531555
227,"PORT WASHINGTON WI",7,1,1,0,0,1,-87.876091,43.3874321
227,"PORTAGE IN",7,1,0,0,1,1,-87.18197632,41.57239151
227,"PORTAGE MI",7,5,2,3,0,5,-85.57974243,42.20133972
227,"PORTAGE WI",7,2,1,0,1,2,-89.46311188,43.53891754
227,"PORTALES NM",7,1,0,1,0,1,-103.3379746,34.18170547
227,"PORTER OK",7,2,0,1,1,2,-95.5231781,35.87133026
227,"PORTERVILLE CA",7,2,1,0,1,2,-119.0190811,36.06521988
227,"PORTLAND ME",7,83,23,22,38,83,-70.25403595,43.6618576
227,"PORTLAND OR",7,1219,418,291,510,1219,-122.6786423,45.52309418
227,"PORTLAND TX",7,1,0,0,1,1,-97.32419586,27.87795258
227,"PORTOLA VALLEY CA",7,1,0,0,1,1,-122.2373505,37.38395309
227,"PORTSMOUTH NH",7,11,1,3,7,11,-70.76164246,43.07198334
227,"PORTSMOUTH OH",7,1,1,0,0,1,-82.99292755,38.74839783
227,"PORTSMOUTH VA",7,14,2,3,9,14,-76.29769135,36.83554077
227,"POST FALLS ID",7,2,1,1,0,2,-116.954155,47.71800613
227,"POTTSTOWN PA",7,3,1,2,0,3,-75.64894867,40.24571609
227,"POUGHKEEPSIE NY",7,6,4,0,2,6,-73.92034149,41.70055771
227,"POULTNEY VT",7,2,1,1,0,2,-73.23524475,43.51735687
227,"POUND VA",7,1,1,0,0,1,-82.60127258,37.12379837
227,"POWDER SPRINGS GA",7,1,0,0,1,1,-84.68379974,33.8599205
227,"PRAIRIE DU SAC WI",7,1,0,0,1,1,-89.72431183,43.28665543
227,"PRAIRIE VIEW TX",7,4,3,0,1,4,-95.9883194,30.09370232
227,"PRAIRIE VILLAGE KS",7,8,4,3,1,8,-94.63400269,38.99189377
227,"PRATTVILLE AL",7,13,4,5,4,13,-86.45972443,32.46446228
227,"PRESCOTT AZ",7,2,0,1,1,2,-112.4702301,34.54008102
227,"PRESQUE ISLE ME",7,1,0,0,1,1,-68.01457214,46.68122482
227,"PRIEST RIVER ID",7,1,1,0,0,1,-116.906868,48.18558121
227,"PRINCESS ANNE MD",7,2,1,1,0,2,-75.69158173,38.20330429
227,"PRINCETON MN",7,1,0,0,1,1,-93.58203888,45.56974411
227,"PRINCETON NJ",7,41,20,10,11,41,-74.65805817,40.34872055
227,"PROSPECT PA",7,2,0,0,2,2,-80.04576111,40.90452576
227,"PROSPER TX",7,1,1,0,0,1,-96.80168915,33.23641205
227,"PROVIDENCE RI",7,142,44,36,62,142,-71.40118408,41.82990265
227,"PROVINCETOWN MA",7,92,29,27,36,92,-70.17770386,42.05849075
227,"PROVO UT",7,16,2,8,6,16,-111.6589813,40.23337936
227,"PUEBLO CO",7,58,19,13,26,58,-104.6108551,38.25450516
227,"PULLMAN WA",7,123,36,39,48,123,-117.180481,46.73068619
227,"PUNTA GORDA FL",7,2,0,0,2,2,-82.04517365,26.93050766
227,"PUYALLUP WA",7,6,3,1,2,6,-122.2927628,47.19064331
227,"QUAKERTOWN PA",7,6,0,2,4,6,-75.33325958,40.44256592
227,"QUARRYVILLE PA",7,1,0,1,0,1,-76.16281891,39.898983
227,"QUEEN CREEK AZ",7,1,1,0,0,1,-111.6382294,33.25391769
227,"QUINCY IL",7,6,3,1,2,6,-91.41021729,39.9356575
227,"QUINCY MA",7,8,4,0,4,8,-71.00706482,42.24961472
227,"QUINCY MI",7,2,0,1,1,2,-84.88388824,41.94426727
227,"RACINE WI",7,7,2,1,4,7,-87.78296661,42.72628021
227,"RADFORD VA",7,20,10,6,4,20,-80.57588196,37.13208389
227,"RALEIGH NC",7,362,115,92,155,362,-78.63800049,35.77230835
227,"RAMSEY NJ",7,1,0,0,1,1,-74.13990021,41.05768967
227,"RANCHO CORDOVA CA",7,2,0,1,1,2,-121.3053742,38.58900452
227,"RANCHO MIRAGE CA",7,5,1,2,2,5,-116.4143066,33.73956299
227,"RANDOLPH MA",7,4,2,0,2,4,-71.03983307,42.1629715
227,"RANDOLPH ME",7,2,0,2,0,2,-69.75239563,44.23274612
227,"RANDOLPH VT",7,1,0,0,1,1,-72.6631012,43.92315674
227,"RAPID CITY SD",7,3,2,0,1,3,-103.2325821,44.08078766
227,"RAYTOWN MO",7,18,9,4,5,18,-94.46369934,39.00871277
227,"READING MA",7,1,0,0,1,1,-71.0990448,42.52708054
227,"READING PA",7,22,10,4,8,22,-75.9259491,40.33562851
227,"RED BANK NJ",7,3,0,0,3,3,-74.06324768,40.3471756
227,"RED BLUFF CA",7,1,1,0,0,1,-122.2382431,40.17803574
227,"RED HOOK NY",7,2,0,1,1,2,-73.87477875,41.99516296
227,"RED LION PA",7,2,0,1,1,2,-76.60523987,39.9010849
227,"RED WING MN",7,1,0,0,1,1,-92.53401184,44.56221771
227,"REDDING CA",7,7,2,0,5,7,-122.3944626,40.58649826
227,"REDDING CT",7,1,1,0,0,1,-73.38277435,41.30291367
227,"REDLANDS CA",7,7,2,1,4,7,-117.21064,34.0318718
227,"REDMOND WA",7,40,14,12,14,40,-122.1240006,47.67367172
227,"REDONDO BEACH CA",7,24,5,8,11,24,-118.3907471,33.84916687
227,"REDWOOD CITY CA",7,30,10,7,13,30,-122.2364655,37.48601151
227,"REFUGIO TX",7,4,0,0,4,4,-97.27603912,28.30598068
227,"REIDSVILLE NC",7,5,1,2,2,5,-79.66392517,36.35525513
227,"RENO NV",7,49,23,7,19,49,-119.8160934,39.5294838
227,"RENTON WA",7,31,10,9,12,31,-122.2197342,47.48252487
227,"REPUBLIC MO",7,1,0,0,1,1,-93.48056793,37.12031555
227,"REXBURG ID",7,2,1,1,0,2,-111.7915344,43.82584763
227,"REYNOLDSBURG OH",7,2,0,0,2,2,-82.81163788,39.95471191
227,"RIALTO CA",7,2,1,0,1,2,-117.3716126,34.1063118
227,"RICE LAKE WI",7,6,1,4,1,6,-91.73868561,45.5060463
227,"RICHARDSON TX",7,9,3,3,3,9,-96.73020172,32.94840622
227,"RICHFIELD MN",7,5,2,1,2,5,-93.28303528,44.87028503
227,"RICHLAND WA",7,2,0,1,1,2,-119.2866592,46.28547287
227,"RICHMOND CA",7,29,10,9,10,29,-122.3500443,37.9354744
227,"RICHMOND HEIGHTS MO",7,22,4,4,14,22,-90.31951904,38.62892532
227,"RICHMOND HILL GA",7,2,0,1,1,2,-81.30295563,31.9388752
227,"RICHMOND IN",7,5,1,2,2,5,-84.8900528,39.82888412
227,"RICHMOND KY",7,3,0,2,1,3,-84.29437256,37.74818802
227,"RICHMOND TX",7,2,0,1,1,2,-95.76106262,29.58276558
227,"RICHMOND VA",7,272,91,81,100,272,-77.45962524,37.55412674
227,"RICHTON PARK IL",7,2,0,1,1,2,-87.70342255,41.48434448
227,"RIDGECREST CA",7,3,1,2,0,3,-117.672821,35.62243652
227,"RIDGEFIELD CT",7,1,0,0,1,1,-73.49742126,41.28165054
227,"RIDGELAND MS",7,2,0,0,2,2,-90.13221741,32.42857742
227,"RIDGEWOOD NJ",7,2,2,0,0,2,-74.11595917,40.97959518
227,"RINGGOLD GA",7,2,1,1,0,2,-85.10852051,34.9195137
227,"RIO RANCHO NM",7,1,1,0,0,1,-106.6682816,35.23852539
227,"RIO VISTA CA",7,1,0,1,0,1,-121.6946182,38.15613556
227,"RIPON WI",7,3,2,0,1,3,-88.83634186,43.8422966
227,"RISING CITY NE",7,1,0,0,1,1,-97.29671478,41.19942474
227,"RISON AR",7,1,1,0,0,1,-92.19036102,33.95878983
227,"RIVER FALLS WI",7,1,0,1,0,1,-92.62417603,44.86109543
227,"RIVERDALE GA",7,8,2,2,4,8,-84.4131012,33.57296371
227,"RIVERSIDE CA",7,155,49,41,65,155,-117.3973999,33.95311737
227,"RIVERSIDE NJ",7,9,2,3,4,9,-74.95646667,40.03240967
227,"RIVERTON UT",7,2,0,2,0,2,-111.940033,40.52087402
227,"RIVIERA BEACH FL",7,1,0,0,1,1,-80.05784607,26.77610397
227,"ROANOKE AL",7,1,1,0,0,1,-85.37194061,33.15143967
227,"ROANOKE VA",7,28,7,15,6,28,-79.94111633,37.27119827
227,"ROBBINSDALE MN",7,1,0,0,1,1,-93.33868408,45.03195572
227,"ROBINSON IL",7,1,0,0,1,1,-87.73912048,39.00521469
227,"ROCHELLE IL",7,3,0,2,1,3,-89.06913757,41.9238472
227,"ROCHESTER IN",7,1,1,0,0,1,-86.21604919,41.06472015
227,"ROCHESTER MI",7,1,0,0,1,1,-83.13374329,42.68050766
227,"ROCHESTER MN",7,26,9,6,11,26,-92.47042084,44.02156448
227,"ROCHESTER NY",7,200,64,56,80,200,-77.61522675,43.15487671
227,"ROCK HILL MO",7,1,1,0,0,1,-90.37846375,38.60773849
227,"ROCK HILL SC",7,24,6,12,6,24,-81.02463531,34.92498779
227,"ROCK ISLAND IL",7,1,1,0,0,1,-90.5790329,41.50963593
227,"ROCKDALE TX",7,2,0,0,2,2,-97.00177765,30.65601349
227,"ROCKFORD IL",7,22,6,7,9,22,-89.09428406,42.27135086
227,"ROCKFORD MI",7,3,1,0,2,3,-85.56002045,43.12025833
227,"ROCKFORD MN",7,1,0,1,0,1,-93.73521423,45.08799744
227,"ROCKINGHAM NC",7,1,0,1,0,1,-79.77334595,34.9397316
227,"ROCKLAND ME",7,4,1,1,2,4,-69.1079483,44.10363388
227,"ROCKLIN CA",7,3,0,0,3,3,-121.2383118,38.79031754
227,"ROCKPORT MA",7,2,0,2,0,2,-70.61954498,42.65607071
227,"ROCKVILLE CENTRE NY",7,2,0,1,1,2,-73.64044189,40.6588974
227,"ROCKVILLE MD",7,10,3,3,4,10,-77.15235901,39.08402252
227,"ROCKWALL TX",7,3,0,0,3,3,-96.46016693,32.93169022
227,"ROCKY HILL CT",7,2,0,0,2,2,-72.64056396,41.66537857
227,"ROCKY MOUNT NC",7,2,0,1,1,2,-77.78997803,35.93837738
227,"ROCKY RIVER OH",7,5,1,3,1,5,-81.83889008,41.4756279
227,"ROGERS AR",7,10,3,3,4,10,-94.11903381,36.33228683
227,"ROLLA MO",7,1,1,0,0,1,-91.77151489,37.95161438
227,"ROME GA",7,1,0,1,0,1,-85.16900635,34.24008942
227,"ROMEOVILLE IL",7,1,1,0,0,1,-88.08948517,41.64759064
227,"ROSCOE SD",7,1,1,0,0,1,-99.33797455,45.44993591
227,"ROSE VALLEY PA",7,3,1,1,1,3,-75.38393402,39.89647293
227,"ROSELLE IL",7,1,1,0,0,1,-88.08023071,41.9848671
227,"ROSEMOUNT MN",7,3,0,0,3,3,-93.12598419,44.73943329
227,"ROSENBERG TX",7,4,2,0,2,4,-95.80905914,29.5575695
227,"ROSENDALE NY",7,1,1,0,0,1,-74.0810318,41.84408951
227,"ROSEVILLE CA",7,8,1,5,2,8,-121.2899246,38.75195694
227,"ROSEVILLE MI",7,1,0,0,1,1,-82.93720245,42.49747086
227,"ROSEVILLE MN",7,4,2,2,0,4,-93.14508057,45.02290726
227,"ROSWELL GA",7,13,4,4,5,13,-84.36141205,34.02328491
227,"ROSWELL NM",7,2,0,0,2,2,-104.5282135,33.39533997
227,"ROTTERDAM NY",7,1,0,0,1,1,-73.96983337,42.78696823
227,"ROUND ROCK TX",7,12,4,0,8,12,-97.67939758,30.50861359
227,"ROWLETT TX",7,12,2,5,5,12,-96.56422424,32.90298462
227,"ROXBORO NC",7,7,2,2,3,7,-78.98235321,36.3940506
227,"ROYAL OAK MI",7,5,1,2,2,5,-83.1442337,42.48933792
227,"ROYERSFORD PA",7,1,0,1,0,1,-75.53735352,40.18464279
227,"ROYSE CITY TX",7,2,1,0,1,2,-96.33287048,32.97550201
227,"RUMSON NJ",7,1,0,0,1,1,-73.99851227,40.37051773
227,"RUSHVILLE IL",7,1,1,0,0,1,-90.56352997,40.12114334
227,"RUSHVILLE IN",7,1,0,0,1,1,-85.45323944,39.6113205
227,"RUSSELL KS",7,1,0,1,0,1,-98.86052704,38.89523697
227,"RUSSELLVILLE AR",7,20,6,5,9,20,-93.1343689,35.27845383
227,"RUSTON LA",7,1,0,0,1,1,-92.63848877,32.52357101
227,"RUTHERFORD NJ",7,1,0,0,1,1,-74.10585022,40.82668304
227,"RUTHERFORDTON NC",7,3,2,1,0,3,-81.95639801,35.3694458
227,"RYE CO",7,6,2,0,4,6,-104.9316177,37.92366791
227,"RYE NY",7,3,0,0,3,3,-73.68312836,40.98072433
227,"SACKETS HARBOR NY",7,1,1,0,0,1,-76.12520599,43.94608688
227,"SACO ME",7,6,1,0,5,6,-70.4417038,43.50106049
227,"SACRAMENTO CA",7,260,86,77,97,260,-121.4959793,38.58154297
227,"SADDLE BROOK NJ",7,1,1,0,0,1,-74.09207153,40.89922333
227,"SAGINAW MI",7,15,4,3,8,15,-83.95076752,43.41968918
227,"SAHUARITA AZ",7,59,19,15,25,59,-110.9567032,31.95795059
227,"SALEM IL",7,30,6,12,12,30,-88.94590759,38.62715149
227,"SALEM MA",7,9,3,1,5,9,-70.89565277,42.51993179
227,"SALEM NH",7,1,0,0,1,1,-71.19998169,42.78861618
227,"SALEM OR",7,37,15,11,11,37,-123.0377197,44.94248199
227,"SALEM VA",7,3,1,1,1,3,-80.05405426,37.29384232
227,"SALINA KS",7,1,0,1,0,1,-97.61184692,38.84041977
227,"SALINAS CA",7,85,21,36,28,85,-121.6571732,36.67780304
227,"SALISBURY MD",7,16,4,5,7,16,-75.5984726,38.36100388
227,"SALISBURY NC",7,3,1,0,2,3,-80.47377014,35.67113495
227,"SALT LAKE CITY UT",7,129,39,37,53,129,-111.8912659,40.77029037
227,"SAN ANGELO TX",7,16,3,6,7,16,-100.4379044,31.46401215
227,"SAN ANSELMO CA",7,1,0,0,1,1,-122.5641785,37.97429276
227,"SAN ANTONIO TX",7,500,160,130,210,500,-98.49394989,29.42439651
227,"SAN BERNARDINO CA",7,21,3,5,13,21,-117.304596,34.12142563
227,"SAN BRUNO CA",7,2,1,0,1,2,-122.4133148,37.63018799
227,"SAN CARLOS CA",7,1,1,0,0,1,-122.262207,37.50718307
227,"SAN CLEMENTE CA",7,6,1,0,5,6,-117.6134033,33.42698669
227,"SAN DIEGO CA",7,710,213,223,274,710,-117.1587296,32.71524429
227,"SAN DIMAS CA",7,2,0,1,1,2,-117.8088913,34.10668945
227,"SAN FERNANDO CA",7,1,1,0,0,1,-118.4407349,34.28187561
227,"SAN FRANCISCO CA",7,1041,333,267,441,1041,-122.4213257,37.77465057
227,"SAN GABRIEL CA",7,3,2,0,1,3,-118.107605,34.09612274
227,"SAN JOSE CA",7,134,40,43,51,134,-121.8973846,37.33491516
227,"SAN JUAN CAPISTRANO CA",7,1,1,0,0,1,-117.6644516,33.50197601
227,"SAN LEANDRO CA",7,7,1,2,4,7,-122.155983,37.70180511
227,"SAN LUIS OBISPO CA",7,15,3,2,10,15,-120.6622849,35.28281021
227,"SAN MARCOS CA",7,8,1,0,7,8,-117.1673966,33.14345551
227,"SAN MARCOS TX",7,38,13,18,7,38,-97.94176483,29.88363266
227,"SAN MATEO CA",7,16,7,2,7,16,-122.3270264,37.56283569
227,"SAN PABLO CA",7,2,2,0,0,2,-122.3469696,37.96184921
227,"SAN RAFAEL CA",7,10,6,1,3,10,-122.5331726,37.97325134
227,"SAN RAMON CA",7,5,2,0,3,5,-121.9799347,37.77985764
227,"SAND SPRINGS OK",7,1,0,1,0,1,-96.10940552,36.13979721
227,"SANDUSKY OH",7,3,0,1,2,3,-82.7080307,41.44903183
227,"SANDY OR",7,6,3,0,3,6,-122.263649,45.39704132
227,"SANDY SPRINGS GA",7,5,0,2,3,5,-84.37850952,33.92443848
227,"SANFORD FL",7,3,0,0,3,3,-81.27256012,28.80128288
227,"SANIBEL FL",7,1,0,1,0,1,-82.02768707,26.45082092
227,"SANTA ANA CA",7,24,6,4,14,24,-117.8697281,33.74567413
227,"SANTA BARBARA CA",7,110,38,31,41,110,-119.7056656,34.4233017
227,"SANTA CLARA CA",7,24,10,9,5,24,-121.946434,37.34754181
227,"SANTA CRUZ CA",7,50,21,15,14,50,-122.0333557,36.97389984
227,"SANTA FE NM",7,43,15,11,17,43,-105.9468155,35.68014526
227,"SANTA FE SPRINGS CA",7,1,0,0,1,1,-118.0864639,33.94723129
227,"SANTA MARIA CA",7,5,1,1,3,5,-120.437973,34.95292664
227,"SANTA MONICA CA",7,98,25,29,44,98,-118.4925232,34.01921082
227,"SANTA PAULA CA",7,2,0,0,2,2,-119.0609283,34.35404587
227,"SANTA ROSA CA",7,42,18,5,19,42,-122.7165146,38.44017792
227,"SARANAC LAKE NY",7,1,1,0,0,1,-74.1305542,44.32965851
227,"SARASOTA FL",7,34,13,5,16,34,-82.53031158,27.33688736
227,"SARATOGA CA",7,1,0,1,0,1,-122.0252457,37.26384735
227,"SARATOGA SPRINGS NY",7,2,1,1,0,2,-73.78382111,43.08345032
227,"SARTELL MN",7,1,0,0,1,1,-94.20728302,45.62141418
227,"SATELLITE BEACH FL",7,1,0,0,1,1,-80.58939362,28.17677498
227,"SAUGATUCK MI",7,1,0,1,0,1,-86.2021637,42.65496826
227,"SAUGERTIES NY",7,5,2,1,2,5,-73.95199585,42.07786942
227,"SAUGUS MA",7,1,0,1,0,1,-71.00926971,42.46496964
227,"SAUK RAPIDS MN",7,1,1,0,0,1,-94.16661835,45.59189987
227,"SAUK VILLAGE IL",7,1,1,0,0,1,-87.56780243,41.48827362
227,"SAUKVILLE WI",7,1,0,0,1,1,-87.94111633,43.38184738
227,"SAUSALITO CA",7,6,1,3,2,6,-122.4881592,37.85736847
227,"SAVANNAH GA",7,96,18,28,50,96,-81.09463501,32.07280731
227,"SCARSDALE NY",7,1,1,0,0,1,-73.78360748,41.00525665
227,"SCHAUMBURG IL",7,2,1,0,1,2,-88.08359528,42.03350449
227,"SCHENECTADY NY",7,5,0,3,2,5,-73.938591,42.81433487
227,"SCHUYLKILL HAVEN PA",7,2,0,1,1,2,-76.17021942,40.63098145
227,"SCOTLAND SD",7,1,0,1,0,1,-97.72131348,43.14982605
227,"SCOTTSBORO AL",7,3,2,0,1,3,-86.03386688,34.67259216
227,"SCOTTSDALE AZ",7,45,9,15,21,45,-111.9002533,33.50918579
227,"SCRANTON PA",7,18,4,5,9,18,-75.66184998,41.40919113
227,"SEABROOK TX",7,1,0,1,0,1,-95.02601624,29.56442451
227,"SEAL BEACH CA",7,1,1,0,0,1,-118.1067505,33.74150848
227,"SEARCY AR",7,1,1,0,0,1,-91.73634338,35.25092697
227,"SEASIDE CA",7,2,0,0,2,2,-121.8542252,36.6110611
227,"SEATTLE WA",7,1529,514,392,623,1529,-122.3343964,47.60571289
227,"SEBASTOPOL CA",7,2,2,0,0,2,-122.8264999,38.40188217
227,"SEDALIA MO",7,9,1,5,3,9,-93.22884369,38.70438766
227,"SEDONA AZ",7,11,3,4,4,11,-111.7623367,34.86959839
227,"SEGUIN TX",7,2,1,0,1,2,-97.96529388,29.56933594
227,"SELAH WA",7,1,0,1,0,1,-120.5326233,46.65384674
227,"SELINSGROVE PA",7,1,1,0,0,1,-76.86167145,40.79915619
227,"SELMA AL",7,1,0,0,1,1,-87.02119446,32.40768433
227,"SELMA CA",7,1,1,0,0,1,-119.6140518,36.57050323
227,"SEMINOLE FL",7,1,0,0,1,1,-82.79083252,27.84035683
227,"SENECA SC",7,5,1,3,1,5,-82.95318604,34.68600845
227,"SEYMOUR MO",7,1,1,0,0,1,-92.76896667,37.14664459
227,"SHAKER HEIGHTS OH",7,39,21,9,9,39,-81.53669739,41.47419357
227,"SHAKOPEE MN",7,10,1,4,5,10,-93.52770233,44.79788971
227,"SHAMOKIN PA",7,1,1,0,0,1,-76.55822754,40.78910828
227,"SHARONVILLE OH",7,1,0,1,0,1,-84.41338348,39.26810455
227,"SHARPSVILLE IN",7,2,1,0,1,2,-86.08840179,40.37942886
227,"SHAWNEE KS",7,6,2,2,2,6,-94.7208786,39.0417366
227,"SHAWNEE OK",7,2,1,1,0,2,-96.92608643,35.32754898
227,"SHEBOYGAN WI",7,25,10,3,12,25,-87.71476746,43.75089264
227,"SHEFFIELD LAKE OH",7,3,0,0,3,3,-82.10116577,41.48757935
227,"SHELBURNE VT",7,1,0,1,0,1,-73.22679901,44.3805542
227,"SHELBY NC",7,2,0,0,2,2,-81.53518677,35.29262543
227,"SHELBYVILLE IN",7,1,0,0,1,1,-85.77182007,39.5215683
227,"SHELBYVILLE KY",7,1,0,1,0,1,-85.22341156,38.21203232
227,"SHEPHERD TX",7,1,1,0,0,1,-94.99694824,30.49860954
227,"SHERMAN TX",7,3,0,1,2,3,-96.60933685,33.63597488
227,"SHERWOOD AR",7,3,0,2,1,3,-92.22438049,34.81515884
227,"SHIPPENSBURG PA",7,1,1,0,0,1,-77.51955414,40.05068207
227,"SHIVELY KY",7,6,1,1,4,6,-85.82255554,38.20013809
227,"SHREVEPORT LA",7,54,15,14,25,54,-93.7507019,32.52565002
227,"SIERRA MADRE CA",7,7,2,2,3,7,-118.0547943,34.16183853
227,"SIGNAL HILL CA",7,1,0,0,1,1,-118.1697388,33.80453873
227,"SIKESTON MO",7,2,1,0,1,2,-89.5878067,36.87693024
227,"SILOAM SPRINGS AR",7,6,1,2,3,6,-94.54097748,36.18841934
227,"SILVER CITY NM",7,2,2,0,0,2,-108.281929,32.77336884
227,"SIMI VALLEY CA",7,8,4,1,3,8,-118.7839508,34.26951981
227,"SIMPSONVILLE SC",7,8,2,4,2,8,-82.25405121,34.73744202
227,"SIMSBURY CT",7,1,1,0,0,1,-72.8000412,41.8762207
227,"SINTON TX",7,2,0,2,0,2,-97.50976562,28.03709793
227,"SIOUX CITY IA",7,6,0,2,4,6,-96.40085602,42.5001564
227,"SIOUX FALLS SD",7,14,5,3,6,14,-96.73429108,43.54177475
227,"SKOKIE IL",7,1,0,0,1,1,-87.73321533,42.03328705
227,"SKYKOMISH WA",7,1,0,0,1,1,-121.362587,47.70903015
227,"SLIDELL LA",7,9,4,1,4,9,-89.78143311,30.27558708
227,"SLIPPERY ROCK PA",7,1,0,0,1,1,-80.05516052,41.06407928
227,"SMITHVILLE MO",7,2,1,0,1,2,-94.58171082,39.38669586
227,"SMITHVILLE TN",7,1,1,0,0,1,-85.81411743,35.96058273
227,"SMYRNA GA",7,6,1,3,2,6,-84.51447296,33.88409042
227,"SMYRNA TN",7,1,0,0,1,1,-86.51843262,35.98318863
227,"SNOHOMISH WA",7,7,1,5,1,7,-122.1009903,47.91241837
227,"SOLANA BEACH CA",7,2,1,0,1,2,-117.2725525,32.99123383
227,"SOLDOTNA AK",7,1,0,1,0,1,-151.0635071,60.47569275
227,"SOMERSET KY",7,1,1,0,0,1,-84.60385132,37.09214783
227,"SOMERVILLE MA",7,88,29,18,41,88,-71.09860992,42.38757324
227,"SONOMA CA",7,4,0,0,4,4,-122.4600754,38.29153061
227,"SONORA CA",7,11,4,2,5,11,-120.3842011,37.98400497
227,"SOUDERTON PA",7,1,0,0,1,1,-75.32456207,40.31177902
227,"SOUTH BEND IN",7,72,19,20,33,72,-86.25171661,41.67295837
227,"SOUTH BOUND BROOK NJ",7,1,0,0,1,1,-74.53087616,40.55379105
227,"SOUTH GATE CA",7,19,8,3,8,19,-118.213707,33.95462799
227,"SOUTH HADLEY MA",7,4,1,2,1,4,-72.57582855,42.26013184
227,"SOUTH LAKE TAHOE CA",7,7,3,1,3,7,-119.972786,38.94574356
227,"SOUTH LYON MI",7,3,2,1,0,3,-83.65129089,42.46051788
227,"SOUTH NYACK NY",7,2,0,1,1,2,-73.91947937,41.08323288
227,"SOUTH PORTLAND ME",7,1,0,0,1,1,-70.23975372,43.6415062
227,"SOUTH RIVER NJ",7,1,0,1,0,1,-74.38522339,40.44672394
227,"SOUTH SAN FRANCISCO CA",7,3,2,1,0,3,-122.4101868,37.65430069
227,"SOUTHAMPTON NY",7,12,1,4,7,12,-72.38861084,40.88444519
227,"SOUTHAMPTON PA",7,1,1,0,0,1,-75.04278564,40.17464447
227,"SOUTHAVEN MS",7,3,1,2,0,3,-90.02496338,34.99386215
227,"SOUTHFIELD MI",7,12,2,3,7,12,-83.22153473,42.47357559
227,"SOUTHGATE MI",7,3,0,1,2,3,-83.19342804,42.2142067
227,"SPARKS NV",7,12,4,6,2,12,-119.7548142,39.53468704
227,"SPARTA TN",7,1,1,0,0,1,-85.46425629,35.9259491
227,"SPARTANBURG SC",7,36,10,7,19,36,-81.93160248,34.94982529
227,"SPEARFISH SD",7,3,0,1,2,3,-103.8635941,44.49181366
227,"SPEEDWAY IN",7,30,7,11,12,30,-86.2671051,39.80224609
227,"SPENCER OK",7,1,0,1,0,1,-97.3780365,35.52297974
227,"SPOKANE WA",7,80,35,16,29,80,-117.4281387,47.65847015
227,"SPRING CITY PA",7,1,1,0,0,1,-75.54719543,40.17708588
227,"SPRING HILL TN",7,2,0,1,1,2,-86.93003845,35.75111389
227,"SPRINGDALE AR",7,6,0,4,2,6,-94.12921143,36.1869278
227,"SPRINGFIELD IL",7,60,18,23,19,60,-89.6439743,39.80184174
227,"SPRINGFIELD MA",7,10,5,3,2,10,-72.57289124,42.10980606
227,"SPRINGFIELD MO",7,178,65,51,62,178,-93.29862213,37.21548843
227,"SPRINGFIELD OH",7,1,0,0,1,1,-83.80889893,39.92424011
227,"SPRINGFIELD VT",7,1,1,0,0,1,-72.48161316,43.29873657
227,"ST LOUIS MO",7,6718,2457,1305,2956,6718,-90.19819641,38.62716675
227,"STAMFORD CT",7,14,4,2,8,14,-73.53807068,41.05353165
227,"STANLEY NC",7,2,0,1,1,2,-81.09666443,35.35927582
227,"STANTON CA",7,2,1,1,0,2,-117.9945526,33.80238724
227,"STANTON KY",7,1,1,0,0,1,-83.85791779,37.84600449
227,"STANWOOD WA",7,9,4,1,4,9,-122.3728256,48.24087524
227,"STARKVILLE MS",7,5,2,2,1,5,-88.81492615,33.46545029
227,"STATE COLLEGE PA",7,26,9,7,10,26,-77.85973358,40.79336929
227,"STATESBORO GA",7,24,5,7,12,24,-81.78266907,32.44914246
227,"STATESVILLE NC",7,2,2,0,0,2,-80.88671875,35.78310013
227,"STAUNTON IL",7,1,1,0,0,1,-89.79161072,39.01238632
227,"STAUNTON VA",7,2,0,0,2,2,-79.07145691,38.14970016
227,"STEAMBOAT SPRINGS CO",7,4,0,1,3,4,-106.8292313,40.48627853
227,"STEELE AL",7,1,0,1,0,1,-86.20155334,33.94023514
227,"STERLING CO",7,1,0,1,0,1,-103.2093811,40.62519073
227,"STERLING HEIGHTS MI",7,5,1,3,1,5,-83.03016663,42.58047485
227,"STERLING IL",7,1,0,1,0,1,-89.69670868,41.78865433
227,"STEVENS POINT WI",7,1,0,1,0,1,-89.57467651,44.52337265
227,"STEVENSVILLE MT",7,1,0,1,0,1,-114.0948715,46.50963974
227,"STILLWATER MN",7,7,2,1,4,7,-92.80657959,45.05171967
227,"STILLWATER OK",7,4,2,0,2,4,-97.0588913,36.11580658
227,"STOCKBRIDGE GA",7,11,5,2,4,11,-84.23356628,33.54455185
227,"STOCKTON CA",7,48,16,10,22,48,-121.293457,37.95776749
227,"STONE MOUNTAIN GA",7,21,11,1,9,21,-84.14538574,33.8065033
227,"STONEHAM MA",7,1,1,0,0,1,-71.09869385,42.48027039
227,"STOUGHTON MA",7,2,1,0,1,2,-71.10134888,42.12547302
227,"STOW MA",7,1,0,0,1,1,-71.50474548,42.43725204
227,"STOW OH",7,4,1,2,1,4,-81.44025421,41.1593895
227,"STOWE VT",7,1,1,0,0,1,-72.68366241,44.46540451
227,"STRATFORD CT",7,2,1,1,0,2,-73.13223267,41.18459702
227,"STROUDSBURG PA",7,1,1,0,0,1,-75.19365692,40.98681259
227,"STUART FL",7,4,3,0,1,4,-80.25237274,27.19645882
227,"STUART NE",7,1,1,0,0,1,-99.14349365,42.59927368
227,"STURGIS MI",7,1,0,1,0,1,-85.41933441,41.7995491
227,"SUFFOLK VA",7,9,0,2,7,9,-76.58317566,36.72846985
227,"SUGAR HILL GA",7,5,3,1,1,5,-84.03327179,34.10667801
227,"SUGAR LAND TX",7,12,4,4,4,12,-95.6352005,29.61997795
227,"SULLIGENT AL",7,2,2,0,0,2,-88.13464355,33.90181732
227,"SULPHUR LA",7,1,0,1,0,1,-93.37752533,30.23687744
227,"SUMMERFIELD NC",7,1,0,0,1,1,-79.9040451,36.20918274
227,"SUMMERVILLE SC",7,3,0,2,1,3,-80.17547607,33.01868439
227,"SUMMIT IL",7,1,1,0,0,1,-87.81018066,41.78816223
227,"SUMTER SC",7,1,0,0,1,1,-80.34135437,33.92088318
227,"SUN PRAIRIE WI",7,2,2,0,0,2,-89.21392059,43.18373108
227,"SUNBURY PA",7,1,1,0,0,1,-76.79363251,40.86275864
227,"SUNNYVALE CA",7,24,7,9,8,24,-122.0380707,37.36878967
227,"SUNRISE FL",7,4,1,0,3,4,-80.2282486,26.14059067
227,"SURF CITY NC",7,1,0,1,0,1,-77.54553986,34.42726898
227,"SUSSEX WI",7,1,0,0,1,1,-88.22231293,43.13374329
227,"SUWANEE GA",7,2,2,0,0,2,-84.0713501,34.05178452
227,"SWANSEA IL",7,2,0,2,0,2,-89.98918152,38.53406143
227,"SWARTHMORE PA",7,1,0,1,0,1,-75.34899139,39.90222549
227,"SWEENY TX",7,1,0,0,1,1,-95.69893646,29.03920364
227,"SWISSVALE PA",7,1,0,0,1,1,-79.88240814,40.42403793
227,"SYKESVILLE MD",7,2,1,0,1,2,-76.96707916,39.37390518
227,"SYLACAUGA AL",7,3,1,2,0,3,-86.25159454,33.17354202
227,"SYLVANIA OH",7,14,9,2,3,14,-83.71266174,41.71902466
227,"SYRACUSE NY",7,139,46,41,52,139,-76.14653015,43.04846191
227,"TACOMA WA",7,104,40,29,35,104,-122.4466705,47.25242233
227,"TAKOMA PARK MD",7,12,2,3,7,12,-77.00667572,38.97793198
227,"TALLADEGA AL",7,1,0,0,1,1,-86.10553741,33.43610001
227,"TALLAHASSEE FL",7,123,42,35,46,123,-84.27896881,30.44669914
227,"TALLAPOOSA GA",7,2,1,0,1,2,-85.2878418,33.74494553
227,"TALLULAH LA",7,2,0,1,1,2,-91.18704987,32.40855789
227,"TAMARAC FL",7,4,2,0,2,4,-80.22389984,26.19458199
227,"TAMPA FL",7,602,188,172,242,602,-82.4580307,27.94833755
227,"TAOS NM",7,34,13,9,12,34,-105.5769424,36.40658188
227,"TARPON SPRINGS FL",7,63,16,25,22,63,-82.75656128,28.14682198
227,"TAUNTON MA",7,1,0,0,1,1,-71.08903503,41.900177
227,"TAYLOR MI",7,1,0,1,0,1,-83.26967621,42.24112701
227,"TAYLOR MILL KY",7,1,0,1,0,1,-84.49630737,38.99780273
227,"TEANECK NJ",7,4,1,2,1,4,-74.01485443,40.89759064
227,"TECUMSEH MI",7,4,1,3,0,4,-83.94480133,42.00404358
227,"TEHAMA CA",7,1,0,1,0,1,-122.1255112,40.02666092
227,"TELL CITY IN",7,1,0,0,1,1,-86.76784515,37.95154953
227,"TEMECULA CA",7,6,3,1,2,6,-117.1428146,33.48790741
227,"TEMPE AZ",7,77,16,28,33,77,-111.9108276,33.41504288
227,"TEMPLE TX",7,8,1,5,2,8,-97.34354401,31.09850502
227,"TENAFLY NJ",7,2,1,1,0,2,-73.9623642,40.92551041
227,"TERRE HAUTE IN",7,9,3,3,3,9,-87.41414642,39.46681976
227,"TERRELL TX",7,1,0,0,1,1,-96.27573395,32.73627472
227,"TEWKSBURY MA",7,43,12,7,24,43,-71.23313904,42.61103439
227,"TEXARKANA AR",7,3,0,1,2,3,-94.03818512,33.44210052
227,"TEXARKANA TX",7,1,0,0,1,1,-94.04785156,33.42536545
227,"TEXAS CITY TX",7,2,1,0,1,2,-94.90317535,29.38432312
227,"THOMASVILLE GA",7,2,2,0,0,2,-83.97835541,30.8371582
227,"THORNTON CO",7,20,4,10,6,20,-104.9727631,39.86811829
227,"THOUSAND OAKS CA",7,4,1,1,2,4,-118.8398514,34.17078018
227,"THREE RIVERS MI",7,7,1,2,4,7,-85.63246918,41.94419861
227,"TIGARD OR",7,5,1,1,3,5,-122.7737198,45.4310112
227,"TILLAMOOK OR",7,3,0,0,3,3,-123.8468399,45.45576096
227,"TINLEY PARK IL",7,4,3,1,0,4,-87.78465271,41.57352448
227,"TIPP CITY OH",7,2,2,0,0,2,-84.17195892,39.95846939
227,"TOLEDO OH",7,87,26,25,36,87,-83.55497742,41.66411591
227,"TOLLESON AZ",7,1,0,0,1,1,-112.2612381,33.45026016
227,"TOMBALL TX",7,13,4,5,4,13,-95.6162262,30.09776115
227,"TOMBSTONE AZ",7,2,1,1,0,2,-110.0689316,31.71310997
227,"TOMS RIVER NJ",7,2,1,1,0,2,-74.19700623,39.95401382
227,"TONAWANDA NY",7,1,0,0,1,1,-78.88004303,43.02050018
227,"TONKAWA OK",7,3,1,2,0,3,-97.3106308,36.67843628
227,"TOOELE UT",7,2,0,0,2,2,-112.3005066,40.53457642
227,"TOPEKA KS",7,71,18,16,37,71,-95.67857361,39.04813766
227,"TORONTO KS",7,8,2,1,5,8,-95.94944,37.79908752
227,"TORONTO OH",7,1,0,0,1,1,-80.60319519,40.46689606
227,"TORRANCE CA",7,25,2,11,12,25,-118.3428345,33.8359642
227,"TORRINGTON CT",7,3,1,0,2,3,-73.12056732,41.80105209
227,"TORRINGTON WY",7,1,1,0,0,1,-104.1826859,42.06502533
227,"TRACY CA",7,3,1,1,1,3,-121.427269,37.73949814
227,"TRAVERSE CITY MI",7,6,2,2,2,6,-85.6207962,44.76324844
227,"TREASURE ISLAND FL",7,1,0,0,1,1,-82.76873779,27.76968193
227,"TREMONTON UT",7,1,0,0,1,1,-112.1671677,41.71178055
227,"TRENTON FL",7,6,1,2,3,6,-82.81704712,29.61356735
227,"TRENTON IL",7,1,0,1,0,1,-89.68222809,38.60559845
227,"TRENTON NJ",7,6,2,1,3,6,-74.74206543,40.21709442
227,"TRINIDAD CO",7,1,0,0,1,1,-104.5080338,37.17304611
227,"TRIPOLI IA",7,1,0,0,1,1,-92.25856781,42.80789948
227,"TROY AL",7,1,0,0,1,1,-85.97013855,31.80913544
227,"TROY MI",7,5,1,0,4,5,-83.14983368,42.60589218
227,"TROY MO",7,11,3,4,4,11,-90.98098755,38.979702
227,"TROY NY",7,6,1,3,2,6,-73.69088745,42.72839737
227,"TROY OH",7,54,19,15,20,54,-84.20330811,40.03966141
227,"TRUSSVILLE AL",7,1,0,0,1,1,-86.61297607,33.62001419
227,"TRUTH OR CONSEQUENCES NM",7,1,0,0,1,1,-107.2433853,33.13360596
227,"TRYON NC",7,2,1,1,0,2,-82.23826599,35.20822144
227,"TUCKAHOE NY",7,2,1,1,0,2,-73.82630157,40.95046616
227,"TUCKER GA",7,1,0,1,0,1,-84.21690369,33.85486603
227,"TUCSON AZ",7,177,61,39,77,177,-110.9277954,32.22209167
227,"TULARE CA",7,2,0,1,1,2,-119.3488922,36.20763016
227,"TULIA TX",7,1,0,1,0,1,-101.7592316,34.53606033
227,"TULSA OK",7,92,39,13,40,92,-95.98488617,36.1603241
227,"TUMWATER WA",7,6,1,4,1,6,-122.9116669,47.00710678
227,"TUPELO MS",7,10,3,3,4,10,-88.71934509,34.26508713
227,"TURLOCK CA",7,5,2,2,1,5,-120.8488617,37.49431229
227,"TUSCALOOSA AL",7,65,11,22,32,65,-87.56897736,33.21024704
227,"TUSCUMBIA AL",7,1,1,0,0,1,-87.70251465,34.73139191
227,"TUSKEGEE AL",7,2,1,0,1,2,-85.69181061,32.42424011
227,"TUSTIN CA",7,1,0,0,1,1,-117.8277283,33.74598312
227,"TUTTLE OK",7,1,0,0,1,1,-97.82015991,35.29173279
227,"TWENTYNINE PALMS CA",7,2,0,1,1,2,-116.055397,34.13557053
227,"TWIN FALLS ID",7,2,1,1,0,2,-114.4627686,42.56301498
227,"TYLER TX",7,22,10,6,6,22,-95.3013916,32.35176468
227,"UKIAH CA",7,2,1,0,1,2,-123.2104721,39.15015793
227,"UNION BRIDGE MD",7,1,1,0,0,1,-77.17628479,39.56907654
227,"UNION CITY CA",7,6,0,3,3,6,-122.0214462,37.59539032
227,"UNION CITY NJ",7,3,0,3,0,3,-74.02296448,40.77968979
227,"UNION CITY OH",7,1,1,0,0,1,-84.80506134,40.19968414
227,"UNION KY",7,1,0,1,0,1,-84.68045044,38.94612122
227,"UNION ME",7,2,1,0,1,2,-69.27328491,44.21183395
227,"UNION MO",7,3,1,1,1,3,-91.00618744,38.44558716
227,"UNION NJ",7,1,0,0,1,1,-74.26235199,40.69780731
227,"UNIONTOWN PA",7,2,0,1,1,2,-79.7276535,39.89894104
227,"UNIVERSITY CITY MO",7,66,17,16,33,66,-90.33391571,38.66000748
227,"UPLAND CA",7,5,3,2,0,5,-117.6498413,34.09745026
227,"UPPER ARLINGTON OH",7,2,2,0,0,2,-83.06159973,39.99918365
227,"UPPER DARBY PA",7,5,3,1,1,5,-75.27319336,39.92858124
227,"UPPER MARLBORO MD",7,7,4,3,0,7,-76.74905396,38.81620026
227,"URBANA IL",7,29,11,7,11,29,-88.20746613,40.11079025
227,"URBANDALE IA",7,3,1,1,1,3,-93.71256256,41.62665176
227,"UTICA MI",7,1,0,1,0,1,-83.03349304,42.62604141
227,"UTICA NY",7,1,0,0,1,1,-75.23220062,43.10119629
227,"UVALDE TX",7,1,0,0,1,1,-99.78696442,29.20999336
227,"VACAVILLE CA",7,9,3,3,3,9,-121.9900284,38.35633469
227,"VALDOSTA GA",7,39,10,13,16,39,-83.27806854,30.83293533
227,"VALLEJO CA",7,23,6,4,13,23,-122.2594299,38.1039505
227,"VALLEY AL",7,1,1,0,0,1,-85.17531586,32.81519318
227,"VALLEY STREAM NY",7,1,1,0,0,1,-73.70756531,40.66439819
227,"VALPARAISO IN",7,3,2,1,0,3,-87.05838013,41.46813583
227,"VAN WERT OH",7,1,1,0,0,1,-84.58428955,40.86948395
227,"VANCOUVER WA",7,53,23,12,18,53,-122.6816559,45.63534164
227,"VANDALIA OH",7,1,0,0,1,1,-84.19855499,39.89054871
227,"VARNADO LA",7,1,0,1,0,1,-89.82972717,30.89409256
227,"VARNVILLE SC",7,1,1,0,0,1,-81.07863617,32.85089874
227,"VENICE FL",7,2,0,2,0,2,-82.45388031,27.10065269
227,"VERMILLION SD",7,4,2,1,1,4,-96.92948914,42.77981949
227,"VERNON TX",7,1,0,0,1,1,-99.26555634,34.15447235
227,"VERO BEACH FL",7,4,2,0,2,4,-80.39705658,27.63908195
227,"VERONA WI",7,1,1,0,0,1,-89.53356171,42.99075699
227,"VERSAILLES KY",7,2,2,0,0,2,-84.73013306,38.05267715
227,"VIAN OK",7,2,0,2,0,2,-94.9708252,35.498703
227,"VICKSBURG MS",7,3,0,1,2,3,-90.87818909,32.35280991
227,"VICTORIA TX",7,7,3,3,1,7,-97.00409698,28.80560303
227,"VICTORVILLE CA",7,4,1,0,3,4,-117.2928162,34.53612137
227,"VIENNA VA",7,26,11,7,8,26,-77.2645874,38.90164566
227,"VIENNA WV",7,2,1,1,0,2,-81.54671478,39.33840179
227,"VILLA RICA GA",7,2,1,0,1,2,-84.91907501,33.73210907
227,"VINE GROVE KY",7,4,2,1,1,4,-85.98104858,37.81027222
227,"VINELAND NJ",7,4,1,1,2,4,-75.02515411,39.48631668
227,"VIRGINIA BEACH VA",7,252,80,80,92,252,-75.97751617,36.8533783
227,"VISALIA CA",7,5,1,0,4,5,-119.2938156,36.33000946
227,"VISTA CA",7,7,1,3,3,7,-117.2447052,33.2000885
227,"VOLO IL",7,1,0,1,0,1,-88.16824341,42.32604218
227,"WACO TX",7,19,4,10,5,19,-97.14704895,31.54987144
227,"WAHPETON ND",7,1,0,1,0,1,-96.6032486,46.26345062
227,"WAITE PARK MN",7,7,3,1,3,7,-94.224823,45.55731201
227,"WAKE FOREST NC",7,10,3,1,6,10,-78.50919342,35.98039246
227,"WAKEFIELD MA",7,5,3,1,1,5,-71.07489014,42.51018906
227,"WALDOBORO ME",7,4,1,2,1,4,-69.37466431,44.09539795
227,"WALDWICK NJ",7,1,0,1,0,1,-74.11700439,41.01090622
227,"WALLA WALLA WA",7,6,1,3,2,6,-118.3452072,46.06405258
227,"WALLER TX",7,1,0,0,1,1,-95.92726135,30.05709457
227,"WALNUT CREEK CA",7,4,1,0,3,4,-122.0670624,37.90636826
227,"WALPOLE MA",7,14,2,1,11,14,-71.2485199,42.14173889
227,"WALTERBORO SC",7,1,0,0,1,1,-80.66620636,32.90554047
227,"WALTHAM MA",7,5,3,1,1,5,-71.2346344,42.37656403
227,"WARMINSTER PA",7,2,1,0,1,2,-75.09890747,40.20700836
227,"WARNER ROBINS GA",7,11,2,2,7,11,-83.59963989,32.62118149
227,"WARREN MI",7,90,34,18,38,90,-83.02783203,42.47764969
227,"WARREN OH",7,3,1,1,1,3,-80.81771851,41.23757935
227,"WARRENSBURG MO",7,9,3,2,4,9,-93.73639679,38.76289749
227,"WARRENTON MO",7,29,12,6,11,29,-91.14160919,38.81156921
227,"WARRENTON VA",7,10,6,1,3,10,-77.79475403,38.71380615
227,"WARSAW IN",7,2,2,0,0,2,-85.85310364,41.23810196
227,"WARSAW NC",7,5,3,0,2,5,-78.09035492,34.99985886
227,"WARSAW NY",7,1,0,1,0,1,-78.13197327,42.74021912
227,"WARWICK NY",7,1,0,0,1,1,-74.35926819,41.25672531
227,"WARWICK RI",7,2,1,0,1,2,-71.37738037,41.69232941
227,"WASCO CA",7,1,0,0,1,1,-119.3427811,35.59425735
227,"WASHINGTON DC",7,5879,1855,1520,2504,5879,-77.01257324,38.88911819
227,"WASHINGTON MO",7,43,22,8,13,43,-91.01213074,38.55807495
227,"WASHINGTON NC",7,1,1,0,0,1,-77.05869293,35.54986954
227,"WASHINGTON PA",7,2,0,1,1,2,-80.24552155,40.17398453
227,"WASHINGTON UT",7,1,1,0,0,1,-113.5095291,37.13038635
227,"WASHOUGAL WA",7,2,0,1,1,2,-122.3545303,45.58441925
227,"WASILLA AK",7,7,1,3,3,7,-149.4517059,61.58290482
227,"WATERBURY CT",7,5,3,1,1,5,-73.05029297,41.55849075
227,"WATERLOO IA",7,12,1,3,8,12,-92.34320831,42.49277496
227,"WATERLOO IL",7,1,0,0,1,1,-90.14981842,38.3361702
227,"WATERTOWN NY",7,2,1,1,0,2,-75.9100647,43.97471619
227,"WATERTOWN WI",7,4,0,1,3,4,-88.72946167,43.19454193
227,"WATERVILLE ME",7,10,6,2,2,10,-69.63098145,44.55205154
227,"WATKINSVILLE GA",7,2,1,1,0,2,-83.40834808,33.86332703
227,"WATSONVILLE CA",7,2,1,0,1,2,-121.7594147,36.90995407
227,"WAUCONDA IL",7,1,0,1,0,1,-88.13915253,42.25894928
227,"WAUKEGAN IL",7,4,3,0,1,4,-87.84466553,42.36366653
227,"WAUKESHA WI",7,21,7,3,11,21,-88.23146057,43.01194382
227,"WAUNAKEE WI",7,1,1,0,0,1,-89.45576477,43.19177246
227,"WAUSAU WI",7,6,1,2,3,6,-89.63059998,44.95904922
227,"WAUWATOSA WI",7,5,1,1,3,5,-88.00754547,43.04960632
227,"WAVELAND IN",7,2,2,0,0,2,-87.04476166,39.87699127
227,"WAVERLY IA",7,1,1,0,0,1,-92.47597504,42.7256813
227,"WAVERLY KS",7,2,1,0,1,2,-95.603302,38.39393997
227,"WAVERLY NE",7,1,0,1,0,1,-96.52924347,40.9175148
227,"WAVERLY TN",7,1,0,1,0,1,-87.79498291,36.08420944
227,"WAXHAW NC",7,6,2,1,3,6,-80.74282074,34.92486572
227,"WAYLAND MA",7,2,1,0,1,2,-71.36071777,42.36267471
227,"WAYNESBORO VA",7,1,0,0,1,1,-78.88896179,38.06871414
227,"WAYNESVILLE NC",7,1,1,0,0,1,-82.98840332,35.48899078
227,"WEAVERVILLE NC",7,1,1,0,0,1,-82.56031799,35.6974411
227,"WEBSTER CITY IA",7,1,0,1,0,1,-93.81646729,42.46933365
227,"WEBSTER GROVES MO",7,3,1,1,1,3,-90.35769653,38.59287262
227,"WEBSTER TX",7,2,1,1,0,2,-95.11889648,29.53835869
227,"WEED CA",7,50,15,21,14,50,-122.388382,41.42225266
227,"WELLESLEY MA",7,1,1,0,0,1,-71.29138947,42.29670715
227,"WELLSTON OH",7,1,0,0,1,1,-82.53286743,39.12374496
227,"WENATCHEE WA",7,1,0,1,0,1,-120.3128357,47.42322159
227,"WENTZVILLE MO",7,6,1,2,3,6,-90.85335541,38.81171036
227,"WESLACO TX",7,5,1,2,2,5,-97.99131775,26.16018867
227,"WEST CALDWELL NJ",7,2,1,1,0,2,-74.30077362,40.84119797
227,"WEST CHESTER OH",7,6,3,2,1,6,-84.40789032,39.33029938
227,"WEST CHESTER PA",7,11,4,4,3,11,-75.60475159,39.96074677
227,"WEST CHICAGO IL",7,2,1,1,0,2,-88.20433807,41.88489914
227,"WEST COVINA CA",7,7,0,4,3,7,-117.9406204,34.0685463
227,"WEST DES MOINES IA",7,2,1,0,1,2,-93.71179962,41.57717514
227,"WEST FARGO ND",7,10,3,4,3,10,-96.90450287,46.87138367
227,"WEST HARTFORD CT",7,7,5,1,1,7,-72.74108887,41.76238251
227,"WEST HAVEN CT",7,2,1,1,0,2,-72.94598389,41.27069473
227,"WEST HOLLYWOOD CA",7,45,8,16,21,45,-118.3634567,34.08982468
227,"WEST JORDAN UT",7,4,0,2,2,4,-111.9405594,40.60975647
227,"WEST LAFAYETTE IN",7,14,4,1,9,14,-86.9082489,40.42613983
227,"WEST MEMPHIS AR",7,1,1,0,0,1,-90.18457031,35.14645004
227,"WEST ORANGE NJ",7,12,6,2,4,12,-74.23833466,40.7989006
227,"WEST PALM BEACH FL",7,119,37,37,45,119,-80.05298615,26.71585464
227,"WEST PLAINS MO",7,6,2,1,3,6,-91.85284424,36.72810745
227,"WEST RICHLAND WA",7,6,3,1,2,6,-119.3632965,46.30400085
227,"WEST SENECA NY",7,1,1,0,0,1,-78.79914856,42.85012436
227,"WEST TX",7,5,2,0,3,5,-97.09226227,31.80267906
227,"WEST VALLEY CITY UT",7,2,0,0,2,2,-111.9695816,40.69639969
227,"WEST WARWICK RI",7,2,1,1,0,2,-71.5218811,41.70644379
227,"WEST YELLOWSTONE MT",7,1,1,0,0,1,-111.1018829,44.66385651
227,"WESTBOROUGH MA",7,4,2,0,2,4,-71.61507416,42.26956177
227,"WESTBROOK ME",7,2,0,1,1,2,-70.37012482,43.67708588
227,"WESTBURY NY",7,3,0,3,0,3,-73.58692932,40.75608444
227,"WESTCLIFFE CO",7,2,0,0,2,2,-105.4663086,38.13474274
227,"WESTERLY RI",7,2,2,0,0,2,-71.82659149,41.37784958
227,"WESTERVILLE OH",7,14,5,3,6,14,-82.92906952,40.12620926
227,"WESTFIELD IN",7,12,5,6,1,12,-86.12757111,40.04309464
227,"WESTFIELD MA",7,4,1,1,2,4,-72.74882507,42.12547302
227,"WESTFIELD NJ",7,5,0,2,3,5,-74.34671783,40.65938187
227,"WESTFORD MA",7,2,0,0,2,2,-71.43686676,42.57947159
227,"WESTLAND MI",7,4,3,0,1,4,-83.39988708,42.32430649
227,"WESTMINSTER CA",7,1,0,0,1,1,-118.0086441,33.7593689
227,"WESTMINSTER CO",7,5,0,4,1,5,-105.0385208,39.83644867
227,"WESTMINSTER MD",7,4,2,1,1,4,-76.99542999,39.57574463
227,"WESTMONT IL",7,1,0,0,1,1,-87.97566223,41.79613113
227,"WESTON MA",7,1,1,0,0,1,-71.30235291,42.36714172
227,"WESTPORT CT",7,4,2,1,1,4,-73.35696411,41.14154053
227,"WESTPORT NY",7,1,1,0,0,1,-73.43728638,44.18396759
227,"WESTWOOD MA",7,1,1,0,0,1,-71.22348022,42.21436691
227,"WESTWOOD NJ",7,1,1,0,0,1,-74.03186798,40.9915657
227,"WETUMPKA AL",7,2,0,1,1,2,-86.21166229,32.54381561
227,"WHEAT RIDGE CO",7,2,1,0,1,2,-105.0783615,39.76603317
227,"WHEATON IL",7,8,2,1,5,8,-88.10729218,41.86618805
227,"WHEELING IL",7,3,1,1,1,3,-87.92919159,42.13937759
227,"WHEELING WV",7,7,3,2,2,7,-80.7192688,40.06991577
227,"WHITE BEAR LAKE MN",7,1,0,1,0,1,-93.01039886,45.08457947
227,"WHITE PLAINS NY",7,13,4,5,4,13,-73.76217651,41.03399658
227,"WHITEFISH MT",7,7,4,3,0,7,-114.3380127,48.41337967
227,"WHITEHALL PA",7,2,1,0,1,2,-79.99015045,40.36117554
227,"WHITESBURG KY",7,3,1,1,1,3,-82.82665253,37.11859894
227,"WHITEVILLE NC",7,2,1,0,1,2,-78.70272064,34.3391037
227,"WHITEWATER WI",7,5,0,4,1,5,-88.73226166,42.83348846
227,"WHITING IN",7,1,0,0,1,1,-87.49537659,41.68428421
227,"WHITTIER CA",7,13,2,3,8,13,-118.0349197,33.9793129
227,"WICHITA FALLS TX",7,13,3,5,5,13,-98.49403381,33.91383743
227,"WICHITA KS",7,86,21,23,42,86,-97.3383255,37.69230652
227,"WILKES-BARRE PA",7,5,5,0,0,5,-75.88058472,41.24601746
227,"WILKINSBURG PA",7,13,2,7,4,13,-79.88179016,40.44174194
227,"WILLACOOCHEE GA",7,1,1,0,0,1,-83.04568481,31.34116745
227,"WILLIAMS CA",7,1,0,0,1,1,-122.151535,39.15454483
227,"WILLIAMSBURG VA",7,21,5,9,7,21,-76.70659637,37.27114868
227,"WILLIAMSPORT PA",7,9,0,6,3,9,-77.00060272,41.24121475
227,"WILLIAMSTOWN KY",7,3,0,1,2,3,-84.56015778,38.63843536
227,"WILLINGBORO NJ",7,5,0,2,3,5,-74.86815643,40.02816391
227,"WILLIS TX",7,3,3,0,0,3,-95.48044586,30.42520714
227,"WILLMAR MN",7,1,0,0,1,1,-95.04427338,45.12181473
227,"WILLOUGHBY OH",7,2,2,0,0,2,-81.40597534,41.63972092
227,"WILMETTE IL",7,2,0,0,2,2,-87.72296143,42.07221222
227,"WILMINGTON DE",7,17,2,7,8,17,-75.54558563,39.74601364
227,"WILMINGTON IL",7,2,0,0,2,2,-88.14704132,41.30776596
227,"WILMINGTON NC",7,46,15,10,21,46,-77.94431305,34.22592926
227,"WILMINGTON OH",7,3,1,1,1,3,-83.82820892,39.44527435
227,"WILSON NC",7,3,1,1,1,3,-77.914711,35.72143173
227,"WILSONVILLE OR",7,1,0,0,1,1,-122.7757416,45.29935455
227,"WILTON CT",7,1,0,1,0,1,-73.43698883,41.19543076
227,"WILTON MANORS FL",7,1,0,0,1,1,-80.1386261,26.16088676
227,"WINCHESTER KY",7,7,1,4,2,7,-84.17945862,37.99042511
227,"WINCHESTER TN",7,1,1,0,0,1,-86.11190796,35.18607712
227,"WINCHESTER VA",7,6,1,2,3,6,-78.16301727,39.18608475
227,"WINDER GA",7,1,0,1,0,1,-83.71982574,33.99271393
227,"WINDERMERE FL",7,2,0,2,0,2,-81.53463745,28.49615097
227,"WINDSOR CO",7,2,0,2,0,2,-104.9023056,40.47741699
227,"WINDSOR IL",7,1,1,0,0,1,-88.59477234,39.4409256
227,"WINDSOR LOCKS CT",7,1,1,0,0,1,-72.626297,41.92962646
227,"WINDSOR MO",7,10,3,4,3,10,-93.5224762,38.53234863
227,"WINDSOR VT",7,3,0,1,2,3,-72.38378906,43.48069
227,"WINFIELD KS",7,1,0,0,1,1,-96.9961853,37.23976898
227,"WINFIELD MO",7,1,1,0,0,1,-90.73840332,38.99734879
227,"WINNETKA IL",7,3,0,0,3,3,-87.73626709,42.10827255
227,"WINNFIELD LA",7,1,0,1,0,1,-92.63972473,31.92557716
227,"WINOOSKI VT",7,1,0,0,1,1,-73.18509674,44.49157333
227,"WINSTON-SALEM NC",7,91,36,21,34,91,-80.24356842,36.1001091
227,"WINTER HAVEN FL",7,3,1,1,1,3,-81.73223114,28.02276421
227,"WINTER PARK CO",7,2,0,0,2,2,-105.7649307,39.89161301
227,"WINTER PARK FL",7,24,7,5,12,24,-81.33872223,28.6003685
227,"WINTERS CA",7,1,0,0,1,1,-121.9734039,38.52486038
227,"WIXOM MI",7,1,0,0,1,1,-83.53598785,42.52477264
227,"WOBURN MA",7,2,0,0,2,2,-71.15155029,42.47951508
227,"WOLFEBORO NH",7,1,0,0,1,1,-71.1996994,43.58374405
227,"WOODBRIDGE NJ",7,5,0,3,2,5,-74.28398895,40.55769348
227,"WOODBURN OR",7,5,2,0,3,5,-122.8577652,45.14351273
227,"WOODBURY MN",7,2,2,0,0,2,-92.95999908,44.92368698
227,"WOODBURY NJ",7,6,0,3,3,6,-75.15171051,39.83841705
227,"WOODBURY NY",7,1,0,1,0,1,-73.46657562,40.82590485
227,"WOODINVILLE WA",7,1,0,0,1,1,-122.1656876,47.75372314
227,"WOODLAND CA",7,3,0,1,2,3,-121.7751541,38.67827225
227,"WOODLAND PARK CO",7,1,0,0,1,1,-105.0628204,38.98442078
227,"WOODRIDGE IL",7,1,1,0,0,1,-88.05056763,41.74704742
227,"WOODSIDE CA",7,2,1,0,1,2,-122.2564316,37.42977905
227,"WOODSTOCK GA",7,3,1,2,0,3,-84.51925659,34.10178375
227,"WOODSTOCK IL",7,2,1,0,1,2,-88.4488678,42.31498718
227,"WOOSTER OH",7,7,0,3,4,7,-81.93497467,40.80502319
227,"WORCESTER MA",7,43,13,15,15,43,-71.801651,42.26288986
227,"WORTHINGTON OH",7,2,1,0,1,2,-83.01785278,40.09322739
227,"WRIGHT CITY MO",7,1,0,0,1,1,-91.02021027,38.82786942
227,"WYANDOTTE MI",7,1,0,0,1,1,-83.15003204,42.21445465
227,"WYLIE TX",7,3,0,1,2,3,-96.5396347,33.01520157
227,"WYNNE AR",7,1,0,0,1,1,-90.7868042,35.22455978
227,"WYOMING MI",7,13,7,2,4,13,-85.70549011,42.9133873
227,"YAKIMA WA",7,10,5,1,4,10,-120.508812,46.60157394
227,"YARDLEY PA",7,1,0,0,1,1,-74.8451004,40.2459259
227,"YELLOW SPRINGS OH",7,2,1,1,0,2,-83.88698578,39.80642319
227,"YONKERS NY",7,20,8,3,9,20,-73.89792633,40.93142319
227,"YORBA LINDA CA",7,1,0,1,0,1,-117.8147278,33.88856888
227,"YORK PA",7,16,7,3,6,16,-76.72687531,39.96264267
227,"YOUNGSTOWN OH",7,181,48,34,99,181,-80.64901733,41.1000061
227,"YOUNGSVILLE NC",7,3,3,0,0,3,-78.47360992,36.02531433
227,"YOUNTVILLE CA",7,2,0,1,1,2,-122.3634491,38.40127182
227,"YPSILANTI MI",7,18,5,8,5,18,-83.61315155,42.24105453
227,"YREKA CA",7,2,0,0,2,2,-122.6363983,41.73524094
227,"YUBA CITY CA",7,1,1,0,0,1,-121.6193237,39.14025497
227,"YUCAIPA CA",7,1,0,0,1,1,-117.0447998,34.03347397
227,"YUMA AZ",7,4,3,0,1,4,-114.6262665,32.72531128
227,"ZACHARY LA",7,1,1,0,0,1,-91.15661621,30.64884186
227,"ZANESVILLE OH",7,3,1,1,1,3,-82.01314545,39.94056702
227,"ZEBULON GA",7,1,0,1,0,1,-84.34278107,33.10243607
227,"ZEELAND MI",7,1,0,0,1,1,-86.01843262,42.812603
227,"ZIONSVILLE IN",7,1,1,0,0,1,-86.26182556,39.95092773
228,"ABILENE TX",8,5,2,2,1,5,-99.73384094,32.44894028
228,"ABINGTON PA",8,1,0,1,0,1,-75.11743164,40.12073898
228,"ABSECON NJ",8,15,4,2,9,15,-74.49462128,39.42850494
228,"ACCIDENT MD",8,1,0,1,0,1,-79.31906891,39.62875366
228,"ACTON MA",8,1,1,0,0,1,-71.43197632,42.48540115
228,"ACWORTH GA",8,4,1,1,2,4,-84.67662811,34.06597519
228,"ADA OK",8,1,0,0,1,1,-96.67899323,34.77481842
228,"ADAIRSVILLE GA",8,1,0,1,0,1,-84.93426514,34.36875153
228,"ADDISON TX",8,6,3,1,2,6,-96.82976532,32.96215057
228,"ADRIAN MI",8,2,1,1,0,2,-84.03691101,41.89771652
228,"ADRIAN MO",8,1,1,0,0,1,-94.35219574,38.39756775
228,"AIKEN SC",8,8,2,4,2,8,-81.71619415,33.55714417
228,"AKRON OH",8,59,16,17,26,59,-81.51885223,41.08151627
228,"AKRON PA",8,1,0,1,0,1,-76.20130157,40.15691757
228,"ALAMEDA CA",8,23,8,9,6,23,-122.2444763,37.76513672
228,"ALAMOGORDO NM",8,4,1,2,1,4,-105.9584656,32.90003967
228,"ALBANY CA",8,2,0,1,1,2,-122.3003311,37.88674164
228,"ALBANY GA",8,1,0,1,0,1,-84.15510559,31.58296013
228,"ALBANY NY",8,32,9,8,15,32,-73.75520325,42.6529007
228,"ALBANY OR",8,1,0,0,1,1,-123.1083984,44.63620758
228,"ALBUQUERQUE NM",8,233,71,69,93,233,-106.6517639,35.08336639
228,"ALCOA TN",8,5,0,3,2,5,-83.96761322,35.77825165
228,"ALEXANDRIA LA",8,5,1,3,1,5,-92.44517517,31.31143761
228,"ALEXANDRIA MN",8,1,1,0,0,1,-95.37786865,45.88516617
228,"ALEXANDRIA VA",8,54,18,12,24,54,-77.04605103,38.80503082
228,"ALFRED NY",8,1,0,0,1,1,-77.78995514,42.25440979
228,"ALICE TX",8,6,2,1,3,6,-98.07035828,27.7528286
228,"ALLEN PARK MI",8,2,1,0,1,2,-83.21057892,42.25782394
228,"ALLEN TX",8,4,1,2,1,4,-96.67116547,33.10336685
228,"ALLENDALE SC",8,1,0,1,0,1,-81.3080368,33.00844955
228,"ALLENTOWN PA",8,7,2,1,4,7,-75.46569824,40.60851288
228,"ALPENA MI",8,1,0,0,1,1,-83.43292999,45.06164551
228,"ALTAMONTE SPRINGS FL",8,2,0,1,1,2,-81.39485931,28.66284752
228,"ALTON IL",8,14,5,4,5,14,-90.18429565,38.89074326
228,"ALTOONA PA",8,2,2,0,0,2,-78.39411163,40.51860046
228,"ALVA OK",8,1,0,0,1,1,-98.66719055,36.80501556
228,"AMARILLO TX",8,27,6,11,10,27,-101.8324051,35.22210312
228,"AMERICAN FORK UT",8,1,1,0,0,1,-111.8032379,40.34251022
228,"AMERICUS GA",8,1,0,0,1,1,-84.23246002,32.07291031
228,"AMES IA",8,23,6,2,15,23,-93.61370087,42.02269363
228,"AMHERST MA",8,2,0,1,1,2,-72.5192337,42.37371826
228,"AMHERST OH",8,1,0,1,0,1,-82.22229767,41.39805603
228,"ANACORTES WA",8,1,1,0,0,1,-122.6148834,48.51247025
228,"ANAHEIM CA",8,5,2,1,2,5,-117.9165115,33.8354454
228,"ANCHORAGE AK",8,25,9,6,10,25,-149.8811951,61.21649933
228,"ANDERSON IN",8,12,4,3,5,12,-85.68051147,40.1053772
228,"ANDERSON SC",8,5,2,0,3,5,-82.65641785,34.50934219
228,"ANDOVER MA",8,1,0,1,0,1,-71.13011169,42.65668869
228,"ANKENY IA",8,1,1,0,0,1,-93.60646057,41.72983551
228,"ANN ARBOR MI",8,131,41,27,63,131,-83.74536896,42.28347015
228,"ANNAPOLIS MD",8,17,5,7,5,17,-76.49166107,38.97844696
228,"ANNISTON AL",8,5,3,1,1,5,-85.8313446,33.65997314
228,"ANSONIA CT",8,1,0,0,1,1,-73.0779953,41.34640884
228,"ANTIOCH CA",8,20,3,11,6,20,-121.808136,38.0049057
228,"APACHE JUNCTION AZ",8,1,1,0,0,1,-111.5511551,33.41511536
228,"APEX NC",8,5,1,2,2,5,-78.84952545,35.73279572
228,"APPLETON WI",8,7,1,3,3,7,-88.41551208,44.2618866
228,"ARCATA CA",8,2,2,0,0,2,-124.08564,40.86624527
228,"ARDEN HILLS MN",8,1,0,0,1,1,-93.15720367,45.05033112
228,"ARLINGTON HEIGHTS IL",8,5,1,3,1,5,-87.98104858,42.08821106
228,"ARLINGTON MA",8,2,1,0,1,2,-71.15559387,42.41545486
228,"ARLINGTON TN",8,3,0,2,1,3,-89.66139984,35.29637527
228,"ARLINGTON TX",8,68,24,17,27,68,-97.10882568,32.73590469
228,"ARNOLD MO",8,1,0,1,0,1,-90.37690735,38.43906784
228,"ARROYO GRANDE CA",8,2,0,1,1,2,-120.5928879,35.11868668
228,"ARVADA CO",8,1,0,0,1,1,-105.0886612,39.8028183
228,"ASBURY PARK NJ",8,2,0,1,1,2,-74.01100159,40.22047806
228,"ASHEVILLE NC",8,35,13,9,13,35,-82.55367279,35.60134888
228,"ASHLAND KY",8,1,0,1,0,1,-82.63764954,38.47874069
228,"ASHLAND MA",8,1,0,1,0,1,-71.46256256,42.26143265
228,"ASHLAND MO",8,1,1,0,0,1,-92.25737762,38.77433395
228,"ASHLAND OH",8,3,1,0,2,3,-82.31797028,40.86874771
228,"ASHLAND OR",8,11,4,2,5,11,-122.7111359,42.19425583
228,"ASHLAND VA",8,11,4,1,6,11,-77.47959137,37.75937653
228,"ASHTABULA OH",8,1,0,1,0,1,-80.78971863,41.86506653
228,"ASPEN CO",8,2,0,1,1,2,-106.8185959,39.19105911
228,"ASPERMONT TX",8,1,1,0,0,1,-100.2279816,33.13380051
228,"ASTORIA OR",8,2,0,0,2,2,-123.8339157,46.18756866
228,"ATHENS IL",8,1,0,1,0,1,-89.72410583,39.96085739
228,"ATHENS OH",8,1,0,0,1,1,-82.10113525,39.32934952
228,"ATHENS PA",8,4,0,1,3,4,-76.52072906,41.9661293
228,"ATHENS TN",8,1,0,0,1,1,-84.59921265,35.44878387
228,"ATLANTA GA",8,1868,587,474,807,1868,-84.38757324,33.74927521
228,"ATLANTIC BEACH FL",8,2,0,2,0,2,-81.39808655,30.33498573
228,"ATLANTIC CITY NJ",8,14,4,5,5,14,-74.42202759,39.36457062
228,"AUBREY TX",8,1,0,0,1,1,-96.98683167,33.30471039
228,"AUBURN AL",8,13,3,3,7,13,-85.48087311,32.61021423
228,"AUBURN CA",8,107,35,33,39,107,-121.0794067,38.89623642
228,"AUBURN ME",8,1,1,0,0,1,-70.23028564,44.09794235
228,"AUBURN NY",8,1,0,1,0,1,-76.56542969,42.93203735
228,"AUBURN WA",8,3,0,1,2,3,-122.2304688,47.30677795
228,"AUGUSTA ME",8,1,1,0,0,1,-69.7781601,44.31053925
228,"AURORA CO",8,19,5,5,9,19,-104.8693161,39.73983765
228,"AURORA IL",8,8,3,3,2,8,-88.32048798,41.76070023
228,"AUSTELL GA",8,9,6,1,2,9,-84.63414001,33.81290054
228,"AUSTIN MN",8,1,0,1,0,1,-92.97491455,43.6665535
228,"AUSTIN TX",8,787,255,209,323,787,-97.74386597,30.26748466
228,"AUSTINTOWN OH",8,5,1,1,3,5,-80.76424408,41.10162354
228,"AVA MO",8,1,0,0,1,1,-92.6605835,36.95189667
228,"AVONDALE AZ",8,2,0,1,1,2,-112.3513947,33.43592072
228,"AZUSA CA",8,1,0,0,1,1,-117.9098816,34.13357544
228,"BAINBRIDGE GA",8,1,1,0,0,1,-84.57505798,30.90430069
228,"BAKERSFIELD CA",8,27,7,10,10,27,-119.0206375,35.37326813
228,"BALDWIN CITY KS",8,3,0,2,1,3,-95.18656921,38.77522659
228,"BALDWIN PARK CA",8,2,0,1,1,2,-117.9624786,34.08519363
228,"BALDWYN MS",8,2,0,2,0,2,-88.63553619,34.5099411
228,"BALLSTON SPA NY",8,2,0,1,1,2,-73.84790039,43.00103378
228,"BALLWIN MO",8,20,6,5,9,20,-90.54669189,38.5951004
228,"BALTIMORE MD",8,462,140,121,201,462,-76.6115799,39.29075623
228,"BANGOR ME",8,8,1,6,1,8,-68.77653503,44.80109406
228,"BAR HARBOR ME",8,4,3,0,1,4,-68.20309448,44.38752747
228,"BARDSTOWN KY",8,4,0,1,1,2,-85.46318817,37.810512545
228,"BARNESVILLE GA",8,2,1,0,1,2,-84.15583038,33.05487442
228,"BARNWELL SC",8,2,1,0,1,2,-81.35834503,33.24495316
228,"BARTLETT TN",8,4,3,1,0,4,-89.87441254,35.20460892
228,"BARTONVILLE IL",8,17,8,4,5,17,-89.65235138,40.6502037
228,"BARTOW FL",8,1,0,0,1,1,-81.84252167,27.89712715
228,"BASTROP TX",8,1,0,0,1,1,-97.31572723,30.11092758
228,"BATAVIA IA",8,3,2,1,0,3,-92.16798401,40.99414825
228,"BATAVIA NY",8,4,1,1,2,4,-78.18697357,42.99835587
228,"BATON ROUGE LA",8,121,44,34,43,121,-91.15479279,30.45132256
228,"BAXTER SPRINGS KS",8,4,2,1,1,4,-94.73813629,37.02472305
228,"BAY CITY MI",8,8,0,1,7,8,-83.8886261,43.59466171
228,"BAY VILLAGE OH",8,1,1,0,0,1,-81.92155457,41.48464966
228,"BAYONNE NJ",8,1,1,0,0,1,-74.10975647,40.66794968
228,"BAYTOWN TX",8,10,4,2,4,10,-94.97782135,29.73608589
228,"BEAR LAKE MI",8,3,2,0,1,3,-86.14846802,44.42086029
228,"BEAUFORT SC",8,1,0,1,0,1,-80.68718719,32.44019699
228,"BEAUMONT TX",8,7,3,2,2,7,-94.10238647,30.08622551
228,"BEAVERCREEK OH",8,1,0,1,0,1,-84.06332397,39.70913696
228,"BEAVERTON OR",8,13,7,4,2,13,-122.8055344,45.48670197
228,"BECKLEY WV",8,2,2,0,0,2,-81.18963623,37.77680588
228,"BEDFORD IN",8,9,1,4,4,9,-86.48697662,38.86146164
228,"BEDFORD MA",8,1,0,0,1,1,-71.27526855,42.49069214
228,"BEDFORD NY",8,2,0,1,1,2,-73.64318085,41.204319
228,"BEDFORD OH",8,1,0,0,1,1,-81.53594208,41.39339828
228,"BEDFORD PA",8,1,0,0,1,1,-78.50319672,40.01898575
228,"BEDFORD TX",8,3,1,1,1,3,-97.14364624,32.8442955
228,"BEL AIR MD",8,2,2,0,0,2,-76.34788513,39.53611374
228,"BELLEAIR BEACH FL",8,2,0,2,0,2,-82.84260559,27.9237709
228,"BELLEFONTAINE OH",8,1,0,1,0,1,-83.75959015,40.36141205
228,"BELLEVILLE IL",8,30,14,7,9,30,-89.98438263,38.52002716
228,"BELLEVILLE MI",8,1,1,0,0,1,-83.48514557,42.20495987
228,"BELLEVUE NE",8,2,1,0,1,2,-95.89156342,41.13648224
228,"BELLEVUE OH",8,1,0,1,0,1,-82.84135437,41.27357483
228,"BELLEVUE WA",8,6,4,1,1,6,-122.2029648,47.61014557
228,"BELLFLOWER CA",8,1,0,0,1,1,-118.1186295,33.88169479
228,"BELLINGHAM WA",8,18,6,5,7,18,-122.4727402,48.76121521
228,"BELLPORT NY",8,1,0,0,1,1,-72.93808746,40.75737
228,"BELMONT CA",8,5,1,0,4,5,-122.2783508,37.51996613
228,"BELTON TX",8,3,1,1,1,3,-97.46511841,31.05611229
228,"BEMIDJI MN",8,4,0,0,4,4,-94.88105774,47.47352982
228,"BEND OR",8,23,7,5,11,23,-121.3171387,44.0577774
228,"BENNETTSVILLE SC",8,1,0,0,1,1,-79.68428802,34.61242676
228,"BENSENVILLE IL",8,1,0,1,0,1,-87.94012451,41.95510483
228,"BENTONVILLE AR",8,7,2,1,4,7,-94.20933533,36.3728447
228,"BEREA OH",8,5,1,3,1,5,-81.85396576,41.36633301
228,"BERGENFIELD NJ",8,1,0,1,0,1,-73.99640656,40.92791748
228,"BERKELEY CA",8,183,48,56,79,183,-122.2752533,37.87145615
228,"BERKELEY HEIGHTS NJ",8,1,0,1,0,1,-74.44181824,40.68349838
228,"BERKELEY MO",8,1,0,0,1,1,-90.33169556,38.75470734
228,"BERKLEY MI",8,1,0,1,0,1,-83.18341827,42.50307083
228,"BERRIEN SPRINGS MI",8,1,0,1,0,1,-86.33900452,41.94654846
228,"BESSEMER AL",8,3,2,0,1,3,-86.95465851,33.40222549
228,"BETHALTO IL",8,1,0,1,0,1,-90.04077911,38.90911865
228,"BETHEL OH",8,1,0,0,1,1,-84.08042908,38.96363068
228,"BETHLEHEM PA",8,2,1,0,1,2,-75.36949921,40.62598801
228,"BEVERLY HILLS CA",8,12,5,2,5,12,-118.4019775,34.07383347
228,"BEXLEY OH",8,1,0,0,1,1,-82.93772888,39.96929932
228,"BIG SANDY TX",8,1,0,0,1,1,-95.10948181,32.58401871
228,"BIG SPRING TX",8,14,3,6,5,14,-101.4811173,32.25181198
228,"BIG STONE GAP VA",8,3,0,3,0,3,-82.74668884,36.88179398
228,"BILLINGS MT",8,1,1,0,0,1,-108.504631,45.7833786
228,"BILOXI MS",8,9,0,4,5,9,-88.89369202,30.40021133
228,"BINGHAMTON NY",8,11,1,7,3,11,-75.91755676,42.0986557
228,"BIRMINGHAM AL",8,101,34,22,45,101,-86.80226898,33.52098846
228,"BIRMINGHAM MI",8,12,3,4,5,12,-83.21121216,42.54697418
228,"BISBEE AZ",8,26,8,11,7,26,-109.9298477,31.44821548
228,"BISMARCK ND",8,5,1,2,2,5,-100.7789612,46.80673981
228,"BIXBY OK",8,2,1,0,1,2,-95.88382721,35.94215775
228,"BLACK MOUNTAIN NC",8,1,0,0,1,1,-82.32103729,35.61796188
228,"BLACKFOOT ID",8,2,0,0,2,2,-112.3463059,43.1905098
228,"BLACKSBURG VA",8,13,2,4,7,13,-80.41369629,37.22999573
228,"BLAINE WA",8,1,0,1,0,1,-122.7500839,48.99335098
228,"BLAND MO",8,3,0,2,1,3,-91.63315582,38.30200195
228,"BLOOMFIELD HILLS MI",8,2,0,1,1,2,-83.24560547,42.58376312
228,"BLOOMFIELD NJ",8,1,0,1,0,1,-74.18488312,40.8069458
228,"BLOOMINGDALE IL",8,2,0,0,2,2,-88.08078766,41.95762634
228,"BLOOMINGTON IL",8,6,2,3,1,6,-88.99375916,40.48418045
228,"BLOOMINGTON IN",8,15,6,4,5,15,-86.53382874,39.16920471
228,"BLUE HILL ME",8,1,0,0,1,1,-68.588974,44.43393707
228,"BLUE SPRINGS MO",8,2,1,0,1,2,-94.2820816,39.01689148
228,"BLUEFIELD VA",8,1,0,0,1,1,-81.27105713,37.25265121
228,"BLUEFIELD WV",8,1,0,0,1,1,-81.21854401,37.27106094
228,"BLUFF CITY TN",8,1,0,0,1,1,-82.26051331,36.47451019
228,"BOARDMAN OH",8,1,0,0,1,1,-80.66256714,41.02441788
228,"BOCA RATON FL",8,29,6,12,11,29,-80.08280182,26.35960197
228,"BOILING SPRINGS NC",8,2,1,1,0,2,-81.66678619,35.25450516
228,"BOLINGBROOK IL",8,36,9,14,13,36,-88.06878662,41.69866562
228,"BONIFAY FL",8,2,0,0,2,2,-85.67938995,30.79223824
228,"BONNER SPRINGS KS",8,1,1,0,0,1,-94.88421631,39.05975342
228,"BONNEY LAKE WA",8,1,1,0,0,1,-122.1883698,47.17679596
228,"BOONE NC",8,5,1,2,2,5,-81.67436218,36.21696472
228,"BOONES MILL VA",8,1,0,0,1,1,-79.9546051,37.11700821
228,"BORDENTOWN NJ",8,7,4,2,1,7,-74.7159729,40.15003586
228,"BOSTON MA",8,826,274,209,343,826,-71.05905151,42.35883713
228,"BOULDER CO",8,80,27,25,28,80,-105.2715302,40.01483917
228,"BOWIE MD",8,61,19,23,19,61,-76.77848816,39.00718689
228,"BOWLING GREEN KY",8,14,6,3,5,14,-86.4437027,36.99057388
228,"BOWLING GREEN OH",8,2,1,1,0,2,-83.65102386,41.37505341
228,"BOYNTON BEACH FL",8,1,0,0,1,1,-80.066185,26.52592087
228,"BOZEMAN MT",8,15,9,5,1,15,-111.0471649,45.6803093
228,"BRADDOCK PA",8,1,0,1,0,1,-79.86782837,40.4034462
228,"BRADENTON FL",8,2,2,0,0,2,-82.57459259,27.49969101
228,"BRADLEY IL",8,2,0,2,0,2,-87.86099243,41.14196014
228,"BRANDON MS",8,3,1,0,2,3,-89.98616028,32.27327728
228,"BRANFORD FL",8,1,0,0,1,1,-82.92802429,29.95959473
228,"BRANSON MO",8,1,0,0,1,1,-93.21912384,36.64381409
228,"BRAWLEY CA",8,1,0,1,0,1,-115.5312119,32.97854614
228,"BREA CA",8,1,0,0,1,1,-117.9015732,33.91663361
228,"BREMEN GA",8,1,0,0,1,1,-85.1452179,33.72130585
228,"BREMERTON WA",8,1,0,0,1,1,-122.6345291,47.56690598
228,"BRENTWOOD CA",8,3,1,1,1,3,-121.6984329,37.93167496
228,"BRENTWOOD TN",8,1,1,0,0,1,-86.78275299,36.03345108
228,"BREVARD NC",8,6,0,4,2,6,-82.73400116,35.23363113
228,"BRIDGEPORT CT",8,8,3,1,4,8,-73.2040863,41.16743088
228,"BRIDGEPORT TX",8,3,1,1,1,3,-97.75536346,33.21035767
228,"BRIDGETON NJ",8,4,1,2,1,4,-75.23321533,39.42769623
228,"BRIGHTON IL",8,12,4,2,6,12,-90.14067841,39.03963089
228,"BRINKLEY AR",8,1,1,0,0,1,-91.19507599,34.8880043
228,"BRISTOL CT",8,1,0,1,0,1,-72.94853973,41.67193222
228,"BRISTOL TN",8,3,2,0,1,3,-82.17338562,36.58886719
228,"BRISTOL VA",8,2,2,0,0,2,-82.18840027,36.59663391
228,"BROADVIEW HEIGHTS OH",8,6,1,3,2,6,-81.68503571,41.31410217
228,"BROADVIEW IL",8,3,0,1,2,3,-87.85337067,41.86410522
228,"BROCKPORT NY",8,9,3,2,4,9,-77.93889618,43.213871
228,"BROCKTON MA",8,10,3,2,5,10,-71.01748657,42.08340454
228,"BROKEN ARROW OK",8,1,1,0,0,1,-95.79160309,36.05273056
228,"BROOKFIELD IL",8,15,5,5,5,15,-87.85184479,41.82412338
228,"BROOKFIELD WI",8,3,2,0,1,3,-88.10640717,43.06070328
228,"BROOKHAVEN MS",8,1,0,1,0,1,-90.44090271,31.57933807
228,"BROOKINGS OR",8,8,3,4,1,8,-124.2865219,42.05229187
228,"BROOKINGS SD",8,1,0,1,0,1,-96.79450989,44.3097229
228,"BROOKLINE MA",8,1,0,0,1,1,-71.12002563,42.33176804
228,"BROOKLYN CENTER MN",8,1,0,0,1,1,-93.28692627,45.07069016
228,"BROOKLYN PARK MN",8,1,0,0,1,1,-93.35662079,45.09407043
228,"BROOKNEAL VA",8,1,1,0,0,1,-78.94335937,37.05040741
228,"BROOKSVILLE FL",8,2,2,0,0,2,-82.38734436,28.55600739
228,"BROOMFIELD CO",8,7,5,2,0,7,-105.0877686,39.92069244
228,"BROWNSVILLE TX",8,2,1,0,1,2,-97.4977951,25.90228081
228,"BROWNWOOD TX",8,1,0,0,1,1,-98.99180603,31.70943642
228,"BRUNSWICK OH",8,2,1,0,1,2,-81.84169769,41.23830795
228,"BRYAN TX",8,2,1,0,1,2,-96.3704071,30.67456818
228,"BUCHANAN MI",8,2,0,0,2,2,-86.3614502,41.82715225
228,"BUCKEYE AZ",8,3,1,0,2,3,-112.5852661,33.37036896
228,"BUFFALO NY",8,132,37,39,56,132,-78.87787628,42.8867836
228,"BURBANK CA",8,10,4,3,3,10,-118.3104782,34.18065262
228,"BURGAW NC",8,1,1,0,0,1,-77.92559814,34.55234146
228,"BURLINGTON MA",8,1,1,0,0,1,-71.19434357,42.50506973
228,"BURLINGTON NJ",8,3,2,0,1,3,-74.86417389,40.07125092
228,"BURLINGTON VT",8,20,6,4,10,20,-73.20542908,44.47687531
228,"BUTLER PA",8,7,3,1,3,7,-79.89468384,40.86117172
228,"BYRAM MS",8,1,1,0,0,1,-90.25419617,32.18321609
228,"BYRON WY",8,3,1,2,0,3,-108.5082169,44.79620361
228,"CABOT AR",8,2,1,1,0,2,-92.01670837,34.9747467
228,"CAHOKIA IL",8,4,2,2,0,4,-90.19016266,38.57118225
228,"CAIRO GA",8,5,2,2,1,5,-84.20102692,30.87791824
228,"CALABASAS CA",8,3,1,1,1,3,-118.6473236,34.1558876
228,"CALIFORNIA PA",8,2,1,0,1,2,-79.89154053,40.06599426
228,"CALIMESA CA",8,2,2,0,0,2,-117.0634689,34.00385666
228,"CALUMET MI",8,1,0,0,1,1,-88.45446777,47.24640274
228,"CAMARILLO CA",8,54,18,15,21,54,-119.0400391,34.21628952
228,"CAMBRIDGE MA",8,148,49,38,61,148,-71.10369873,42.36532593
228,"CAMBRIDGE OH",8,45,8,20,17,45,-81.58615875,40.02525711
228,"CAMDEN NJ",8,19,6,3,10,19,-75.118927,39.92608261
228,"CAMDEN TN",8,1,0,0,1,1,-88.09780121,36.05930328
228,"CAMPBELL CA",8,3,0,1,2,3,-121.951973,37.287117
228,"CAMPBELL MO",8,1,1,0,0,1,-90.07504272,36.49356079
228,"CANANDAIGUA NY",8,3,0,3,0,3,-77.28107452,42.88830948
228,"CANASTOTA NY",8,1,0,0,1,1,-75.75039673,43.07939529
228,"CANTON GA",8,3,1,0,2,3,-84.48571014,34.23356628
228,"CANTON MS",8,1,0,1,0,1,-90.03672028,32.61313248
228,"CANTON NY",8,1,1,0,0,1,-75.16870117,44.59575272
228,"CANTON OH",8,14,5,4,5,14,-81.37824249,40.79906845
228,"CAPE CANAVERAL FL",8,2,0,2,0,2,-80.60503387,28.4044838
228,"CAPE CORAL FL",8,12,2,3,7,12,-81.9491806,26.56343079
228,"CAPE GIRARDEAU MO",8,27,8,12,7,27,-89.51838684,37.30613327
228,"CAPE MAY NJ",8,2,2,0,0,2,-74.90522766,38.93513107
228,"CAPITOL HEIGHTS MD",8,3,1,0,2,3,-76.91506195,38.88552475
228,"CARBONDALE IL",8,22,6,5,11,22,-89.2168808,37.7274704
228,"CARDINGTON OH",8,2,1,0,1,2,-82.89324188,40.5008812
228,"CARLISLE IA",8,1,1,0,0,1,-93.48899078,41.50154495
228,"CARLSBAD CA",8,3,0,0,3,3,-117.3528137,33.1580162
228,"CARMEL IN",8,3,1,1,1,3,-86.12607574,39.97961426
228,"CARNEYS POINT NJ",8,1,0,1,0,1,-75.46931458,39.71123123
228,"CAROL STREAM IL",8,3,1,1,1,3,-88.13473511,41.91279221
228,"CARPINTERIA CA",8,1,1,0,0,1,-119.5201263,34.39894485
228,"CARRBORO NC",8,9,2,3,4,9,-79.07286835,35.91213989
228,"CARRIZO SPRINGS TX",8,1,1,0,0,1,-99.86119843,28.52256584
228,"CARROLLTON GA",8,3,1,0,2,3,-85.07631683,33.58019638
228,"CARROLLTON TX",8,1,0,1,0,1,-96.89080811,32.95380783
228,"CARSON CA",8,7,3,3,1,7,-118.2837448,33.8312645
228,"CARSON CITY NV",8,3,2,0,1,3,-119.7687988,39.16352844
228,"CARTERET NJ",8,7,3,3,1,7,-74.2276535,40.57754135
228,"CARTERSVILLE GA",8,8,4,3,1,8,-84.79982758,34.1654892
228,"CARY NC",8,21,9,5,7,21,-78.78055573,35.79200745
228,"CASCADE LOCKS OR",8,1,0,0,1,1,-121.8928452,45.66971588
228,"CASTLE ROCK CO",8,1,1,0,0,1,-104.857811,39.37207031
228,"CAVE CREEK AZ",8,2,1,1,0,2,-111.9523544,33.83345795
228,"CEDAR FALLS IA",8,2,1,1,0,2,-92.44594574,42.52773285
228,"CEDAR HILL TX",8,16,2,3,3,8,-99.08098985,33.36628723
228,"CEDAR RAPIDS IA",8,29,5,11,13,29,-91.66259766,41.98337555
228,"CENTER LINE MI",8,1,1,0,0,1,-83.02747345,42.48490524
228,"CENTRALIA MO",8,1,0,0,1,1,-92.13832855,39.2105484
228,"CENTRALIA WA",8,1,0,0,1,1,-122.9679337,46.71740723
228,"CERES CA",8,6,1,3,2,6,-120.9599075,37.59457016
228,"CERRITOS CA",8,1,0,0,1,1,-118.0665054,33.85832214
228,"CHAMBERSBURG PA",8,1,0,0,1,1,-77.66046906,39.93768692
228,"CHAMBLEE GA",8,1,0,1,0,1,-84.29881287,33.89216995
228,"CHAMPAIGN IL",8,28,8,9,11,28,-88.24346161,40.11659622
228,"CHANDLER AZ",8,23,7,5,11,23,-111.8428345,33.3062439
228,"CHAPEL HILL NC",8,66,22,17,27,66,-79.05697632,35.91110611
228,"CHARLESTON SC",8,105,36,31,38,105,-79.93032074,32.77671814
228,"CHARLESTON WV",8,11,4,0,7,11,-81.63149261,38.34872055
228,"CHARLOTTE NC",8,483,134,146,203,483,-80.84257507,35.22746277
228,"CHARLOTTESVILLE VA",8,59,22,14,23,59,-78.49123383,38.03798676
228,"CHATTANOOGA TN",8,43,13,16,14,43,-85.30583954,35.04058456
228,"CHECOTAH OK",8,6,2,1,3,6,-95.52338409,35.47038651
228,"CHEEKTOWAGA NY",8,1,0,1,0,1,-78.75413513,42.90357208
228,"CHELSEA AL",8,3,1,1,1,3,-86.63014984,33.34026718
228,"CHELSEA MA",8,1,1,0,0,1,-71.03151703,42.39189529
228,"CHENEY KS",8,1,0,0,1,1,-97.78330994,37.6300087
228,"CHERRY HILL NJ",8,6,2,2,2,6,-75.03024292,39.93510437
228,"CHESAPEAKE VA",8,28,9,9,10,28,-76.27422333,36.81948853
228,"CHESTER IL",8,1,0,0,1,1,-89.82231903,37.91368103
228,"CHESTER PA",8,3,0,1,2,3,-75.35475159,39.84973145
228,"CHESTERFIELD MO",8,24,8,6,10,24,-90.5772934,38.6631279
228,"CHESTERTOWN MD",8,1,1,0,0,1,-76.0662384,39.20907593
228,"CHEYENNE WY",8,2,0,2,0,2,-104.8183899,41.13345718
228,"CHICAGO IL",8,1664,535,452,677,1664,-87.6503067,41.85000992
228,"CHICKAMAUGA GA",8,1,0,0,1,1,-85.29045105,34.87113571
228,"CHICO CA",8,63,13,18,32,63,-121.839447,39.72846222
228,"CHILLICOTHE MO",8,4,2,0,2,4,-93.55298615,39.79542542
228,"CHINA GROVE NC",8,4,1,3,0,4,-80.58115387,35.56945801
228,"CHINO CA",8,5,3,0,2,5,-117.6906662,34.0121727
228,"CHOCTAW OK",8,1,0,0,1,1,-97.26795197,35.49282074
228,"CHULA VISTA CA",8,15,11,1,3,15,-117.0857468,32.64037704
228,"CICERO IL",8,2,2,0,0,2,-87.75395203,41.84553909
228,"CINCINNATI OH",8,156,56,41,59,156,-84.51939392,39.10413742
228,"CLAREMORE OK",8,2,1,0,1,2,-95.61654663,36.31294632
228,"CLARKSVILLE TN",8,13,5,2,6,13,-87.35944366,36.52993011
228,"CLAYTON DE",8,5,2,1,2,5,-75.63150787,39.29172897
228,"CLAYTON MO",8,4,1,0,3,4,-90.32382965,38.64260101
228,"CLAYTON NC",8,1,1,0,0,1,-78.45562744,35.6511879
228,"CLEAR LAKE SHORES TX",8,106,30,38,38,106,-95.03226471,29.54773712
228,"CLEARWATER FL",8,17,2,7,8,17,-82.79984283,27.9665451
228,"CLEBURNE TX",8,2,0,2,0,2,-97.38722992,32.34804535
228,"CLEMSON SC",8,4,0,0,4,4,-82.83683014,34.68382645
228,"CLEVELAND HEIGHTS OH",8,1,0,1,0,1,-81.55568695,41.52017975
228,"CLEVELAND OH",8,419,134,129,156,419,-81.69516754,41.49978256
228,"CLEVELAND TN",8,1,0,1,0,1,-84.87675476,35.15940094
228,"CLIFTON NJ",8,1,1,0,0,1,-74.16278076,40.85860062
228,"CLINTON MS",8,1,0,0,1,1,-90.33226776,32.34069061
228,"CLOVER SC",8,1,0,1,0,1,-81.22589874,35.11135864
228,"CLOVIS CA",8,3,1,2,0,3,-119.7047043,36.82522583
228,"CLYDE NY",8,1,0,1,0,1,-76.86891937,43.08428955
228,"COATESVILLE PA",8,1,0,0,1,1,-75.82329559,39.98334885
228,"COEUR D'ALENE ID",8,2,1,0,1,2,-116.781929,47.67768478
228,"COLDSPRING TX",8,1,1,0,0,1,-95.12992096,30.5929203
228,"COLEMAN FL",8,1,1,0,0,1,-82.06983185,28.80015755
228,"COLFAX CA",8,2,1,0,1,2,-120.9551468,39.10037994
228,"COLLEGE PARK GA",8,6,2,1,3,6,-84.44933319,33.65347672
228,"COLLEGE PARK MD",8,108,35,26,47,108,-76.93619537,38.98080444
228,"COLLEGE STATION TX",8,19,6,4,9,19,-96.33758545,30.62316895
228,"COLLEGEVILLE PA",8,2,1,0,1,2,-75.4506073,40.18598557
228,"COLLIERVILLE TN",8,6,1,2,3,6,-89.66448212,35.0423317
228,"COLLINSVILLE IL",8,20,8,3,9,20,-89.98478699,38.67050171
228,"COLMA CA",8,1,0,0,1,1,-122.4610977,37.67665482
228,"COLORADO SPRINGS CO",8,44,10,11,23,44,-104.8225174,38.83369446
228,"COLTON CA",8,1,1,0,0,1,-117.3153687,34.0738945
228,"COLUMBIA IL",8,5,3,1,1,5,-90.20130157,38.44375992
228,"COLUMBIA MO",8,168,47,55,66,168,-92.33429718,38.95169067
228,"COLUMBIA PA",8,1,0,1,0,1,-76.50388336,40.03407669
228,"COLUMBIA SC",8,114,37,21,56,114,-81.04045105,34.00138855
228,"COLUMBIA TN",8,1,0,1,0,1,-87.03533173,35.61502457
228,"COLUMBIANA OH",8,1,0,0,1,1,-80.69345093,40.88829041
228,"COLUMBUS GA",8,63,20,16,27,63,-84.98313141,32.46828842
228,"COLUMBUS IN",8,6,0,1,5,6,-85.92284393,39.20959473
228,"COLUMBUS MS",8,5,2,1,2,5,-88.42742157,33.49581909
228,"COLUMBUS OH",8,387,110,119,158,387,-82.99890137,39.96136475
228,"COMBES TX",8,2,0,0,2,2,-97.73451233,26.24924469
228,"COMMERCE TX",8,1,0,1,0,1,-95.90060425,33.24729538
228,"COMPTON CA",8,18,5,5,8,18,-118.2218704,33.89606857
228,"CONCORD CA",8,3,2,0,1,3,-122.0333328,37.97780228
228,"CONCORD NC",8,3,0,2,1,3,-80.57880402,35.4092598
228,"CONCORD NH",8,1,1,0,0,1,-71.53688812,43.20820999
228,"CONOVER NC",8,1,0,0,1,1,-81.21835327,35.70663834
228,"CONROE TX",8,2,0,2,0,2,-95.45646667,30.31249237
228,"CONWAY AR",8,3,1,0,2,3,-92.4426651,35.08877563
228,"CONWAY SC",8,1,0,0,1,1,-79.04202271,33.83802795
228,"CONYERS GA",8,3,1,1,1,3,-84.0175705,33.66764832
228,"COOKEVILLE TN",8,1,0,1,0,1,-85.50189972,36.16290665
228,"COON RAPIDS MN",8,1,0,1,0,1,-93.32348633,45.16527176
228,"COOPERSTOWN NY",8,1,1,0,0,1,-74.9236908,42.70100784
228,"COOS BAY OR",8,3,0,1,2,3,-124.219841,43.36757278
228,"COPPELL TX",8,1,0,0,1,1,-97.01548004,32.95487213
228,"COPPERAS COVE TX",8,1,1,0,0,1,-97.90343475,31.12462616
228,"CORAL GABLES FL",8,3,2,0,1,3,-80.26779938,25.72242165
228,"CORINTH TX",8,1,0,1,0,1,-99.87008667,32.85448456
228,"CORONA CA",8,13,4,3,6,13,-117.5688171,33.87516785
228,"CORONADO CA",8,9,2,2,5,9,-117.1846619,32.6861763
228,"CORPUS CHRISTI TX",8,12,4,6,2,12,-97.42076874,27.77859879
228,"CORTLAND NY",8,3,2,0,1,3,-76.17972565,42.60138702
228,"CORTLAND OH",8,1,1,0,0,1,-80.72497559,41.3302803
228,"CORVALLIS OR",8,3,2,1,0,3,-123.2646637,44.56417084
228,"COSTA MESA CA",8,2,0,0,2,2,-117.9204407,33.64131927
228,"COTATI CA",8,6,2,2,2,6,-122.7091904,38.32655334
228,"COTTONDALE FL",8,1,1,0,0,1,-85.37663269,30.79734612
228,"COULTERVILLE IL",8,1,1,0,0,1,-89.60566711,38.18644714
228,"COUNCIL BLUFFS IA",8,5,2,1,2,5,-95.86154938,41.26196289
228,"COUNCIL GROVE KS",8,2,0,1,1,2,-96.49236298,38.66096115
228,"COUNTRY CLUB HILLS IL",8,1,1,0,0,1,-87.72031403,41.56811142
228,"COVINGTON KY",8,1,1,0,0,1,-84.50816345,39.08356476
228,"CRAWFORDSVILLE IN",8,1,0,0,1,1,-86.89406586,40.04439926
228,"CRESCENT CITY CA",8,2,0,1,1,2,-124.2048645,41.75559235
228,"CRESTVIEW FL",8,1,0,0,1,1,-86.57064819,30.76231766
228,"CRESTVIEW KY",8,1,0,1,0,1,-84.41716003,39.02523804
228,"CREVE COEUR MO",8,3,0,3,0,3,-90.42288971,38.66108322
228,"CROSS PLAINS TN",8,2,0,2,0,2,-86.69587708,36.54875183
228,"CROSSVILLE IL",8,1,0,1,0,1,-88.06548309,38.1617775
228,"CROSSVILLE TN",8,3,1,1,1,3,-85.0270462,35.9490509
228,"CROTON-ON-HUDSON NY",8,7,1,3,3,7,-73.89041901,41.2085762
228,"CROWN POINT IN",8,1,1,0,0,1,-87.36541748,41.41695023
228,"CRYSTAL MN",8,1,0,0,1,1,-93.36638641,45.05664063
228,"CRYSTAL SPRINGS MS",8,1,1,0,0,1,-90.35726929,31.98783875
228,"CUBA MO",8,3,1,2,0,3,-91.40387726,38.06311035
228,"CULPEPER VA",8,1,1,0,0,1,-77.99610901,38.47347641
228,"CUMMING GA",8,3,1,1,1,3,-84.1401825,34.2074852
228,"CUPERTINO CA",8,6,0,1,5,6,-122.0342026,37.32306671
228,"CUT AND SHOOT TX",8,15,6,4,5,15,-95.35832214,30.33357811
228,"CUYAHOGA FALLS OH",8,24,7,8,9,24,-81.48397064,41.1338768
228,"DACULA GA",8,9,4,1,4,9,-83.89762878,33.9887352
228,"DADE CITY FL",8,3,3,0,0,3,-82.19556427,28.36546135
228,"DAHLONEGA GA",8,1,0,0,1,1,-83.98484802,34.53287125
228,"DAINGERFIELD TX",8,1,1,0,0,1,-94.72219086,33.03223801
228,"DALLAS OR",8,1,0,0,1,1,-123.3198471,44.91903687
228,"DALLAS TX",8,1023,336,281,406,1023,-96.80088043,32.78369904
228,"DALTON GA",8,3,0,2,1,3,-84.97008514,34.76976776
228,"DALY CITY CA",8,4,0,3,1,4,-122.4645081,37.70376968
228,"DANBURY CT",8,2,0,1,1,2,-73.45310974,41.39499664
228,"DANFORTH ME",8,1,0,1,0,1,-67.86733246,45.66029358
228,"DANVILLE CA",8,1,0,0,1,1,-122.0023193,37.82156754
228,"DANVILLE IL",8,2,0,0,2,2,-87.62978363,40.12442398
228,"DANVILLE VA",8,9,2,4,3,9,-79.39437866,36.58641434
228,"DAPHNE AL",8,2,0,2,0,2,-87.90383148,30.60381317
228,"DAVENPORT IA",8,14,5,5,4,14,-90.57814026,41.52380753
228,"DAVIE FL",8,3,0,1,2,3,-80.23148346,26.0657177
228,"DAVIS CA",8,7,4,2,1,7,-121.7421722,38.54467773
228,"DAYTON IN",8,1,1,0,0,1,-86.76915741,40.37435913
228,"DAYTON KY",8,6,0,4,2,6,-84.47278595,39.11274338
228,"DAYTON OH",8,57,20,19,18,57,-84.19126892,39.75915146
228,"DAYTONA BEACH FL",8,27,10,9,8,27,-81.02253723,29.21147537
228,"DEARBORN MI",8,7,1,3,3,7,-83.1758728,42.32239914
228,"DECATUR AL",8,5,2,0,3,5,-86.98355103,34.60622406
228,"DECATUR GA",8,39,14,11,14,39,-84.29631805,33.77489471
228,"DECATUR IL",8,2,0,1,1,2,-88.95516968,39.84060287
228,"DECATUR IN",8,1,0,0,1,1,-84.93001556,40.82580566
228,"DEDHAM MA",8,2,1,0,1,2,-71.16512299,42.24193954
228,"DEER PARK WA",8,1,0,0,1,1,-117.4789734,47.95389938
228,"DEERFIELD BEACH FL",8,3,0,1,2,3,-80.09928131,26.31905365
228,"DEERFIELD IL",8,1,0,1,0,1,-87.84490204,42.17103577
228,"DEL MAR CA",8,3,1,0,2,3,-117.2663345,32.95969391
228,"DEL RIO TX",8,3,1,1,1,3,-100.8970642,29.36329842
228,"DELAWARE CITY DE",8,1,0,1,0,1,-75.59502411,39.57416534
228,"DELAWARE OH",8,1,0,0,1,1,-83.06757355,40.29886627
228,"DELRAY BEACH FL",8,5,2,1,2,5,-80.07209778,26.46233368
228,"DELTA CO",8,3,0,2,1,3,-108.0698395,38.74222946
228,"DENMARK SC",8,1,0,1,0,1,-81.14172363,33.32278824
228,"DENTON TX",8,44,12,17,15,44,-97.13349915,33.21514893
228,"DENVER CO",8,427,122,123,182,427,-104.9853745,39.73901749
228,"DEPOE BAY OR",8,1,0,1,0,1,-124.0607987,44.81190491
228,"DERBY KS",8,1,0,1,0,1,-97.26980591,37.54567719
228,"DERRY NH",8,1,0,0,1,1,-71.32653809,42.88068008
228,"DES MOINES IA",8,35,15,8,12,35,-93.6210022,41.59817123
228,"DES PLAINES IL",8,10,5,3,2,10,-87.8833847,42.03343964
228,"DESTIN FL",8,8,2,3,3,8,-86.49551392,30.39405632
228,"DETROIT MI",8,368,115,102,151,368,-83.04567719,42.33172226
228,"DEXTER MI",8,1,0,1,0,1,-83.88848114,42.33824158
228,"DEXTER MO",8,4,0,4,0,4,-89.95834351,36.79595947
228,"DIAMOND BAR CA",8,2,1,0,1,2,-117.8404999,33.97759247
228,"DILLON SC",8,2,1,0,1,2,-79.37909698,34.41096115
228,"DISTRICT HEIGHTS MD",8,1,1,0,0,1,-76.88869476,38.85776138
228,"DONIPHAN MO",8,1,1,0,0,1,-90.82394409,36.62110138
228,"DONNA TX",8,1,0,1,0,1,-98.05448914,26.17434883
228,"DORAVILLE GA",8,1,1,0,0,1,-84.28286743,33.89825821
228,"DOTHAN AL",8,2,1,0,1,2,-85.39019775,31.22351265
228,"DOUGLAS GA",8,28,8,7,13,28,-82.84980011,31.50903511
228,"DOVER DE",8,6,2,0,4,6,-75.52090454,39.15853882
228,"DOVER NH",8,2,0,2,0,2,-70.88840485,43.2059021
228,"DOYLESTOWN PA",8,7,1,2,4,7,-75.1292038,40.31054688
228,"DUBLIN CA",8,9,0,3,6,9,-121.9383392,37.70181274
228,"DUBLIN GA",8,1,1,0,0,1,-82.90332794,32.540802
228,"DUBLIN VA",8,1,1,0,0,1,-80.68517303,37.10611343
228,"DUBUQUE IA",8,5,2,0,3,5,-90.67155457,42.51130295
228,"DULUTH MN",8,4,0,3,1,4,-92.10697174,46.78300858
228,"DUNCAN OK",8,1,1,0,0,1,-97.95820618,34.50245667
228,"DUNCANVILLE TX",8,2,1,0,1,2,-96.9091568,32.65229034
228,"DUNEDIN FL",8,3,0,3,0,3,-82.77127838,28.02050591
228,"DUNWOODY GA",8,1,0,1,0,1,-84.33460236,33.94631958
228,"DURANGO CO",8,3,1,2,0,3,-107.8810043,37.27463913
228,"DURANT OK",8,1,0,1,0,1,-96.37478638,33.99116135
228,"DURHAM NC",8,247,64,71,112,247,-78.89787292,35.99412918
228,"DURHAM NH",8,1,0,0,1,1,-70.92732239,43.13511276
228,"EAGAN MN",8,5,1,1,3,5,-93.16746521,44.80387878
228,"EAGLE PASS TX",8,1,0,0,1,1,-100.5002899,28.70978737
228,"EAGLE RIVER WI",8,1,1,0,0,1,-89.24466705,45.91718674
228,"EAST DUBLIN GA",8,1,0,0,1,1,-82.86959839,32.54988098
228,"EAST HARTFORD CT",8,2,1,0,1,2,-72.64693451,41.77160263
228,"EAST LANSING MI",8,35,12,14,9,35,-84.48403931,42.73703384
228,"EAST MCKEESPORT PA",8,4,1,0,3,4,-79.80618286,40.38326645
228,"EAST ORANGE NJ",8,23,8,8,7,23,-74.21418762,40.76618958
228,"EAST PALO ALTO CA",8,3,1,2,0,3,-122.143013,37.46857452
228,"EAST POINT GA",8,2,1,1,0,2,-84.43933868,33.67996979
228,"EASTMAN GA",8,1,0,0,1,1,-83.17722321,32.19805527
228,"EASTON MD",8,1,1,0,0,1,-76.07592773,38.77448654
228,"EASTON PA",8,7,4,0,3,7,-75.21966553,40.68871689
228,"EAU CLAIRE WI",8,2,2,0,0,2,-91.49876404,44.81137466
228,"EDEN PRAIRIE MN",8,1,0,0,1,1,-93.48716736,44.85310745
228,"EDINA MN",8,1,0,1,0,1,-93.34928131,44.91236496
228,"EDINA MO",8,2,1,0,1,2,-92.1732254,40.16763306
228,"EDINBORO PA",8,3,2,0,1,3,-80.13100433,41.87437439
228,"EDINBURG TX",8,1,1,0,0,1,-98.16417694,26.30259705
228,"EDINBURGH IN",8,1,0,1,0,1,-85.96690369,39.35437775
228,"EDMOND OK",8,20,5,6,9,20,-97.48453522,35.65326309
228,"EDMONDS WA",8,13,4,1,8,13,-122.3799057,47.81037521
228,"EDWARDSVILLE IL",8,71,27,17,27,71,-89.95322418,38.8115654
228,"EFFINGHAM IL",8,1,1,0,0,1,-88.54359436,39.12008667
228,"EL CENTRO CA",8,2,0,0,2,2,-115.5646057,32.79199982
228,"EL CERRITO CA",8,11,7,1,3,11,-122.3142548,37.91544342
228,"EL LAGO TX",8,3,1,2,0,3,-95.04547119,29.56394196
228,"EL PASO TX",8,74,24,21,29,74,-106.4620514,31.78388405
228,"EL SEGUNDO CA",8,2,1,0,1,2,-118.4185257,33.91943741
228,"ELBERTON GA",8,1,0,0,1,1,-82.86587524,34.11487579
228,"ELGIN IL",8,1,1,0,0,1,-88.28123474,42.03733444
228,"ELIZABETH NJ",8,4,1,3,0,4,-74.21881866,40.66823578
228,"ELIZABETH PA",8,1,1,0,0,1,-79.88930511,40.26922607
228,"ELIZABETHTOWN KY",8,2,0,2,0,2,-85.85932159,37.69418716
228,"ELIZABETHTOWN PA",8,3,1,2,0,3,-76.60209656,40.15314865
228,"ELK GROVE CA",8,220,68,57,95,220,-121.3743591,38.40848923
228,"ELK RIVER MN",8,1,0,0,1,1,-93.56745911,45.30422974
228,"ELKHART IN",8,1,0,0,1,1,-85.97689056,41.68212128
228,"ELKO NV",8,1,0,0,1,1,-115.7643967,40.83226395
228,"ELLENSBURG WA",8,4,0,2,2,4,-120.5507507,46.99611664
228,"ELMIRA NY",8,17,5,7,5,17,-76.80737305,42.08998108
228,"ELYRIA OH",8,12,4,6,2,12,-82.10734558,41.36825562
228,"EMERYVILLE CA",8,1,0,1,0,1,-122.2871475,37.83127975
228,"ENGLEWOOD NJ",8,4,1,2,1,4,-73.97172546,40.8928833
228,"ENGLISHTOWN NJ",8,1,0,0,1,1,-74.35713196,40.29751205
228,"ENID OK",8,1,1,0,0,1,-97.87895203,36.39573288
228,"ERIE PA",8,33,10,4,19,33,-80.08492279,42.12926483
228,"ERLANGER KY",8,1,0,0,1,1,-84.60089111,39.01673508
228,"ERWIN TN",8,1,0,1,0,1,-82.41162109,36.15189362
228,"ESCANABA MI",8,1,0,0,1,1,-87.06468964,45.74517822
228,"ESCONDIDO CA",8,3,1,1,1,3,-117.0886231,33.11952591
228,"ESTERO FL",8,1,1,0,0,1,-81.80654144,26.43899536
228,"ESTHERVILLE IA",8,1,0,0,1,1,-94.83354187,43.40145493
228,"EUCLID OH",8,1,0,0,1,1,-81.52645111,41.59303284
228,"EUGENE OR",8,72,29,17,26,72,-123.0898361,44.05194855
228,"EULESS TX",8,1,0,1,0,1,-97.08273315,32.83728409
228,"EUREKA CA",8,3,0,1,2,3,-124.1653366,40.80156708
228,"EUREKA MO",8,2,1,1,0,2,-90.62799835,38.50252533
228,"EVANSTON IL",8,8,4,0,4,8,-87.69037628,42.04132843
228,"EVANSTON WY",8,4,2,2,0,4,-110.9652634,41.26803589
228,"EVANSVILLE IN",8,21,5,9,7,21,-87.56850433,37.97795486
228,"EVERETT MA",8,4,3,0,1,4,-71.05252075,42.40878296
228,"EVERETT WA",8,6,1,2,3,6,-122.2045441,47.97843552
228,"EXCELSIOR SPRINGS MO",8,3,2,0,1,3,-94.22633362,39.33908463
228,"EXETER NH",8,1,1,0,0,1,-70.95800781,42.98471451
228,"FAIRBANKS AK",8,1,0,1,0,1,-147.7185669,64.83367157
228,"FAIRBORN OH",8,4,0,1,3,4,-84.01902771,39.82121658
228,"FAIRFAX VA",8,10,6,2,2,10,-77.30588531,38.84661865
228,"FAIRFIELD CA",8,4,1,1,2,4,-122.0420914,38.24917603
228,"FAIRFIELD CT",8,1,1,0,0,1,-73.26300049,41.14122772
228,"FAIRFIELD OH",8,3,0,0,3,3,-84.56064606,39.34600449
228,"FAIRHOPE AL",8,1,0,1,0,1,-87.90351105,30.52334213
228,"FAIRMONT CITY IL",8,1,0,1,0,1,-90.09365845,38.65008545
228,"FAIRMONT WV",8,2,2,0,0,2,-80.14244843,39.48347473
228,"FALL RIVER MA",8,5,2,0,3,5,-71.15414429,41.70151138
228,"FALLS CHURCH VA",8,1,0,1,0,1,-77.17056274,38.88268661
228,"FARGO ND",8,15,5,2,8,15,-96.79805756,46.87498474
228,"FARMERS BRANCH TX",8,1,1,0,0,1,-96.89679718,32.92665482
228,"FARMINGDALE NY",8,1,0,0,1,1,-73.44436646,40.73298645
228,"FARMINGTON HILLS MI",8,2,0,0,2,2,-83.3771286,42.48558807
228,"FARMINGTON IL",8,1,0,0,1,1,-90.00591278,40.69827271
228,"FARMINGTON MO",8,5,0,2,3,5,-90.4220047,37.78110504
228,"FARMVILLE VA",8,2,1,0,1,2,-78.39121246,37.30234909
228,"FAYETTE MO",8,1,1,0,0,1,-92.68386078,39.14609146
228,"FAYETTEVILLE AR",8,37,12,8,17,37,-94.15759277,36.06256104
228,"FAYETTEVILLE GA",8,1,0,0,1,1,-84.45489502,33.44916916
228,"FAYETTEVILLE NC",8,14,3,5,6,14,-78.87771606,35.05313873
228,"FAYETTEVILLE NY",8,1,0,0,1,1,-76.0059433,43.02997971
228,"FAYETTEVILLE TN",8,2,1,1,0,2,-86.57073212,35.15206146
228,"FEDERAL WAY WA",8,7,1,4,2,7,-122.314415,47.32177734
228,"FELTON DE",8,1,0,0,1,1,-75.57888031,39.00894928
228,"FENTON MI",8,2,0,0,2,2,-83.70490265,42.79768372
228,"FENTON MO",8,35,8,10,17,35,-90.43593597,38.51305771
228,"FERGUSON MO",8,66,26,18,22,66,-90.306633,38.74429321
228,"FERNDALE MI",8,10,4,3,3,10,-83.13441467,42.46089172
228,"FESTUS MO",8,3,0,1,2,3,-90.39609528,38.22088623
228,"FISHERS IN",8,1,0,0,1,1,-86.0140152,39.95565414
228,"FITCHBURG WI",8,2,1,1,0,2,-89.47031403,42.96075439
228,"FLAGLER BEACH FL",8,2,1,1,0,2,-81.12680054,29.47527695
228,"FLAGSTAFF AZ",8,26,10,3,13,26,-111.6533051,35.19802475
228,"FLINT MI",8,39,17,14,8,39,-83.68744659,43.01246643
228,"FLORAL PARK NY",8,1,1,0,0,1,-73.70424652,40.72377777
228,"FLORENCE AL",8,7,1,3,3,7,-87.67726898,34.7997818
228,"FLORENCE OR",8,1,0,1,0,1,-124.1027145,43.98227692
228,"FLORENCE SC",8,12,5,0,7,12,-79.76351166,34.19935226
228,"FLORISSANT MO",8,145,72,31,42,145,-90.32299042,38.78946304
228,"FLOYD VA",8,2,0,2,0,2,-80.31944275,36.91149902
228,"FONTANA CA",8,4,1,1,2,4,-117.4363785,34.09202576
228,"FORDYCE AR",8,1,0,0,1,1,-92.41331482,33.81410217
228,"FOREST CITY IA",8,1,1,0,0,1,-93.63772583,43.26252365
228,"FORT COLLINS CO",8,48,15,10,23,48,-105.0858688,40.58546066
228,"FORT LAUDERDALE FL",8,81,24,25,32,81,-80.14283752,26.12309074
228,"FORT LEE NJ",8,1,0,1,0,1,-73.96900177,40.85113907
228,"FORT LUPTON CO",8,1,0,0,1,1,-104.8086929,40.07614517
228,"FORT MILL SC",8,4,0,1,3,4,-80.94496155,35.00762558
228,"FORT MYERS FL",8,12,3,3,6,12,-81.87184143,26.64133644
228,"FORT PIERCE FL",8,1,0,1,0,1,-80.32531738,27.44716644
228,"FORT SMITH AR",8,9,3,5,1,9,-94.39919281,35.3862114
228,"FORT WALTON BEACH FL",8,3,2,0,1,3,-86.61834717,30.40767479
228,"FORT WAYNE IN",8,39,15,11,13,39,-85.13967896,41.07278061
228,"FORT WORTH TX",8,182,58,49,75,182,-97.32135773,32.72562027
228,"FORT YATES ND",8,1,0,1,0,1,-100.6290817,46.09021378
228,"FOUNTAIN INN SC",8,1,0,1,0,1,-82.20529175,34.69663239
228,"FOUNTAIN VALLEY CA",8,1,0,0,1,1,-117.9555054,33.70910645
228,"FRAMINGHAM MA",8,1,0,1,0,1,-71.41543579,42.27958298
228,"FRANKFORT KY",8,5,4,1,0,5,-84.87322235,38.20124054
228,"FRANKLIN LA",8,1,0,1,0,1,-91.50192261,29.79652786
228,"FRANKLIN TN",8,7,2,2,3,7,-86.87760162,35.92164993
228,"FRANKLINTON LA",8,1,0,0,1,1,-90.15345764,30.84731102
228,"FREDERICK MD",8,15,7,1,7,15,-77.40981293,39.41444397
228,"FREDERICKSBURG TX",8,1,1,0,0,1,-98.87243652,30.27570152
228,"FREDERICKSBURG VA",8,7,0,2,5,7,-77.45996094,38.30348969
228,"FREEPORT IL",8,11,2,3,6,11,-89.62126923,42.29691696
228,"FREMONT CA",8,11,5,1,5,11,-121.9740372,37.55101776
228,"FREMONT OH",8,5,0,3,2,5,-83.12195587,41.35057831
228,"FRESNO CA",8,62,20,19,23,62,-119.7739868,36.74755478
228,"FRIARS POINT MS",8,1,0,0,1,1,-90.63935089,34.36989975
228,"FRIDLEY MN",8,6,1,1,4,6,-93.2636261,45.08617401
228,"FRIENDSWOOD TX",8,2,1,0,1,2,-95.20127106,29.53010368
228,"FRISCO CO",8,5,3,1,1,5,-106.0990143,39.57444763
228,"FRISCO TX",8,5,1,4,0,5,-96.82434082,33.15098572
228,"FRITCH TX",8,1,0,0,1,1,-101.6041031,35.63983154
228,"FRONT ROYAL VA",8,1,0,1,0,1,-78.19395447,38.91853714
228,"FULLERTON CA",8,13,1,4,8,13,-117.9268646,33.87014771
228,"GADSDEN AL",8,5,1,3,1,5,-86.00675201,34.01457596
228,"GAINESVILLE FL",8,42,14,12,16,42,-82.32462311,29.65203285
228,"GAINESVILLE GA",8,2,0,2,0,2,-83.82389832,34.29787827
228,"GAITHERSBURG MD",8,4,1,0,3,4,-77.20072174,39.14352417
228,"GALESBURG IL",8,1,0,0,1,1,-90.37152863,40.9480629
228,"GALT CA",8,1,0,1,0,1,-121.3024445,38.25453568
228,"GALVESTON TX",8,4,2,1,1,4,-94.79576111,29.30070114
228,"GARDEN CITY MO",8,2,0,0,2,2,-94.19150543,38.56124496
228,"GARDEN GROVE CA",8,9,1,2,6,9,-117.943718,33.77397156
228,"GARDENA CA",8,4,2,1,1,4,-118.3105164,33.88837814
228,"GARDNER MA",8,1,1,0,0,1,-71.99727631,42.57534027
228,"GARLAND TX",8,3,1,1,1,3,-96.63926697,32.91297531
228,"GARNER NC",8,3,1,1,1,3,-78.61359406,35.71166992
228,"GARRETT IN",8,1,0,1,0,1,-85.13555908,41.3495636
228,"GARY IN",8,14,7,4,3,14,-87.33873749,41.59325409
228,"GASTON OR",8,1,0,1,0,1,-123.141571,45.43574142
228,"GASTONIA NC",8,1,0,0,1,1,-81.18706512,35.26216507
228,"GAYLORD MI",8,1,0,1,0,1,-84.67483521,45.02762222
228,"GENEVA IL",8,1,0,0,1,1,-88.30541992,41.8876915
228,"GENEVA NY",8,1,0,1,0,1,-76.97723389,42.86890793
228,"GENOA CITY WI",8,1,0,0,1,1,-88.32978821,42.49824905
228,"GEORGETOWN KY",8,1,0,1,0,1,-84.55860138,38.21012115
228,"GEORGETOWN TX",8,3,0,0,3,3,-97.67801666,30.6329689
228,"GERMANTOWN TN",8,2,1,0,1,2,-89.80731201,35.08958817
228,"GETTYSBURG PA",8,2,1,0,1,2,-77.23023224,39.83097076
228,"GIDDINGS TX",8,2,1,0,1,2,-96.93708801,30.18294907
228,"GIG HARBOR WA",8,2,0,2,0,2,-122.590683,47.32983398
228,"GILBERT AZ",8,7,1,4,2,7,-111.7899933,33.35302353
228,"GLADSTONE MO",8,7,2,2,3,7,-94.55509186,39.20398331
228,"GLASGOW KY",8,2,2,0,0,2,-85.91189575,36.99584961
228,"GLASGOW MO",8,1,0,1,0,1,-92.84679413,39.22732925
228,"GLEN ROCK NJ",8,1,0,0,1,1,-74.13186646,40.96286011
228,"GLEN ROCK PA",8,1,1,0,0,1,-76.7299118,39.79356384
228,"GLENDALE AZ",8,5,2,0,3,5,-112.1871796,33.5386467
228,"GLENDALE CA",8,63,13,12,38,63,-118.2566681,34.1423645
228,"GLENNVILLE GA",8,3,1,1,1,3,-81.92810822,31.93696594
228,"GLOUCESTER CITY NJ",8,3,0,0,3,3,-75.11563873,39.89209747
228,"GODFREY IL",8,2,1,1,0,2,-90.18669891,38.95780182
228,"GOLDEN CO",8,1,0,0,1,1,-105.2226791,39.75567627
228,"GOLDEN VALLEY MN",8,8,5,1,2,8,-93.33234406,44.98583603
228,"GOLDSBORO NC",8,1,1,0,0,1,-77.99216461,35.38506317
228,"GONZALES LA",8,2,0,0,2,2,-90.92044067,30.23900986
228,"GOODRICH TX",8,5,2,1,2,5,-94.9467926,30.60574341
228,"GOOSE CREEK SC",8,3,2,1,0,3,-80.03201294,32.98114395
228,"GOSHEN IN",8,1,1,0,0,1,-85.8345871,41.58250046
228,"GOWER MO",8,1,1,0,0,1,-94.60014343,39.61081314
228,"GRAMBLING LA",8,2,1,0,1,2,-92.71523285,32.52869415
228,"GRAND BLANC MI",8,1,1,0,0,1,-83.62955475,42.92750168
228,"GRAND FORKS ND",8,7,1,2,4,7,-97.03855133,47.92044067
228,"GRAND ISLAND NE",8,2,0,1,1,2,-98.34256744,40.92502213
228,"GRAND JUNCTION CO",8,1,0,0,1,1,-108.5520706,39.06374741
228,"GRAND MARAIS MN",8,2,0,1,1,2,-90.33486176,47.75009918
228,"GRAND PRAIRIE TX",8,3,0,0,3,3,-96.99823761,32.74625015
228,"GRAND RAPIDS MI",8,46,13,9,24,46,-85.66797638,42.96317291
228,"GRANDVIEW MO",8,1,0,1,0,1,-94.53369904,38.88563538
228,"GRANITE CITY IL",8,87,29,17,41,87,-90.14891815,38.70147705
228,"GRANTS PASS OR",8,4,1,1,2,4,-123.3306351,42.43851471
228,"GRAPEVINE TX",8,18,4,5,9,18,-97.07859802,32.93464279
228,"GRAY COURT SC",8,2,0,1,1,2,-82.11286926,34.60851669
228,"GRAYSON KY",8,1,0,1,0,1,-82.94855499,38.33277512
228,"GREAT BEND KS",8,1,0,0,1,1,-98.76521301,38.36428452
228,"GREAT FALLS MT",8,1,0,1,0,1,-111.2823257,47.50692368
228,"GREECE NY",8,1,0,1,0,1,-77.69234467,43.21003342
228,"GREELEY CO",8,2,1,0,1,2,-104.7104645,40.42345047
228,"GREEN BAY WI",8,21,6,4,11,21,-88.01370239,44.51335907
228,"GREENBELT MD",8,15,9,4,2,15,-76.87561035,39.00544357
228,"GREENEVILLE TN",8,2,1,1,0,2,-82.83133698,36.16376495
228,"GREENFIELD IN",8,1,0,0,1,1,-85.76914978,39.78491974
228,"GREENSBORO NC",8,89,22,24,43,89,-79.79152679,36.0729599
228,"GREENVILLE MS",8,3,1,1,1,3,-91.05704498,33.40253448
228,"GREENVILLE NC",8,11,3,5,3,11,-77.37215424,35.61170959
228,"GREENVILLE PA",8,2,0,0,2,2,-80.39095306,41.40464401
228,"GREENVILLE SC",8,39,8,17,14,39,-82.39870453,34.84753418
228,"GREENWICH CT",8,6,1,1,4,6,-73.62783051,41.02645111
228,"GREENWOOD IN",8,5,1,3,1,5,-86.10647583,39.61371994
228,"GREENWOOD WI",8,2,2,0,0,2,-90.59983063,44.77019882
228,"GREER SC",8,2,0,1,1,2,-82.22647095,34.9389267
228,"GRESHAM OR",8,4,1,1,2,4,-122.4333954,45.4980278
228,"GRETNA NE",8,1,0,1,0,1,-96.24054718,41.14088058
228,"GRINNELL IA",8,3,1,1,1,3,-92.72964478,41.7466507
228,"GROSSE POINTE PARK MI",8,1,0,0,1,1,-82.93411255,42.37599182
228,"GROSSE POINTE WOODS MI",8,1,0,0,1,1,-82.90637207,42.4438858
228,"GROTON CT",8,5,1,2,2,5,-72.07763672,41.3502121
228,"GROTON NY",8,3,0,3,0,3,-76.36643982,42.58802032
228,"GULF BREEZE FL",8,2,1,1,0,2,-87.16386414,30.35763931
228,"GULF SHORES AL",8,3,1,2,0,3,-87.70103455,30.24625969
228,"GULFPORT FL",8,2,0,1,1,2,-82.70953369,27.74733734
228,"GULFPORT MS",8,12,1,3,8,12,-89.09369659,30.37276649
228,"GUNTERSVILLE AL",8,1,0,0,1,1,-86.29457855,34.3585434
228,"GUNTOWN MS",8,1,0,1,0,1,-88.66011047,34.44345093
228,"GUSTINE CA",8,5,3,1,1,5,-121.001297,37.25769043
228,"GYPSUM CO",8,5,1,2,2,5,-106.9528198,39.64703369
228,"HACKENSACK NJ",8,1,0,0,1,1,-74.04291534,40.88635254
228,"HADDONFIELD NJ",8,63,22,17,24,63,-75.03710937,39.89155197
228,"HAGERSTOWN MD",8,3,1,1,1,3,-77.71956635,39.641819
228,"HAINESVILLE IL",8,1,1,0,0,1,-88.06796265,42.34496307
228,"HALF MOON BAY CA",8,2,1,0,1,2,-122.4299774,37.46336365
228,"HALLSTEAD PA",8,16,8,5,3,16,-75.74239349,41.96153259
228,"HALLSVILLE MO",8,1,0,0,1,1,-92.22124481,39.11693573
228,"HALTOM CITY TX",8,1,0,1,0,1,-97.26971436,32.79956055
228,"HAMBURG NY",8,1,0,1,0,1,-78.82896423,42.71609879
228,"HAMDEN CT",8,6,2,1,3,6,-72.89596558,41.39611816
228,"HAMILTON OH",8,3,3,0,0,3,-84.56098175,39.39949799
228,"HAMMOND IN",8,2,1,0,1,2,-87.50006104,41.58346558
228,"HAMMOND LA",8,4,1,0,3,4,-90.46140289,30.50458908
228,"HAMPTON VA",8,11,5,0,6,11,-76.34473419,37.03002548
228,"HANOVER NH",8,1,1,0,0,1,-72.28845215,43.70233917
228,"HARBOR SPRINGS MI",8,2,1,1,0,2,-84.99181366,45.43172455
228,"HARKER HEIGHTS TX",8,1,1,0,0,1,-97.66394806,31.08788109
228,"HARLINGEN TX",8,4,1,2,1,4,-97.69669342,26.19152069
228,"HARRAH OK",8,1,1,0,0,1,-97.1640625,35.48944855
228,"HARRIMAN TN",8,1,0,1,0,1,-84.55221558,35.93426514
228,"HARRISBURG PA",8,32,8,8,16,32,-76.88382721,40.27407455
228,"HARRISON OH",8,1,0,1,0,1,-84.81867981,39.26198959
228,"HARRISONBURG VA",8,21,5,8,8,21,-78.86815643,38.44975281
228,"HARRISONVILLE MO",8,1,1,0,0,1,-94.34924316,38.65325928
228,"HARTFORD CT",8,40,10,11,19,40,-72.68445587,41.76383591
228,"HARTFORD IA",8,1,0,1,0,1,-93.40566254,41.45930862
228,"HARTSVILLE SC",8,29,17,4,8,29,-80.07303619,34.37445068
228,"HASTINGS-ON-HUDSON NY",8,1,1,0,0,1,-73.87804413,41.00286102
228,"HASTINGS MN",8,2,1,1,0,2,-92.85280609,44.7434082
228,"HATTIESBURG MS",8,1,0,0,1,1,-89.29040527,31.32738686
228,"HAW RIVER NC",8,1,0,1,0,1,-79.36388397,36.09186172
228,"HAWTHORNE CA",8,2,0,1,1,2,-118.3549194,33.91656113
228,"HAYDEN ID",8,1,1,0,0,1,-116.7890625,47.76594925
228,"HAYS KS",8,1,0,0,1,1,-99.32746887,38.87940598
228,"HAYWARD CA",8,15,4,3,8,15,-122.0832672,37.66890335
228,"HAZELWOOD MO",8,4,2,0,2,4,-90.37133789,38.77171707
228,"HAZLET NJ",8,1,1,0,0,1,-74.19022369,40.41601563
228,"HEALDSBURG CA",8,1,1,0,0,1,-122.8713226,38.6101799
228,"HEARNE TX",8,1,0,0,1,1,-96.59375763,30.87876701
228,"HEBRON IN",8,1,0,0,1,1,-87.20029449,41.31857681
228,"HELENA MT",8,3,1,0,2,3,-112.0374527,46.59269333
228,"HELOTES TX",8,3,0,2,1,3,-98.69043732,29.57864761
228,"HEMPSTEAD NY",8,3,1,1,1,3,-73.61798096,40.70619965
228,"HENDERSON KY",8,1,0,1,0,1,-87.58986664,37.8363266
228,"HENDERSON NV",8,15,3,6,6,15,-114.9741058,36.03540421
228,"HENDERSONVILLE NC",8,8,4,1,3,8,-82.46079254,35.31912994
228,"HENDERSONVILLE TN",8,1,1,0,0,1,-86.61997986,36.30472565
228,"HERCULES CA",8,1,0,0,1,1,-122.2900772,38.01711655
228,"HERMANN MO",8,20,7,7,6,20,-91.43791199,38.70432281
228,"HERMOSA BEACH CA",8,11,2,2,7,11,-118.401619,33.86245728
228,"HERNANDO MS",8,3,0,2,1,3,-89.99411774,34.82405853
228,"HERNDON VA",8,1,1,0,0,1,-77.38563538,38.96995544
228,"HESPERIA CA",8,1,0,0,1,1,-117.3026352,34.42634964
228,"HIALEAH FL",8,1,0,1,0,1,-80.27757263,25.85853386
228,"HICKORY NC",8,1,0,0,1,1,-81.34054565,35.72800827
228,"HIGH POINT NC",8,2,0,2,0,2,-80.00497437,35.95609665
228,"HIGHLAND CA",8,4,1,1,2,4,-117.2105789,34.12824631
228,"HIGHLAND IL",8,1,0,0,1,1,-89.6713562,38.73976135
228,"HIGHLAND PARK IL",8,1,0,0,1,1,-87.80068207,42.18181992
228,"HIGHLAND PARK NJ",8,4,0,3,1,4,-74.4232254,40.49617386
228,"HIGHLAND PARK TX",8,1,0,0,1,1,-96.80493164,32.8320961
228,"HILLIARD OH",8,2,0,1,1,2,-83.15856171,40.03361511
228,"HILLSBORO IL",8,4,1,2,1,4,-89.4937439,39.16139603
228,"HILLSBORO OH",8,1,0,1,0,1,-83.61119843,39.20261765
228,"HILLSBORO OR",8,32,9,9,14,32,-122.9927826,45.52270508
228,"HILLSDALE MI",8,2,0,1,1,2,-84.63027191,41.91994095
228,"HILLSIDE NJ",8,1,1,0,0,1,-74.22960663,40.70137024
228,"HILTON HEAD ISLAND SC",8,1,0,0,1,1,-80.75251007,32.21665573
228,"HILTON NY",8,1,0,1,0,1,-77.79302979,43.28840256
228,"HOBOKEN NJ",8,6,1,5,0,6,-74.0316925,40.7443428
228,"HOLCOMB KS",8,1,0,0,1,1,-100.9902344,37.98623276
228,"HOLLAND MI",8,1,0,0,1,1,-86.10916138,42.78744507
228,"HOLLY SPRINGS NC",8,3,1,2,0,3,-78.83320618,35.65140915
228,"HOLLYWOOD FL",8,17,3,5,9,17,-80.14926147,26.01175499
228,"HOLTON KS",8,1,0,0,1,1,-95.73680115,39.46525955
228,"HOLYOKE MA",8,4,0,1,3,4,-72.61522675,42.20437241
228,"HOMESTEAD FL",8,2,0,1,1,2,-80.47710419,25.46927071
228,"HOMEWOOD AL",8,2,0,1,1,2,-86.80097961,33.47186661
228,"HOPKINSVILLE KY",8,1,1,0,0,1,-87.48854828,36.86588287
228,"HORN LAKE MS",8,1,0,1,0,1,-90.03000641,34.96072769
228,"HOT SPRINGS AR",8,11,5,2,4,11,-93.05556488,34.5039978
228,"HOUGHTON MI",8,1,0,0,1,1,-88.56951141,47.12665558
228,"HOUMA LA",8,3,1,2,0,3,-90.71982574,29.59630585
228,"HOUSTON MS",8,2,0,1,1,2,-88.99927521,33.89876556
228,"HOUSTON TX",8,1204,399,337,468,1204,-95.36399841,29.76376343
228,"HOWELL MI",8,1,0,0,1,1,-83.92946625,42.6072464
228,"HUDSON NY",8,3,0,0,3,3,-73.7900238,42.25299454
228,"HUDSON OH",8,1,0,1,0,1,-81.44026947,41.2401619
228,"HUDSON WI",8,1,1,0,0,1,-92.75721741,44.97438431
228,"HUMBLE TX",8,6,3,2,1,6,-95.26166534,29.99774551
228,"HUNKER PA",8,1,0,0,1,1,-79.62033844,40.20419312
228,"HUNTERSVILLE NC",8,3,1,2,0,3,-80.83785248,35.41359711
228,"HUNTINGDON PA",8,1,0,1,0,1,-78.00988007,40.48491669
228,"HUNTINGTON BEACH CA",8,9,1,1,7,9,-118.0006027,33.66012955
228,"HUNTINGTON IN",8,1,0,1,0,1,-85.49169159,40.87822342
228,"HUNTINGTON NY",8,1,0,0,1,1,-73.42463684,40.86833191
228,"HUNTINGTON WV",8,12,4,2,6,12,-82.44620514,38.4181366
228,"HUNTSVILLE AL",8,91,28,31,32,91,-86.58609772,34.73073959
228,"HUNTSVILLE TX",8,6,2,2,2,6,-95.55122375,30.72374153
228,"HURRICANE UT",8,1,0,1,0,1,-113.2914887,37.17508316
228,"HURST TX",8,1,1,0,0,1,-97.17115021,32.82357407
228,"HUTCHINSON KS",8,2,1,0,1,2,-97.93050385,38.06093216
228,"HUTTO TX",8,1,0,1,0,1,-97.54733276,30.54326057
228,"HYATTSVILLE MD",8,15,5,2,8,15,-76.94467163,38.95636749
228,"IDA LA",8,1,0,1,0,1,-93.89510345,33.00457001
228,"IDAHO FALLS ID",8,4,1,1,2,4,-112.035408,43.46630478
228,"IMPERIAL CA",8,14,7,2,5,14,-115.5716705,32.84782791
228,"INDEPENDENCE KY",8,1,0,1,0,1,-84.54380035,38.94332886
228,"INDEPENDENCE MO",8,18,4,6,8,18,-94.41611481,39.09104538
228,"INDIANA PA",8,2,2,0,0,2,-79.15187073,40.6216507
228,"INDIANAPOLIS IN",8,382,149,97,136,382,-86.15828705,39.76844788
228,"INDIO CA",8,14,4,4,6,14,-116.2173004,33.72047043
228,"INGLEWOOD CA",8,27,9,6,12,27,-118.354805,33.96157074
228,"INMAN SC",8,2,0,1,1,2,-82.09005737,35.04743958
228,"IOWA CITY IA",8,29,12,10,7,29,-91.53023529,41.66130066
228,"IPSWICH MA",8,1,0,0,1,1,-70.84001923,42.67964554
228,"IRONDEQUOIT NY",8,1,0,0,1,1,-77.57932281,43.21369171
228,"IRONTON OH",8,2,0,1,1,2,-82.68261719,38.53668976
228,"IRVINE CA",8,27,12,7,8,27,-117.8243942,33.66952515
228,"IRVING TX",8,9,1,4,4,9,-96.94924927,32.81419754
228,"ISSAQUAH WA",8,2,0,0,2,2,-122.0345993,47.52977753
228,"ITHACA NY",8,34,6,13,15,34,-76.49575043,42.44075775
228,"IVINS UT",8,1,0,1,0,1,-113.6812897,37.16847992
228,"JACKSON AL",8,1,0,0,1,1,-87.89234924,31.51841354
228,"JACKSON MI",8,2,1,0,1,2,-84.40149689,42.24575043
228,"JACKSON MO",8,1,0,1,0,1,-89.66656494,37.38225174
228,"JACKSON MS",8,133,52,25,56,133,-90.19654846,32.298172
228,"JACKSON TN",8,28,11,8,9,28,-88.81397247,35.61472321
228,"JACKSON WY",8,4,0,2,2,4,-110.7644806,43.4798851
228,"JACKSONVILLE AL",8,1,0,0,1,1,-85.76148987,33.81370163
228,"JACKSONVILLE AR",8,3,1,2,0,3,-92.11023712,34.86617279
228,"JACKSONVILLE BEACH FL",8,29,8,11,10,29,-81.39300537,30.29505539
228,"JACKSONVILLE FL",8,222,62,73,87,222,-81.65545654,30.33253288
228,"JACKSONVILLE OR",8,1,0,1,0,1,-122.9693222,42.31318283
228,"JANESVILLE WI",8,10,2,3,5,10,-89.01893616,42.68303299
228,"JEFFERSON CITY MO",8,38,17,10,11,38,-92.17385864,38.57698441
228,"JEFFERSONVILLE IN",8,1,1,0,0,1,-85.73719788,38.27765656
228,"JENNINGS MO",8,1,0,0,1,1,-90.26077271,38.71944046
228,"JEROME AZ",8,1,1,0,0,1,-112.1151428,34.74900055
228,"JERSEY CITY NJ",8,81,21,17,43,81,-74.07667542,40.72816849
228,"JERSEYVILLE IL",8,3,2,1,0,3,-90.32881165,39.12010956
228,"JIM THORPE PA",8,1,1,0,0,1,-75.73157501,40.87605667
228,"JOHNSON CITY TN",8,8,2,2,4,8,-82.35308075,36.31352615
228,"JOLIET IL",8,61,15,18,28,61,-88.08213043,41.52493668
228,"JONESBORO AR",8,4,3,0,1,4,-90.70430756,35.84226608
228,"JOPLIN MO",8,18,7,4,7,18,-94.5140686,37.08442688
228,"JUPITER FL",8,6,2,2,2,6,-80.09382629,26.9349556
228,"KALAMAZOO MI",8,100,31,27,42,100,-85.58725739,42.29179764
228,"KANKAKEE IL",8,1,0,1,0,1,-87.86149597,41.12018204
228,"KANNAPOLIS NC",8,1,0,0,1,1,-80.62119293,35.48755264
228,"KANSAS CITY KS",8,3,1,2,0,3,-94.62808228,39.1141777
228,"KANSAS CITY MO",8,593,188,160,245,593,-94.57884979,39.09976578
228,"KATY TX",8,6,4,2,0,6,-95.82484436,29.78606224
228,"KEARNEY NE",8,3,1,2,0,3,-99.08208466,40.69932938
228,"KEARNY NJ",8,1,0,1,0,1,-74.14439392,40.76873398
228,"KEENE NH",8,1,0,1,0,1,-72.27714539,42.93392563
228,"KEIZER OR",8,1,1,0,0,1,-123.0285339,44.98967743
228,"KELLER TX",8,3,2,1,0,3,-97.25247192,32.93486786
228,"KENDALLVILLE IN",8,1,1,0,0,1,-85.27036285,41.44488525
228,"KENLY NC",8,1,1,0,0,1,-78.12352753,35.59648514
228,"KENMORE NY",8,2,2,0,0,2,-78.86985779,42.96615982
228,"KENMORE WA",8,1,0,1,0,1,-122.2464905,47.7568779
228,"KENNER LA",8,2,1,1,0,2,-90.24167633,29.99442101
228,"KENNESAW GA",8,6,3,2,1,6,-84.61528015,34.02365875
228,"KENNEWICK WA",8,2,0,1,1,2,-119.1395264,46.2107811
228,"KENOSHA WI",8,1,0,0,1,1,-87.82134247,42.58494949
228,"KENSINGTON MD",8,1,1,0,0,1,-77.07564545,39.02577972
228,"KENT OH",8,6,1,4,1,6,-81.35736084,41.15368271
228,"KENT WA",8,92,19,22,51,92,-122.2377701,47.38068008
228,"KETTERING OH",8,5,2,1,2,5,-84.1687088,39.68964005
228,"KEY WEST FL",8,22,2,4,16,22,-81.78218079,24.556427
228,"KEYSTONE HEIGHTS FL",8,1,0,0,1,1,-82.03114319,29.78640366
228,"KILL DEVIL HILLS NC",8,1,0,0,1,1,-75.6541214,36.01398468
228,"KILLEEN TX",8,7,1,1,5,7,-97.72832489,31.11753464
228,"KIMBERLING CITY MO",8,1,1,0,0,1,-93.41742706,36.63339233
228,"KINGSPORT TN",8,37,8,7,22,37,-82.56182861,36.54841232
228,"KINGSTON GA",8,4,1,1,2,4,-84.94379425,34.23725891
228,"KINGSTON NY",8,5,3,0,2,5,-73.99665833,41.92714691
228,"KINSTON NC",8,1,0,0,1,1,-77.58128357,35.26295471
228,"KIRKLAND WA",8,37,9,6,22,37,-122.2108688,47.6813736
228,"KIRKSVILLE MO",8,4,3,1,0,4,-92.58364105,40.19476318
228,"KIRKWOOD MO",8,3,1,0,2,3,-90.40686798,38.5832901
228,"KISSIMMEE FL",8,9,4,2,3,9,-81.40729523,28.29271317
228,"KITTY HAWK NC",8,2,0,2,0,2,-75.70478058,36.06485367
228,"KLAMATH FALLS OR",8,3,0,0,3,3,-121.7844772,42.2244873
228,"KNIGHTDALE NC",8,2,0,0,2,2,-78.48007202,35.78808975
228,"KNOX PA",8,1,1,0,0,1,-79.53708649,41.23451996
228,"KNOXVILLE TN",8,52,12,13,27,52,-83.92067719,35.96077728
228,"KOKOMO IN",8,3,1,1,1,3,-86.12706757,40.48566818
228,"KUTZTOWN PA",8,3,0,1,2,3,-75.77677917,40.51739502
228,"KYLE TX",8,3,1,1,1,3,-97.87797546,29.9895649
228,"LA CROSSE WI",8,14,4,4,6,14,-91.23967743,43.80151367
228,"LA GRANDE OR",8,13,8,2,3,13,-118.090126,45.32435989
228,"LA HABRA CA",8,1,1,0,0,1,-117.9494629,33.93001556
228,"LA VERGNE TN",8,1,0,1,0,1,-86.58178711,36.01600266
228,"LA VERNE CA",8,3,0,1,2,3,-117.7696304,34.1006546
228,"LACEY WA",8,2,1,0,1,2,-122.8096161,47.03732681
228,"LACONIA NH",8,2,0,0,1,1,-71.46888733,43.52740097
228,"LADY LAKE FL",8,4,2,1,1,4,-81.92842865,28.92837715
228,"LAFAYETTE CA",8,1,1,0,0,1,-122.1200104,37.88574982
228,"LAFAYETTE CO",8,3,1,1,1,3,-105.0904388,39.99370956
228,"LAFAYETTE IN",8,9,2,3,4,9,-86.88406372,40.42077255
228,"LAFAYETTE LA",8,44,13,15,16,44,-92.01987457,30.22468185
228,"LAGUNA BEACH CA",8,5,4,0,1,5,-117.7847061,33.54205322
228,"LAKE CHARLES LA",8,2,0,1,1,2,-93.21766663,30.22713852
228,"LAKE CITY SC",8,1,0,1,0,1,-79.75487518,33.87107086
228,"LAKE GENEVA WI",8,4,2,1,1,4,-88.43348694,42.59184265
228,"LAKE HAVASU CITY AZ",8,1,1,0,0,1,-114.3244324,34.48379517
228,"LAKE JACKSON TX",8,1,0,0,1,1,-95.43475342,29.03430176
228,"LAKE MARY FL",8,1,0,0,1,1,-81.31755829,28.75924492
228,"LAKE STEVENS WA",8,1,0,0,1,1,-122.0684662,48.01782227
228,"LAKE WALES FL",8,2,1,1,0,2,-81.58531189,27.90217018
228,"LAKELAND FL",8,15,5,5,5,15,-81.95620728,28.04432487
228,"LAKEWOOD CA",8,1,0,0,1,1,-118.1357193,33.85370636
228,"LAKEWOOD CO",8,1,0,0,1,1,-105.0827332,39.70486069
228,"LAKEWOOD OH",8,17,4,7,6,17,-81.79773712,41.48223114
228,"LAKEWOOD WA",8,8,1,3,0,4,-122.3653679,47.661533355
228,"LAMAR CO",8,1,0,1,0,1,-102.6111527,38.08679581
228,"LANCASTER CA",8,8,1,2,5,8,-118.1386871,34.69804001
228,"LANCASTER NY",8,1,0,0,1,1,-78.67009735,42.90063477
228,"LANCASTER PA",8,42,8,13,21,42,-76.30498505,40.03824234
228,"LANCASTER TX",8,1,0,0,1,1,-96.75682831,32.59244156
228,"LANDER WY",8,1,0,0,1,1,-108.7319489,42.83276749
228,"LANGLEY WA",8,6,3,2,1,6,-122.4162674,48.03789139
228,"LANSDALE PA",8,1,1,0,0,1,-75.28330994,40.24167633
228,"LANSDOWNE PA",8,18,5,4,9,18,-75.27108765,39.93852234
228,"LANSING IL",8,2,0,0,2,2,-87.5393219,41.56502151
228,"LANSING MI",8,22,6,5,11,22,-84.55532074,42.73265839
228,"LAPEER MI",8,3,1,1,1,3,-83.31890869,43.05135345
228,"LARAMIE WY",8,3,0,1,2,3,-105.592804,41.3115387
228,"LAREDO TX",8,3,1,1,1,3,-99.50824738,27.50720978
228,"LARGO FL",8,22,7,7,8,22,-82.78675079,27.91026115
228,"LAS CRUCES NM",8,2,0,2,0,2,-106.7798538,32.31209564
228,"LAS VEGAS NV",8,472,155,146,171,472,-115.1382141,36.17488098
228,"LAUDERDALE LAKES FL",8,1,1,0,0,1,-80.20793915,26.1671524
228,"LAUREL MS",8,1,0,0,1,1,-89.13054657,31.69452286
228,"LAUREL MT",8,1,0,0,1,1,-108.7678986,45.67721939
228,"LAVONIA GA",8,1,0,1,0,1,-83.10657501,34.4361496
228,"LAWRENCE KS",8,88,36,27,25,88,-95.23565674,38.97153091
228,"LAWRENCE MA",8,6,3,1,2,6,-71.15792084,42.70630646
228,"LAWRENCEVILLE GA",8,1,1,0,0,1,-83.98753357,33.95662308
228,"LAWTON OK",8,6,3,1,2,6,-98.39124298,34.60861969
228,"LAYTON UT",8,3,0,2,1,3,-111.9724808,41.06021118
228,"LEAGUE CITY TX",8,8,3,3,2,8,-95.09550476,29.50793457
228,"LEAWOOD KS",8,4,1,3,0,4,-94.61756897,38.96688461
228,"LEBANON PA",8,1,0,1,0,1,-76.41091156,40.34118652
228,"LEBANON TN",8,1,0,1,0,1,-86.29133606,36.20846939
228,"LEESBURG FL",8,5,2,3,0,5,-81.87727356,28.81123161
228,"LEESBURG VA",8,3,0,2,1,3,-77.56890869,39.11256027
228,"LEESPORT PA",8,1,0,1,0,1,-75.96580505,40.44723892
228,"LELAND NC",8,2,0,2,0,2,-78.04415131,34.25672913
228,"LENEXA KS",8,3,0,0,3,3,-94.73374176,38.95368576
228,"LENOIR NC",8,1,0,1,0,1,-81.53869629,35.91436386
228,"LESLIE MO",8,1,1,0,0,1,-91.23233795,38.41774368
228,"LEWES DE",8,3,0,2,1,3,-75.1359024,38.77365494
228,"LEWISVILLE TX",8,18,6,3,9,18,-96.99449921,33.04630661
228,"LEXINGTON MA",8,1,0,0,1,1,-71.22381592,42.44742584
228,"LEXINGTON MO",8,4,1,2,1,4,-93.88013458,39.18475342
228,"LEXINGTON MS",8,1,1,0,0,1,-90.05338287,33.11347961
228,"LEXINGTON SC",8,5,1,1,3,5,-81.23597717,33.98204041
228,"LEXINGTON VA",8,1,0,1,0,1,-79.4422226,37.78420639
228,"LIBBY MT",8,4,1,0,3,4,-115.5511856,48.38265991
228,"LIBERAL MO",8,5,0,1,4,5,-94.52056122,37.55810547
228,"LIBERTY MO",8,6,2,0,4,6,-94.4196167,39.24604034
228,"LIBERTY MS",8,3,3,0,0,3,-90.81230927,31.15865898
228,"LILBURN GA",8,3,1,1,1,3,-84.14273834,33.89017868
228,"LILLINGTON NC",8,1,1,0,0,1,-78.81506348,35.39981079
228,"LINCOLN CA",8,4,0,3,1,4,-121.2951202,38.89149475
228,"LINCOLN NE",8,24,10,8,6,24,-96.6674118,40.80001068
228,"LINDALE TX",8,2,0,0,2,2,-95.40984344,32.51585007
228,"LINDEN NJ",8,1,0,1,0,1,-74.24382782,40.62202454
228,"LITTLE ROCK AR",8,206,65,53,88,206,-92.28178406,34.7369194
228,"LITTLETON CO",8,3,1,1,1,3,-105.0176163,39.6132431
228,"LIVE OAK FL",8,1,0,1,0,1,-82.98397064,30.29559708
228,"LIVERMORE CA",8,2,0,2,0,2,-121.7701416,37.68147659
228,"LIVINGSTON NJ",8,1,0,1,0,1,-74.31424713,40.79631042
228,"LIVONIA MI",8,1,0,0,1,1,-83.35256958,42.36862564
228,"LOCKPORT NY",8,1,1,0,0,1,-78.69011688,43.17089081
228,"LODI CA",8,7,2,3,2,7,-121.2742386,38.12984467
228,"LOGAN UT",8,5,2,1,2,5,-111.8171616,41.73900604
228,"LOGANSPORT IN",8,3,2,0,1,3,-86.36410522,40.75329208
228,"LOGANVILLE GA",8,6,1,0,5,6,-83.90035248,33.83914948
228,"LOMBARD IL",8,2,0,0,2,2,-88.00775909,41.8800621
228,"LOMIRA WI",8,1,0,0,1,1,-88.44380188,43.59117126
228,"LOMITA CA",8,3,1,1,1,3,-118.3169556,33.79204941
228,"LONG BEACH CA",8,59,16,21,22,59,-118.1908112,33.7670517
228,"LONG BEACH NY",8,3,0,0,3,3,-73.6654129,40.58349991
228,"LONG BRANCH NJ",8,1,0,0,1,1,-73.991745,40.30428314
228,"LONGMONT CO",8,9,2,2,5,9,-105.1026764,40.16700745
228,"LONGVIEW TX",8,12,1,5,6,12,-94.73707581,32.4966507
228,"LONGVIEW WA",8,2,0,2,0,2,-122.9404221,46.1375885
228,"LONSDALE AR",8,1,0,0,1,1,-92.80835724,34.54459763
228,"LORAIN OH",8,2,1,0,1,2,-82.17118073,41.45874023
228,"LOS ALTOS CA",8,3,0,0,3,3,-122.1163025,37.38525772
228,"LOS ANGELES CA",8,2141,642,624,875,2141,-118.2459106,34.05225754
228,"LOUISA KY",8,2,0,1,1,2,-82.60322571,38.11429596
228,"LOUISA VA",8,1,0,0,1,1,-78.00349426,38.0253067
228,"LOUISBURG KS",8,4,1,1,2,4,-94.68140411,38.61960602
228,"LOUISVILLE CO",8,1,0,0,1,1,-105.1326523,39.97768402
228,"LOVELADY TX",8,1,1,0,0,1,-95.44617462,31.12744713
228,"LOVELAND CO",8,5,2,1,2,5,-105.0755997,40.39763641
228,"LOVELAND OH",8,1,0,1,0,1,-84.25993347,39.26356506
228,"LOWELL IN",8,1,0,0,1,1,-87.42073059,41.29130173
228,"LOWELL MA",8,7,2,0,5,7,-71.31530762,42.63344574
228,"LUBBOCK TX",8,12,5,2,5,12,-101.8544312,33.59677505
228,"LUCEDALE MS",8,11,3,1,7,11,-88.59013367,30.92567635
228,"LUMBERTON NC",8,1,0,1,0,1,-79.00803375,34.61832428
228,"LUMBERTON TX",8,1,1,0,0,1,-94.19047546,30.25369263
228,"LURAY VA",8,1,0,0,1,1,-78.45899963,38.66542816
228,"LYNCHBURG VA",8,1,0,1,0,1,-79.14174652,37.41383362
228,"LYNDEN WA",8,2,0,1,1,2,-122.455101,48.94639969
228,"LYNN MA",8,1,0,1,0,1,-70.94833374,42.46699905
228,"LYNNWOOD WA",8,3,1,1,1,3,-122.3175736,47.82042313
228,"LYNWOOD CA",8,7,1,2,4,7,-118.2135544,33.93053055
228,"LYONS CO",8,1,1,0,0,1,-105.272377,40.22478485
228,"MACKINAW IL",8,1,0,0,1,1,-89.35753632,40.53728104
228,"MACOMB IL",8,1,0,0,1,1,-90.67189026,40.45938873
228,"MADELIA MN",8,4,0,2,2,4,-94.42191315,44.05470276
228,"MADERA CA",8,3,2,0,1,3,-120.0627594,36.96101379
228,"MADISON AL",8,12,1,1,4,6,-86.487213135,33.561834335
228,"MADISON CT",8,2,1,0,1,2,-72.59211731,41.28052902
228,"MADISON IL",8,1,0,1,0,1,-90.15700531,38.68284988
228,"MADISON MS",8,1,1,0,0,1,-90.11543274,32.46231079
228,"MADISON NC",8,1,0,0,1,1,-79.95928192,36.38565063
228,"MADISON NJ",8,2,0,2,0,2,-74.41627502,40.76013184
228,"MADISON WI",8,110,46,23,41,110,-89.40128326,43.07303619
228,"MAGNOLIA TX",8,1,1,0,0,1,-95.75150299,30.20981598
228,"MAHOMET IL",8,1,0,1,0,1,-88.40461731,40.19519806
228,"MAHWAH NJ",8,1,0,1,0,1,-74.14279175,41.08900452
228,"MAIZE KS",8,1,0,0,1,1,-97.46515656,37.77322006
228,"MALDEN MA",8,2,0,1,1,2,-71.06546783,42.42518234
228,"MALDEN MO",8,3,2,0,1,3,-89.96641541,36.55708313
228,"MAMARONECK NY",8,1,0,0,1,1,-73.73201752,40.94874191
228,"MANASSAS PARK VA",8,2,1,0,1,2,-77.46895599,38.7841301
228,"MANCHESTER MO",8,3,3,0,0,3,-90.50953674,38.597229
228,"MANCHESTER NH",8,19,7,4,8,19,-71.45406342,42.99581528
228,"MANHATTAN BEACH CA",8,9,3,5,1,9,-118.4129181,33.88484192
228,"MANHATTAN KS",8,8,1,2,5,8,-96.57228851,39.18354034
228,"MANITOU SPRINGS CO",8,3,1,1,1,3,-104.9184494,38.85948944
228,"MANKATO MN",8,11,1,0,10,11,-94.02125549,44.15895462
228,"MANNING SC",8,2,0,1,1,2,-80.21025085,33.69546509
228,"MANSFIELD AR",8,1,0,1,0,1,-94.2530365,35.05989456
228,"MANSFIELD MA",8,1,1,0,0,1,-71.21801758,42.03358078
228,"MANSFIELD TX",8,1,0,0,1,1,-97.14230347,32.56362152
228,"MANTECA CA",8,1,0,0,1,1,-121.2179031,37.79747391
228,"MANTUA NJ",8,1,0,0,1,1,-75.17108917,39.79433823
228,"MANVEL TX",8,1,0,0,1,1,-95.35823822,29.46306229
228,"MAPLE GROVE MN",8,2,0,1,1,2,-93.47679138,45.14711761
228,"MAPLE HEIGHTS OH",8,1,0,0,1,1,-81.5656662,41.41540146
228,"MAPLE SHADE NJ",8,3,1,1,1,3,-74.9913559,39.95294571
228,"MAPLEWOOD MN",8,1,0,1,0,1,-93.05480194,45.01259232
228,"MAPLEWOOD MO",8,9,3,0,6,9,-90.32471466,38.6126976
228,"MAPLEWOOD NJ",8,6,3,1,2,6,-74.27243805,40.77401733
228,"MAQUOKETA IA",8,8,3,2,3,8,-90.66600037,42.06900024
228,"MARCUS IA",8,5,3,0,2,5,-95.8081131,42.82571793
228,"MARFA TX",8,1,1,0,0,1,-104.0205383,30.30808449
228,"MARIANNA FL",8,16,2,5,9,16,-85.22673798,30.77488518
228,"MARICOPA AZ",8,4,1,1,2,4,-112.0491562,33.05832672
228,"MARIETTA GA",8,15,2,6,7,15,-84.54958344,33.9527359
228,"MARION AR",8,3,0,2,1,3,-90.19646454,35.21472931
228,"MARION IL",8,4,1,2,1,4,-88.93344116,37.73056412
228,"MARION KS",8,1,0,1,0,1,-97.018013,38.34838867
228,"MARION SC",8,1,0,1,0,1,-79.40047455,34.18493271
228,"MARKHAM IL",8,4,1,1,2,4,-87.69510651,41.59363937
228,"MARKS MS",8,3,1,1,1,3,-90.27207947,34.25684357
228,"MARLBOROUGH MA",8,1,0,0,1,1,-71.55128479,42.34592819
228,"MARQUETTE MI",8,2,2,0,0,2,-87.39571381,46.54323196
228,"MARS PA",8,1,0,0,1,1,-80.01100159,40.69602585
228,"MARSHALL MI",8,3,0,2,1,3,-84.9631424,42.27227402
228,"MARSHALL MN",8,1,0,1,0,1,-95.78921509,44.4466362
228,"MARSHALL MO",8,2,1,1,0,2,-93.19745636,39.12294769
228,"MARSHALL TX",8,1,0,1,0,1,-94.36775208,32.5450592
228,"MARSHALLTOWN IA",8,2,1,1,0,2,-92.90861511,42.04956055
228,"MARTINSBURG WV",8,4,1,1,2,4,-77.96557617,39.45707703
228,"MARYLAND HEIGHTS MO",8,4,1,0,3,4,-90.43025208,38.71334076
228,"MARYVILLE MO",8,2,0,2,0,2,-94.87281036,40.34609604
228,"MARYVILLE TN",8,1,0,0,1,1,-83.96243286,35.76000977
228,"MASCOUTAH IL",8,3,2,1,0,3,-89.79308319,38.49026489
228,"MASON OH",8,4,1,2,1,4,-84.30989075,39.36032104
228,"MATTHEWS NC",8,1,0,0,1,1,-80.72332001,35.11704254
228,"MAYFLOWER AR",8,1,1,0,0,1,-92.42785645,34.95717239
228,"MAYSVILLE NC",8,1,0,1,0,1,-77.23084259,34.90504074
228,"MCALLEN TX",8,11,3,2,6,11,-98.23077393,26.20433426
228,"MCDONOUGH GA",8,1,0,1,0,1,-84.1467514,33.44765472
228,"MCKINNEY TX",8,8,3,0,5,8,-96.6155777,33.19782257
228,"MCLEANSBORO IL",8,1,0,1,0,1,-88.53587341,38.09341049
228,"MCMINNVILLE OR",8,5,1,2,2,5,-123.2019272,45.20968628
228,"MEBANE NC",8,1,0,1,0,1,-79.26649475,36.09629059
228,"MEDFORD MA",8,4,2,0,2,4,-71.10526276,42.41849518
228,"MEDFORD NJ",8,1,1,0,0,1,-74.82254791,39.90135193
228,"MEDFORD OR",8,16,7,4,5,16,-122.8773193,42.32625961
228,"MEDICAL LAKE WA",8,1,0,1,0,1,-117.682518,47.57226944
228,"MEDINA OH",8,2,1,1,0,2,-81.86336517,41.13858795
228,"MELBOURNE FL",8,9,5,3,1,9,-80.60625458,28.07838249
228,"MEMPHIS TN",8,287,73,88,126,287,-90.01696014,35.1194191
228,"MENA AR",8,4,1,1,2,4,-94.24035645,34.58638
228,"MENLO PARK CA",8,5,2,2,1,5,-122.1842423,37.45361328
228,"MENTOR OH",8,2,0,1,1,2,-81.33918762,41.66637421
228,"MERCED CA",8,1,0,1,0,1,-120.4848785,37.30197525
228,"MERCEDES TX",8,2,0,0,2,2,-97.91394043,26.15032959
228,"MEREDITH NH",8,1,0,0,1,1,-71.50298309,43.65645218
228,"MERIDIAN MS",8,2,0,1,1,2,-88.70374298,32.36473846
228,"MERRILLVILLE IN",8,1,0,1,0,1,-87.33312988,41.48298645
228,"MESA AZ",8,28,10,4,14,28,-111.8239059,33.42222214
228,"MESQUITE NV",8,1,0,0,1,1,-114.0683136,36.80557251
228,"MESQUITE TX",8,19,6,11,2,19,-96.59959412,32.76692581
228,"METCALFE MS",8,1,1,0,0,1,-91.00767517,33.45438385
228,"MEXICO MO",8,3,0,0,3,3,-91.8833313,39.16965866
228,"MIAMI BEACH FL",8,39,17,10,12,39,-80.12982178,25.79146576
228,"MIAMI FL",8,357,121,94,142,357,-80.19329071,25.77483749
228,"MIDDLEBURY VT",8,2,0,2,0,2,-73.16629028,44.01540756
228,"MIDDLETOWN CT",8,1,1,0,0,1,-72.64955902,41.56232071
228,"MIDDLETOWN DE",8,4,2,2,0,4,-75.71700287,39.44935226
228,"MIDDLETOWN PA",8,2,0,0,1,1,-78.1753006,40.230783465
228,"MIDLAND MI",8,2,0,1,1,2,-84.24700928,43.61585236
228,"MIDLAND TX",8,3,3,0,0,3,-102.0793686,31.99754143
228,"MIDWEST CITY OK",8,2,1,1,0,2,-97.39709473,35.44970703
228,"MILAN IL",8,1,1,0,0,1,-90.57264709,41.45294952
228,"MILAN TN",8,1,0,1,0,1,-88.75936127,35.91966248
228,"MILFORD DE",8,1,0,0,1,1,-75.42737579,38.9128685
228,"MILFORD MA",8,3,0,2,1,3,-71.51522064,42.14015198
228,"MILFORD NY",8,5,3,2,0,5,-74.94455719,42.59064865
228,"MILFORD OH",8,1,0,0,1,1,-84.29400635,39.17559433
228,"MILLBROOK AL",8,1,0,1,0,1,-86.36187744,32.48031998
228,"MILLSBORO DE",8,1,0,1,0,1,-75.29344177,38.58910751
228,"MILLSTADT IL",8,1,0,1,0,1,-90.09213257,38.46154404
228,"MILPITAS CA",8,1,0,1,0,1,-121.9090805,37.42808533
228,"MILTON FL",8,3,2,1,0,3,-87.03953552,30.63289833
228,"MILWAUKEE WI",8,230,58,68,104,230,-87.90684509,43.03887939
228,"MILWAUKIE OR",8,1,0,0,1,1,-122.6417084,45.44596481
228,"MINDEN LA",8,117,32,8,77,117,-93.28716278,32.61589432
228,"MINNEAPOLIS MN",8,355,100,119,136,355,-93.26397705,44.97980118
228,"MINNETONKA MN",8,1,1,0,0,1,-93.43367004,44.92795181
228,"MINOT ND",8,1,0,0,1,1,-101.2953949,48.23139572
228,"MINT HILL NC",8,1,0,0,1,1,-80.64685059,35.17968369
228,"MIRAMAR FL",8,3,2,0,1,3,-80.23181915,25.98794746
228,"MISSION KS",8,22,3,13,6,22,-94.65638733,39.02796173
228,"MISSION SD",8,1,0,0,1,1,-100.6579437,43.30659866
228,"MISSION TX",8,8,1,3,4,8,-98.32580566,26.21655273
228,"MISSION VIEJO CA",8,1,0,1,0,1,-117.6737366,33.59992218
228,"MISSOULA MT",8,15,3,5,7,15,-113.9832687,46.87278366
228,"MISSOURI CITY TX",8,9,1,2,6,9,-95.5381012,29.61878204
228,"MOBILE AL",8,26,10,0,16,26,-88.04309845,30.69476128
228,"MOCKSVILLE NC",8,7,1,1,5,7,-80.56092834,35.89443588
228,"MODESTO CA",8,35,13,7,15,35,-120.9991455,37.63897324
228,"MOLINE IL",8,4,1,2,1,4,-90.51522064,41.5069809
228,"MONROE LA",8,24,6,6,12,24,-92.11960602,32.50980759
228,"MONROVIA CA",8,5,1,1,3,5,-118.0006485,34.14796829
228,"MONTCLAIR NJ",8,11,3,6,2,11,-74.20848083,40.82605362
228,"MONTEBELLO CA",8,1,0,0,1,1,-118.1069412,34.00930023
228,"MONTEREY CA",8,4,0,1,3,4,-121.8974838,36.6002388
228,"MONTGOMERY AL",8,17,4,4,9,17,-86.29966736,32.36724472
228,"MONTGOMERY TX",8,1,1,0,0,1,-95.69664001,30.38855171
228,"MONTPELIER VT",8,3,1,1,1,3,-72.57458496,44.26039124
228,"MONTROSE PA",8,1,0,1,0,1,-75.87622833,41.83430481
228,"MOORE OK",8,5,1,3,1,5,-97.48735046,35.33969498
228,"MOORESTOWN NJ",8,2,1,0,1,2,-74.94165039,39.96718597
228,"MOORESVILLE NC",8,5,1,0,4,5,-80.80976868,35.58535004
228,"MOORHEAD MN",8,3,1,0,2,3,-96.76844025,46.87382507
228,"MOORPARK CA",8,1,0,1,0,1,-118.8839111,34.28554535
228,"MOREHEAD CITY NC",8,2,1,1,0,2,-76.72536469,34.72343445
228,"MOREHEAD KY",8,1,0,0,1,1,-83.43223572,38.18409348
228,"MORGANTOWN WV",8,16,7,2,7,16,-79.95038605,39.63131714
228,"MORRILTON AR",8,1,1,0,0,1,-92.74445343,35.15127182
228,"MORRIS MN",8,3,1,1,1,3,-95.91436005,45.58617401
228,"MORRISTOWN NJ",8,2,1,0,1,2,-74.48057556,40.79689789
228,"MORRISTOWN TN",8,2,1,0,1,2,-83.29478455,36.21415329
228,"MORRISVILLE NC",8,2,0,2,0,2,-78.82486725,35.82374954
228,"MORROW GA",8,15,2,6,7,15,-84.33943939,33.58339691
228,"MOSCOW ID",8,13,3,3,7,13,-117.0021973,46.73223877
228,"MOSES LAKE WA",8,2,2,0,0,2,-119.2802811,47.12987137
228,"MOUNDSVILLE WV",8,17,7,3,7,17,-80.74716949,39.92013931
228,"MOUNDVILLE AL",8,2,0,0,2,2,-87.63011169,32.99803162
228,"MOUNT HOLLY NC",8,8,1,3,4,8,-81.0157547,35.29826736
228,"MOUNT PLEASANT SC",8,3,1,1,1,3,-79.86242676,32.79427719
228,"MOUNT PLEASANT TX",8,3,1,2,0,3,-94.96855927,33.15682602
228,"MOUNT POCONO PA",8,1,0,0,1,1,-75.36369324,41.12226868
228,"MOUNT VERNON IA",8,1,1,0,0,1,-91.41739655,41.92199326
228,"MOUNT VERNON IL",8,1,0,0,1,1,-88.90307617,38.31738663
228,"MOUNTAIN HOME ID",8,7,2,4,1,7,-115.6928406,43.13270187
228,"MOUNTAIN VIEW AR",8,1,0,0,1,1,-92.11795807,35.86831665
228,"MOUNTAIN VIEW CA",8,16,4,4,8,16,-122.0861969,37.3859024
228,"MOUNTAIN WI",8,1,1,0,0,1,-88.47368622,45.18442154
228,"MOWEAQUA IL",8,1,0,1,0,1,-89.01890564,39.62461472
228,"MUNCIE IN",8,8,2,3,3,8,-85.38398743,40.18970871
228,"MUNFORDVILLE KY",8,1,0,0,1,1,-85.89085388,37.27248383
228,"MUNHALL PA",8,1,1,0,0,1,-79.89945984,40.39241409
228,"MURFREESBORO TN",8,19,8,2,9,19,-86.39038086,35.84575653
228,"MURPHY NC",8,4,0,2,2,4,-84.03442383,35.08757019
228,"MURRAY KY",8,2,0,1,1,2,-88.31504059,36.61037827
228,"MURRIETA CA",8,2,0,0,2,2,-117.2157898,33.55398941
228,"MUSKEGON MI",8,10,2,0,3,5,-86.25441742,43.23139763
228,"MUSKOGEE OK",8,7,1,3,3,7,-95.36999512,35.74824142
228,"MUSTANG OK",8,1,1,0,0,1,-97.72509766,35.38425446
228,"MYRTLE BEACH SC",8,7,2,0,5,7,-78.88601685,33.69656372
228,"NACOGDOCHES TX",8,5,0,2,3,5,-94.6559906,31.60386467
228,"NAMPA ID",8,2,0,0,2,2,-116.5658188,43.54054642
228,"NAPA CA",8,4,0,1,3,4,-122.2872086,38.29692841
228,"NAPERVILLE IL",8,11,4,3,4,11,-88.14768219,41.78578949
228,"NAPLES FL",8,10,1,5,4,10,-81.79434204,26.14280128
228,"NAPOLEONVILLE LA",8,1,0,0,1,1,-91.02523041,29.9411068
228,"NARBERTH PA",8,2,1,0,1,2,-75.25990295,40.00860596
228,"NASHUA NH",8,4,1,1,2,4,-71.46669769,42.76576996
228,"NATALIA TX",8,1,0,1,0,1,-98.86307526,29.19000626
228,"NATICK MA",8,1,1,0,0,1,-71.3484726,42.2836113
228,"NAUGATUCK CT",8,9,5,3,1,9,-73.04972076,41.4863205
228,"NAVASOTA TX",8,1,1,0,0,1,-96.08838654,30.38853645
228,"NAZARETH PA",8,3,1,2,0,3,-75.30902863,40.74064255
228,"NEDERLAND CO",8,1,1,0,0,1,-105.5114899,39.96115494
228,"NEDERLAND TX",8,3,1,1,1,3,-93.99260712,29.97476387
228,"NEEDHAM MA",8,4,3,0,1,4,-71.21767426,42.27159119
228,"NEENAH WI",8,1,0,1,0,1,-88.4626236,44.18569183
228,"NEW ALBANY IN",8,5,2,1,2,5,-85.80917358,38.29167938
228,"NEW BADEN IL",8,3,1,0,2,3,-89.70088196,38.53531647
228,"NEW BEDFORD MA",8,7,4,0,3,7,-70.93328857,41.63626862
228,"NEW BERN NC",8,3,0,1,2,3,-77.04354095,35.10897827
228,"NEW BRAUNFELS TX",8,3,1,1,1,3,-98.12486267,29.70325089
228,"NEW BRITAIN CT",8,1,0,1,0,1,-72.77884674,41.6615181
228,"NEW CARROLLTON MD",8,6,2,2,2,6,-76.8794632,38.97011185
228,"NEW CASTLE DE",8,14,6,4,4,14,-75.56227875,39.66440964
228,"NEW HARMONY IN",8,1,0,1,0,1,-87.93526459,38.12969589
228,"NEW HAVEN CT",8,62,17,22,23,62,-72.92726898,41.3084259
228,"NEW LONDON CT",8,6,1,2,3,6,-72.09841156,41.35572815
228,"NEW MADRID MO",8,1,0,0,1,1,-89.52796936,36.58650589
228,"NEW ORLEANS LA",8,468,154,137,177,468,-90.07525635,29.95483589
228,"NEW PHILADELPHIA OH",8,1,1,0,0,1,-81.44538879,40.48986053
228,"NEW PORT RICHEY FL",8,5,1,1,3,5,-82.71899414,28.24477577
228,"NEW YORK NY",8,1634,541,470,623,1634,-74.00528717,40.7145195
228,"NEWARK DE",8,54,25,12,17,54,-75.74462128,39.68774414
228,"NEWARK NJ",8,164,46,45,73,164,-74.17185211,40.73570633
228,"NEWARK OH",8,1,0,0,1,1,-82.40110779,40.05843353
228,"NEWBERRY SC",8,1,0,1,0,1,-81.61828613,34.2746582
228,"NEWCASTLE WA",8,1,0,0,1,1,-122.1575165,47.53847504
228,"NEWINGTON CT",8,1,0,1,0,1,-72.72303772,41.69794464
228,"NEWNAN GA",8,3,0,2,1,3,-84.79645538,33.37108231
228,"NEWPORT NEWS VA",8,9,0,1,8,9,-76.42758942,36.97909927
228,"NEWPORT OR",8,1,1,0,0,1,-124.0554047,44.6362915
228,"NEWPORT RI",8,13,4,4,5,13,-71.31213379,41.49024963
228,"NEWTON KS",8,1,0,0,1,1,-97.3455658,38.04684067
228,"NEWTON MA",8,33,7,13,13,33,-71.20809937,42.33743286
228,"NEWTON NC",8,1,0,1,0,1,-81.22117615,35.67030334
228,"NEWTON NJ",8,1,1,0,0,1,-74.7516861,41.0583992
228,"NEWTOWN PA",8,2,0,1,1,2,-74.93606567,40.22966003
228,"NIAGARA FALLS NY",8,9,0,1,8,9,-79.05632019,43.09456253
228,"NIXA MO",8,12,6,3,3,12,-93.29502869,37.04324341
228,"NOBLESVILLE IN",8,5,2,1,2,5,-86.01766205,40.03728104
228,"NOCONA TX",8,5,2,1,2,5,-97.72662354,33.78715515
228,"NOEL MO",8,2,1,0,1,2,-94.4858551,36.54568481
228,"NORCROSS GA",8,4,0,2,2,4,-84.21324158,33.94129181
228,"NORFOLK VA",8,107,42,21,44,107,-76.28334045,36.84831619
228,"NORMAL IL",8,7,3,1,3,7,-88.99052429,40.51409912
228,"NORMAN OK",8,35,11,7,17,35,-97.44689178,35.22203827
228,"NORTH ADAMS MA",8,1,0,0,1,1,-73.10797882,42.70087814
228,"NORTH ANDOVER MA",8,3,1,0,2,3,-71.13425446,42.69897079
228,"NORTH AUGUSTA SC",8,6,5,0,1,6,-81.96509552,33.5021019
228,"NORTH BEND WA",8,18,8,3,7,18,-121.7899017,47.49547195
228,"NORTH BERGEN NJ",8,14,5,5,4,14,-74.0112381,40.8045845
228,"NORTH CANTON OH",8,2,1,0,1,2,-81.40194702,40.87594223
228,"NORTH CHARLESTON SC",8,1,1,0,0,1,-79.97457886,32.85499191
228,"NORTH CHICAGO IL",8,1,0,0,1,1,-87.8412323,42.3254509
228,"NORTH LAS VEGAS NV",8,5,1,2,2,5,-115.1192093,36.19900131
228,"NORTH LIBERTY IA",8,1,0,1,0,1,-91.59856415,41.74905777
228,"NORTH LITTLE ROCK AR",8,14,3,5,6,14,-92.26677704,34.76465988
228,"NORTH MIAMI FL",8,3,1,1,1,3,-80.18624115,25.8908596
228,"NORTH OGDEN UT",8,1,1,0,0,1,-111.9736023,41.30478668
228,"NORTH OLMSTED OH",8,1,0,0,1,1,-81.92334747,41.41566849
228,"NORTH PLATTE NE",8,1,1,0,0,1,-100.7660141,41.12404633
228,"NORTH RIDGEVILLE OH",8,1,1,0,0,1,-82.04491425,41.37031937
228,"NORTH TONAWANDA NY",8,1,0,0,1,1,-78.86399841,43.03866196
228,"NORTHAMPTON MA",8,3,0,1,2,3,-72.64012146,42.32544708
228,"NORTHFIELD IL",8,1,0,0,1,1,-87.78101349,42.09978867
228,"NORTHFIELD MN",8,4,0,3,1,4,-93.16210175,44.45811081
228,"NORTHPORT NY",8,1,1,0,0,1,-73.34220123,40.90099335
228,"NORWALK CT",8,3,1,1,1,3,-73.40729523,41.11759949
228,"NORWALK IA",8,1,1,0,0,1,-93.67901611,41.47555161
228,"NORWICH CT",8,3,0,1,2,3,-72.07475281,41.52449036
228,"NOVATO CA",8,2,0,0,2,2,-122.576561,38.11727142
228,"NOVI MI",8,1,1,0,0,1,-83.47566223,42.48064423
228,"NUTLEY NJ",8,3,2,0,1,3,-74.15930939,40.82229996
228,"NYACK NY",8,12,6,1,5,12,-73.91687012,41.09091568
228,"O'FALLON MO",8,36,12,11,13,36,-90.69979095,38.8109436
228,"OAK BLUFFS MA",8,3,0,1,2,3,-70.56096649,41.45436859
228,"OAK CREEK WI",8,1,0,1,0,1,-87.86346436,42.88599014
228,"OAK PARK IL",8,2,1,0,1,2,-87.78443909,41.88500595
228,"OAK PARK MI",8,2,0,0,1,1,-84.21956253,42.40898132
228,"OAK RIDGE TN",8,2,0,0,2,2,-84.26974487,36.01036072
228,"OAKDALE MN",8,1,1,0,0,1,-92.95690155,44.98758316
228,"OAKLAND CA",8,559,199,147,213,559,-122.2733154,37.80438614
228,"OAKLAND PARK FL",8,1,0,0,1,1,-80.13152313,26.1731205
228,"OAKLEY KS",8,1,0,0,1,1,-100.8645783,39.13345718
228,"OBERLIN OH",8,2,0,0,2,2,-82.21720886,41.29413223
228,"OBLONG IL",8,2,1,0,1,2,-87.90914154,39.00207138
228,"OCALA FL",8,4,1,2,1,4,-82.13973236,29.18780708
228,"OCEAN CITY MD",8,2,0,1,1,2,-75.08437347,38.33656311
228,"OCEANSIDE CA",8,22,4,5,13,22,-117.3814011,33.19587326
228,"ODESSA TX",8,2,2,0,0,2,-102.3682938,31.84587097
228,"OGALLALA NE",8,2,1,1,0,2,-101.7200775,41.1279068
228,"OGDEN UT",8,14,3,3,8,14,-111.9730225,41.22582626
228,"OKEECHOBEE FL",8,1,1,0,0,1,-80.82913971,27.24450302
228,"OKLAHOMA CITY OK",8,76,28,17,31,76,-97.51699829,35.46761322
228,"OLATHE KS",8,15,6,5,4,15,-94.81970215,38.88142395
228,"OLEAN NY",8,2,0,0,2,2,-78.42921448,42.07747269
228,"OLIVE BRANCH MS",8,1,1,0,0,1,-89.82355499,34.96377563
228,"OLYMPIA FIELDS IL",8,2,1,1,0,2,-87.67446899,41.51344299
228,"OLYMPIA WA",8,31,8,13,10,31,-122.8909378,47.04053497
228,"OMAHA NE",8,60,19,15,26,60,-95.93825531,41.25878906
228,"ONAWAY MI",8,1,0,1,0,1,-84.22402191,45.35744095
228,"ONTARIO CA",8,6,0,2,4,6,-117.6528702,34.06340408
228,"ONTARIO OR",8,1,1,0,0,1,-116.9652557,44.02645111
228,"OPA-LOCKA FL",8,1,0,0,1,1,-80.25005341,25.90292931
228,"OPELIKA AL",8,2,0,2,0,2,-85.3780365,32.64568329
228,"ORANGE CA",8,28,9,9,10,28,-117.8544846,33.7877388
228,"ORANGE CITY IA",8,8,1,3,4,8,-96.05925751,43.00707626
228,"ORANGE TX",8,1,0,1,0,1,-93.73699951,30.09343147
228,"ORANGEBURG SC",8,2,0,1,1,2,-80.86129761,33.48974228
228,"OREGON CITY OR",8,1,0,0,1,1,-122.6096726,45.35689163
228,"OREGON IL",8,1,0,0,1,1,-89.3323288,42.01482773
228,"OREM UT",8,3,0,2,1,3,-111.6960449,40.29695892
228,"ORLANDO FL",8,284,81,92,111,284,-81.3789978,28.53886795
228,"ORMOND BEACH FL",8,45,9,14,22,45,-81.05541992,29.28623772
228,"OROVILLE CA",8,1,0,0,1,1,-121.5581131,39.51348877
228,"ORTONVILLE MI",8,1,1,0,0,1,-83.44315338,42.852314
228,"OSHKOSH WI",8,8,2,4,2,8,-88.54268646,44.02453613
228,"OSSINING NY",8,1,0,1,0,1,-73.86093903,41.16327286
228,"OSSIPEE NH",8,1,1,0,0,1,-71.11573029,43.68548965
228,"OSWEGO IL",8,1,0,1,0,1,-88.3513031,41.68288422
228,"OSWEGO NY",8,1,0,1,0,1,-76.50988007,43.45563889
228,"OTTAWA KS",8,2,0,2,0,2,-95.26805878,38.61549759
228,"OTTUMWA IA",8,39,9,12,18,39,-92.41059113,41.01459122
228,"OVERLAND PARK KS",8,8,3,2,3,8,-94.67124939,38.98216248
228,"OVIEDO FL",8,1,0,0,1,1,-81.20778656,28.67054749
228,"OWASSO OK",8,1,1,0,0,1,-95.85546875,36.26954651
228,"OWENSBORO KY",8,3,2,1,0,3,-87.11345673,37.77421188
228,"OWINGSVILLE KY",8,7,4,1,2,7,-83.76404572,38.14480591
228,"OXFORD MS",8,15,6,3,6,15,-89.52319336,34.37203979
228,"OXFORD OH",8,2,1,0,1,2,-84.74536133,39.50694275
228,"OXNARD CA",8,5,0,1,4,5,-119.1790085,34.19766998
228,"OZARK AL",8,1,0,0,1,1,-85.64024353,31.45944405
228,"OZARK MO",8,3,1,2,0,3,-93.20661163,37.02112198
228,"PACIFICA CA",8,3,0,3,0,3,-122.4893951,37.61383438
228,"PADUCAH KY",8,6,2,1,3,6,-88.60009766,37.08333206
228,"PAGELAND SC",8,1,0,0,1,1,-80.39112091,34.77358246
228,"PALACIOS TX",8,2,1,1,0,2,-96.21818542,28.7086792
228,"PALISADES PARK NJ",8,5,1,0,4,5,-73.9969635,40.84852982
228,"PALM BAY FL",8,6,2,0,4,6,-80.58313751,28.03806496
228,"PALM BEACH FL",8,8,1,2,5,8,-80.03616333,26.70643616
228,"PALM BEACH GARDENS FL",8,2,0,2,0,2,-80.07454681,26.8109169
228,"PALM DESERT CA",8,10,1,3,6,10,-116.3907166,33.72164154
228,"PALM SPRINGS CA",8,58,22,15,21,58,-116.5467758,33.83036423
228,"PALM SPRINGS FL",8,1,0,1,0,1,-80.09664154,26.63662338
228,"PALMDALE CA",8,2,2,0,0,2,-118.118454,34.57925034
228,"PALMER AK",8,1,0,1,0,1,-149.1138458,61.59459305
228,"PALMYRA PA",8,1,0,0,1,1,-76.59290314,40.30906677
228,"PALO ALTO CA",8,17,6,3,8,17,-122.1449661,37.44177628
228,"PANAMA CITY BEACH FL",8,2,1,0,1,2,-85.80211639,30.1792717
228,"PANAMA CITY FL",8,4,2,2,0,4,-85.65970612,30.16412926
228,"PAPILLION NE",8,1,0,0,1,1,-96.04257202,41.15442276
228,"PARADISE CA",8,2,0,1,1,2,-121.6395493,39.74609756
228,"PARADISE TX",8,1,1,0,0,1,-97.68798065,33.15030289
228,"PARAGOULD AR",8,1,0,0,1,1,-90.5002594,36.05854034
228,"PARAMOUNT CA",8,1,0,1,0,1,-118.161644,33.88947678
228,"PARIS IL",8,3,0,3,0,3,-87.69623566,39.61117172
228,"PARIS KY",8,1,0,1,0,1,-84.25283051,38.21011353
228,"PARIS TX",8,4,2,1,1,4,-95.55589294,33.66113663
228,"PARK CITY IL",8,1,0,1,0,1,-87.88415527,42.34825897
228,"PARK CITY UT",8,18,4,9,5,18,-111.5018539,40.65143204
228,"PARKER CO",8,7,3,3,1,7,-104.7624359,39.51849365
228,"PARKERSBURG WV",8,7,3,1,3,7,-81.54850006,39.28261948
228,"PARKVILLE MO",8,5,1,2,2,5,-94.68252563,39.19501114
228,"PARMA HEIGHTS OH",8,1,0,0,1,1,-81.75946808,41.39034271
228,"PARMA OH",8,1,0,0,1,1,-81.72257996,41.40510178
228,"PARSONS KS",8,2,1,0,1,2,-95.2614975,37.34062195
228,"PASADENA CA",8,62,20,17,25,62,-118.1466675,34.14794922
228,"PASADENA TX",8,1,0,0,1,1,-95.20979309,29.69150162
228,"PASCO WA",8,1,0,0,1,1,-119.1023636,46.2282753
228,"PASS CHRISTIAN MS",8,1,0,0,1,1,-89.24402618,30.32174683
228,"PASSAIC NJ",8,1,1,0,0,1,-74.12754822,40.8571434
228,"PATASKALA OH",8,1,1,0,0,1,-82.67435455,39.99578094
228,"PATERSON NJ",8,21,9,6,6,21,-74.17102051,40.91714478
228,"PATTEN ME",8,2,0,0,2,2,-68.45036316,45.99417496
228,"PAWTUCKET RI",8,5,2,1,2,5,-71.38137054,41.87892532
228,"PAYETTE ID",8,2,0,0,2,2,-116.9361572,44.07813263
228,"PAYNE OH",8,1,0,1,0,1,-84.72699738,41.07762909
228,"PAYSON AZ",8,1,0,0,1,1,-111.3258514,34.23103714
228,"PAYSON UT",8,1,1,0,0,1,-111.7331848,40.04447937
228,"PEARLAND TX",8,1,1,0,0,1,-95.28644562,29.56411743
228,"PELHAM NY",8,1,1,0,0,1,-73.80719757,40.909832
228,"PEMBROKE PINES FL",8,7,5,0,2,7,-80.22357941,26.00384903
228,"PENDLETON IN",8,4,2,1,1,4,-85.74658203,39.99742126
228,"PENDLETON OR",8,10,3,1,6,10,-118.7900848,45.67152786
228,"PENDLETON SC",8,2,1,1,0,2,-82.78354645,34.65194321
228,"PENN HILLS PA",8,1,0,0,1,1,-79.85767365,40.46170044
228,"PENSACOLA FL",8,17,7,6,4,17,-87.21669006,30.42154694
228,"PEORIA AZ",8,12,6,3,3,12,-112.2390747,33.58084106
228,"PEORIA IL",8,13,4,1,8,13,-89.59487152,40.70241928
228,"PERRY GA",8,1,0,0,1,1,-83.73152161,32.45870972
228,"PERRYSBURG OH",8,7,3,2,2,7,-83.62700653,41.55728531
228,"PERRYVILLE MO",8,4,2,2,0,4,-89.86131287,37.72448349
228,"PERTH AMBOY NJ",8,7,1,3,3,7,-74.26480103,40.5068779
228,"PETALUMA CA",8,2,0,1,1,2,-122.6394272,38.23221207
228,"PHENIX CITY AL",8,2,0,1,1,2,-85.00059509,32.4714241
228,"PHILADELPHIA PA",8,732,222,203,307,732,-75.16322327,39.95243835
228,"PHOENIX AZ",8,374,106,99,169,374,-112.0752716,33.44825363
228,"PHOENIXVILLE PA",8,3,0,3,0,3,-75.51416779,40.13076401
228,"PICAYUNE MS",8,2,1,0,1,2,-89.67980194,30.52602005
228,"PICKENS SC",8,1,0,0,1,1,-82.7070694,34.88385773
228,"PIERPONT SD",8,1,1,0,0,1,-97.82962036,45.49657059
228,"PILOT POINT TX",8,1,1,0,0,1,-96.96129608,33.39688873
228,"PINE BLUFF AR",8,1,1,0,0,1,-92.00374603,34.22846222
228,"PISCATAWAY NJ",8,3,2,1,0,3,-74.3984375,40.49933243
228,"PISMO BEACH CA",8,11,2,2,7,11,-120.6432953,35.1427269
228,"PITTSBORO NC",8,2,0,1,1,2,-79.17662811,35.72052002
228,"PITTSBURG CA",8,10,4,2,4,10,-121.8871613,38.02787781
228,"PITTSBURG KS",8,1,1,0,0,1,-94.70526123,37.41111374
228,"PITTSBURGH PA",8,426,138,111,177,426,-79.99537659,40.44091415
228,"PITTSFIELD IL",8,1,0,0,1,1,-90.80554962,39.60787964
228,"PITTSFIELD MA",8,5,1,2,2,5,-73.24451447,42.45004272
228,"PLACERVILLE CA",8,10,4,4,2,10,-120.8002701,38.72951508
228,"PLAINFIELD IL",8,2,0,2,0,2,-88.20417786,41.62700653
228,"PLAINFIELD IN",8,4,1,3,0,4,-86.39954376,39.70450974
228,"PLAINFIELD NJ",8,6,3,2,1,6,-74.40673065,40.63404083
228,"PLANO TX",8,55,16,16,23,55,-96.69931793,33.01993942
228,"PLANT CITY FL",8,1,0,1,0,1,-82.11231232,28.01914597
228,"PLANTATION FL",8,3,0,3,0,3,-80.23281097,26.12825966
228,"PLAQUEMINE LA",8,2,0,1,1,2,-91.23427582,30.28962708
228,"PLATTSBURGH NY",8,1,0,1,0,1,-73.45239258,44.69951248
228,"PLEASANT VALLEY MO",8,1,0,1,0,1,-94.48001099,39.21652985
228,"PLYMOUTH IN",8,1,1,0,0,1,-86.31345367,41.33988953
228,"PLYMOUTH MA",8,3,0,1,2,3,-70.67458344,41.95769882
228,"PLYMOUTH MI",8,1,0,1,0,1,-83.46985626,42.37141418
228,"POCATELLO ID",8,1,1,0,0,1,-112.4475937,42.87098694
228,"POMONA CA",8,18,2,8,8,18,-117.7534485,34.05541611
228,"POMPANO BEACH FL",8,7,1,2,4,7,-80.12407684,26.23855591
228,"PONCHATOULA LA",8,1,0,0,1,1,-90.44154358,30.4390049
228,"PONTIAC MI",8,6,1,0,5,6,-83.29104614,42.63900757
228,"PONTOON BEACH IL",8,1,0,1,0,1,-90.08075714,38.7317276
228,"POPLAR BLUFF MO",8,8,3,3,2,8,-90.3928833,36.75717545
228,"POPLARVILLE MS",8,1,0,0,1,1,-89.53426361,30.84044838
228,"PORT ANGELES WA",8,1,0,1,0,1,-123.4329224,48.11795044
228,"PORT ARTHUR TX",8,9,3,3,3,9,-93.93045807,29.90067863
228,"PORT ORANGE FL",8,2,1,0,1,2,-81.00856781,29.13491631
228,"PORT TOWNSEND WA",8,2,0,1,1,2,-122.7630005,48.11659241
228,"PORTAGE WI",8,2,0,0,2,2,-89.46311188,43.53891754
228,"PORTALES NM",8,1,1,0,0,1,-103.3379746,34.18170547
228,"PORTER OK",8,14,3,3,8,14,-95.5231781,35.87133026
228,"PORTERVILLE CA",8,1,0,0,1,1,-119.0190811,36.06521988
228,"PORTLAND IN",8,2,0,0,2,2,-84.97788239,40.43445969
228,"PORTLAND ME",8,49,14,18,17,49,-70.25403595,43.6618576
228,"PORTLAND OR",8,947,291,263,393,947,-122.6786423,45.52309418
228,"PORTLAND TN",8,1,0,1,0,1,-86.51625824,36.58184814
228,"PORTSMOUTH NH",8,2,0,1,1,2,-70.76164246,43.07198334
228,"PORTSMOUTH OH",8,1,1,0,0,1,-82.99292755,38.74839783
228,"PORTSMOUTH VA",8,1,0,1,0,1,-76.29769135,36.83554077
228,"POTSDAM NY",8,1,1,0,0,1,-74.98085785,44.66995239
228,"POTTSTOWN PA",8,3,3,0,0,3,-75.64894867,40.24571609
228,"POUGHKEEPSIE NY",8,2,0,1,1,2,-73.92034149,41.70055771
228,"POUND VA",8,1,0,1,0,1,-82.60127258,37.12379837
228,"POWAY CA",8,1,0,1,0,1,-117.0376205,32.96272659
228,"PRAIRIE DU CHIEN WI",8,1,0,1,0,1,-91.14174652,43.05184174
228,"PRAIRIE DU SAC WI",8,1,1,0,0,1,-89.72431183,43.28665543
228,"PRAIRIE VIEW TX",8,2,1,0,1,2,-95.9883194,30.09370232
228,"PRAIRIE VILLAGE KS",8,1,1,0,0,1,-94.63400269,38.99189377
228,"PRATTVILLE AL",8,11,1,6,4,11,-86.45972443,32.46446228
228,"PRESCOTT AZ",8,5,2,2,1,5,-112.4702301,34.54008102
228,"PRICE UT",8,2,1,1,0,2,-110.8117294,39.60165024
228,"PRINCETON NJ",8,22,7,7,8,22,-74.65805817,40.34872055
228,"PROSPER TX",8,2,1,0,1,2,-96.80168915,33.23641205
228,"PROSSER WA",8,1,0,0,1,1,-119.7716522,46.20647812
228,"PROVIDENCE RI",8,102,32,26,44,102,-71.40118408,41.82990265
228,"PROVINCETOWN MA",8,43,9,16,18,43,-70.17770386,42.05849075
228,"PROVO UT",8,7,2,2,3,7,-111.6589813,40.23337936
228,"PUEBLO CO",8,69,19,22,28,69,-104.6108551,38.25450516
228,"PULLMAN WA",8,264,93,60,111,264,-117.180481,46.73068619
228,"PURCELLVILLE VA",8,1,0,1,0,1,-77.71422577,39.13694763
228,"PUYALLUP WA",8,8,1,2,5,8,-122.2927628,47.19064331
228,"QUAKERTOWN PA",8,1,0,0,1,1,-75.33325958,40.44256592
228,"QUINCY IL",8,2,0,1,1,2,-91.41021729,39.9356575
228,"QUINCY MA",8,6,0,3,3,6,-71.00706482,42.24961472
228,"RACINE WI",8,5,1,0,4,5,-87.78296661,42.72628021
228,"RADFORD VA",8,1,0,0,1,1,-80.57588196,37.13208389
228,"RALEIGH NC",8,178,55,55,68,178,-78.63800049,35.77230835
228,"RANCHO CORDOVA CA",8,1,0,0,1,1,-121.3053742,38.58900452
228,"RANCHO MIRAGE CA",8,2,2,0,0,2,-116.4143066,33.73956299
228,"RANDLEMAN NC",8,1,0,0,1,1,-79.80243683,35.81801224
228,"RANDOLPH MA",8,1,0,0,1,1,-71.03983307,42.1629715
228,"RANDOLPH VT",8,1,0,1,0,1,-72.6631012,43.92315674
228,"RAPID CITY SD",8,7,2,2,3,7,-103.2325821,44.08078766
228,"RAYTOWN MO",8,9,2,3,4,9,-94.46369934,39.00871277
228,"READING PA",8,33,10,9,14,33,-75.9259491,40.33562851
228,"RED WING MN",8,1,0,0,1,1,-92.53401184,44.56221771
228,"REDDING CA",8,3,0,0,3,3,-122.3944626,40.58649826
228,"REDLANDS CA",8,3,1,0,2,3,-117.21064,34.0318718
228,"REDMOND WA",8,19,4,6,9,19,-122.1240006,47.67367172
228,"REDONDO BEACH CA",8,41,14,11,16,41,-118.3907471,33.84916687
228,"REDWOOD CITY CA",8,11,3,4,4,11,-122.2364655,37.48601151
228,"REHOBOTH BEACH DE",8,1,0,1,0,1,-75.0807724,38.71229172
228,"REIDSVILLE NC",8,2,1,1,0,2,-79.66392517,36.35525513
228,"RENO NV",8,37,14,6,17,37,-119.8160934,39.5294838
228,"RENTON WA",8,17,6,6,5,17,-122.2197342,47.48252487
228,"REVERE MA",8,2,0,1,1,2,-71.01091003,42.40863037
228,"REYNOLDSBURG OH",8,1,0,0,1,1,-82.81163788,39.95471191
228,"RHINELANDER WI",8,3,1,1,1,3,-89.41246796,45.63654709
228,"RIALTO CA",8,1,0,1,0,1,-117.3716126,34.1063118
228,"RICHARDSON TX",8,1,0,0,1,1,-96.73020172,32.94840622
228,"RICHFIELD MN",8,3,2,1,0,3,-93.28303528,44.87028503
228,"RICHLAND CENTER WI",8,1,0,0,1,1,-90.38737488,43.33480072
228,"RICHLAND WA",8,5,0,2,3,5,-119.2866592,46.28547287
228,"RICHMOND CA",8,21,7,7,7,21,-122.3500443,37.9354744
228,"RICHMOND HEIGHTS MO",8,26,12,4,10,26,-90.31951904,38.62892532
228,"RICHMOND IN",8,3,0,1,2,3,-84.8900528,39.82888412
228,"RICHMOND KY",8,1,0,1,0,1,-84.29437256,37.74818802
228,"RICHMOND MO",8,1,0,0,1,1,-93.97762299,39.2788353
228,"RICHMOND TX",8,3,1,0,2,3,-95.76106262,29.58276558
228,"RICHMOND VA",8,90,25,29,36,90,-77.45962524,37.55412674
228,"RIDGELAND MS",8,1,0,1,0,1,-90.13221741,32.42857742
228,"RIPON WI",8,1,0,1,0,1,-88.83634186,43.8422966
228,"RISON AR",8,2,1,0,1,2,-92.19036102,33.95878983
228,"RIVERHEAD NY",8,1,0,1,0,1,-72.66098785,40.91713333
228,"RIVERSIDE CA",8,65,23,16,26,65,-117.3973999,33.95311737
228,"RIVERSIDE IL",8,1,0,0,1,1,-87.82324219,41.8351059
228,"RIVERTON IL",8,1,0,0,1,1,-89.53983307,39.84453201
228,"RIVIERA BEACH FL",8,1,0,1,0,1,-80.05784607,26.77610397
228,"ROANOKE VA",8,7,2,3,2,7,-79.94111633,37.27119827
228,"ROBINSON IL",8,10,5,2,3,10,-87.73912048,39.00521469
228,"ROBINSON TX",8,1,0,1,0,1,-97.11503601,31.46778679
228,"ROCHESTER MN",8,10,2,2,6,10,-92.47042084,44.02156448
228,"ROCHESTER NY",8,155,45,48,62,155,-77.61522675,43.15487671
228,"ROCK HILL MO",8,1,0,1,0,1,-90.37846375,38.60773849
228,"ROCK HILL SC",8,15,6,2,7,15,-81.02463531,34.92498779
228,"ROCK SPRINGS WY",8,2,0,2,0,2,-109.2040176,41.58724976
228,"ROCKFORD IL",8,6,1,2,3,6,-89.09428406,42.27135086
228,"ROCKPORT MA",8,1,0,0,1,1,-70.61954498,42.65607071
228,"ROCKPORT TX",8,2,0,1,1,2,-97.05498505,28.02133369
228,"ROCKVILLE CENTRE NY",8,1,0,1,0,1,-73.64044189,40.6588974
228,"ROCKVILLE MD",8,9,4,2,3,9,-77.15235901,39.08402252
228,"ROCKWALL TX",8,4,1,1,2,4,-96.46016693,32.93169022
228,"ROCKY MOUNT NC",8,5,1,2,2,5,-77.78997803,35.93837738
228,"ROCKY RIVER OH",8,2,0,0,2,2,-81.83889008,41.4756279
228,"ROGERS AR",8,14,6,3,5,14,-94.11903381,36.33228683
228,"ROLLA MO",8,11,5,0,6,11,-91.77151489,37.95161438
228,"ROME GA",8,1,0,0,1,1,-85.16900635,34.24008942
228,"ROME NY",8,1,0,1,0,1,-75.4548645,43.21290207
228,"ROSE BUD AR",8,1,1,0,0,1,-92.08159637,35.33152771
228,"ROSE HILL KS",8,1,1,0,0,1,-97.13547516,37.5582962
228,"ROSENBERG TX",8,1,0,0,1,1,-95.80905914,29.5575695
228,"ROSEVILLE CA",8,31,12,8,11,31,-121.2899246,38.75195694
228,"ROSEVILLE MN",8,4,2,2,0,4,-93.14508057,45.02290726
228,"ROSWELL GA",8,2,1,1,0,2,-84.36141205,34.02328491
228,"ROUND LAKE IL",8,1,1,0,0,1,-88.09385681,42.35342789
228,"ROWLETT TX",8,1,0,1,0,1,-96.56422424,32.90298462
228,"RUMSON NJ",8,16,4,6,6,16,-73.99851227,40.37051773
228,"RUSSELL MN",8,1,0,1,0,1,-95.95232391,44.3192482
228,"RUSSELLVILLE AR",8,4,1,3,0,4,-93.1343689,35.27845383
228,"RUTHERFORD NJ",8,1,1,0,0,1,-74.10585022,40.82668304
228,"RYE CO",8,5,1,1,3,5,-104.9316177,37.92366791
228,"SACHSE TX",8,1,0,0,1,1,-96.59605408,32.97636795
228,"SACRAMENTO CA",8,214,69,44,101,214,-121.4959793,38.58154297
228,"SAFFORD AZ",8,1,0,0,1,1,-109.7091065,32.83410263
228,"SAGINAW MI",8,2,1,0,1,2,-83.95076752,43.41968918
228,"SAHUARITA AZ",8,82,23,28,31,82,-110.9567032,31.95795059
228,"SALEM IL",8,12,3,4,5,12,-88.94590759,38.62715149
228,"SALEM MA",8,6,3,2,1,6,-70.89565277,42.51993179
228,"SALEM NH",8,1,0,1,0,1,-71.19998169,42.78861618
228,"SALEM OR",8,49,12,18,19,49,-123.0377197,44.94248199
228,"SALINAS CA",8,30,9,9,12,30,-121.6571732,36.67780304
228,"SALISBURY MD",8,9,4,2,3,9,-75.5984726,38.36100388
228,"SALT LAKE CITY UT",8,42,12,12,18,42,-111.8912659,40.77029037
228,"SAN ANGELO TX",8,11,4,3,4,11,-100.4379044,31.46401215
228,"SAN ANSELMO CA",8,2,0,2,0,2,-122.5641785,37.97429276
228,"SAN ANTONIO TX",8,333,100,95,138,333,-98.49394989,29.42439651
228,"SAN BERNARDINO CA",8,9,4,2,3,9,-117.304596,34.12142563
228,"SAN CARLOS CA",8,2,0,2,0,2,-122.262207,37.50718307
228,"SAN CLEMENTE CA",8,2,1,0,1,2,-117.6134033,33.42698669
228,"SAN DIEGO CA",8,543,190,141,212,543,-117.1587296,32.71524429
228,"SAN DIMAS CA",8,1,0,0,1,1,-117.8088913,34.10668945
228,"SAN FRANCISCO CA",8,609,185,178,246,609,-122.4213257,37.77465057
228,"SAN GABRIEL CA",8,2,1,1,0,2,-118.107605,34.09612274
228,"SAN JACINTO CA",8,1,1,0,0,1,-116.9603272,33.78380585
228,"SAN JOSE CA",8,163,45,55,63,163,-121.8973846,37.33491516
228,"SAN LEANDRO CA",8,4,1,2,1,4,-122.155983,37.70180511
228,"SAN LUIS OBISPO CA",8,20,4,5,11,20,-120.6622849,35.28281021
228,"SAN MARCOS CA",8,9,3,4,2,9,-117.1673966,33.14345551
228,"SAN MARCOS TX",8,5,0,1,4,5,-97.94176483,29.88363266
228,"SAN MATEO CA",8,7,2,4,1,7,-122.3270264,37.56283569
228,"SAN PABLO CA",8,1,0,1,0,1,-122.3469696,37.96184921
228,"SAN RAFAEL CA",8,7,1,4,2,7,-122.5331726,37.97325134
228,"SAN RAMON CA",8,1,0,1,0,1,-121.9799347,37.77985764
228,"SANDUSKY OH",8,1,0,0,1,1,-82.7080307,41.44903183
228,"SANDY OR",8,9,4,1,4,9,-122.263649,45.39704132
228,"SANFORD FL",8,2,0,1,1,2,-81.27256012,28.80128288
228,"SANFORD NC",8,2,1,0,1,2,-79.17978668,35.4800415
228,"SANGER CA",8,1,0,0,1,1,-119.5580063,36.70794296
228,"SANTA ANA CA",8,20,8,3,9,20,-117.8697281,33.74567413
228,"SANTA BARBARA CA",8,41,16,15,10,41,-119.7056656,34.4233017
228,"SANTA CLARA CA",8,9,1,4,4,9,-121.946434,37.34754181
228,"SANTA CLARA UT",8,2,1,1,0,2,-113.6550903,37.13301849
228,"SANTA CRUZ CA",8,25,9,10,6,25,-122.0333557,36.97389984
228,"SANTA FE NM",8,56,15,19,22,56,-105.9468155,35.68014526
228,"SANTA MARIA CA",8,4,3,0,1,4,-120.437973,34.95292664
228,"SANTA MONICA CA",8,125,32,35,58,125,-118.4925232,34.01921082
228,"SANTA PAULA CA",8,1,0,0,1,1,-119.0609283,34.35404587
228,"SANTA ROSA CA",8,51,15,17,19,51,-122.7165146,38.44017792
228,"SARANAC LAKE NY",8,1,0,0,1,1,-74.1305542,44.32965851
228,"SARASOTA FL",8,24,5,9,10,24,-82.53031158,27.33688736
228,"SARATOGA CA",8,2,1,1,0,2,-122.0252457,37.26384735
228,"SARATOGA SPRINGS NY",8,3,1,2,0,3,-73.78382111,43.08345032
228,"SARATOGA WY",8,1,1,0,0,1,-106.807579,41.45475769
228,"SAUK RAPIDS MN",8,1,0,0,1,1,-94.16661835,45.59189987
228,"SAUSALITO CA",8,3,1,2,0,3,-122.4881592,37.85736847
228,"SAVANNAH GA",8,65,23,17,25,65,-81.09463501,32.07280731
228,"SAVANNAH TN",8,2,0,0,2,2,-88.24948883,35.22502518
228,"SAVOY IL",8,1,0,0,1,1,-88.25175476,40.05500793
228,"SAYREVILLE NJ",8,1,0,1,0,1,-74.36043549,40.45940018
228,"SCHAUMBURG IL",8,1,0,1,0,1,-88.08359528,42.03350449
228,"SCHENECTADY NY",8,1,1,0,0,1,-73.938591,42.81433487
228,"SCITUATE MA",8,1,0,1,0,1,-70.72504425,42.19600677
228,"SCOTTSBLUFF NE",8,1,1,0,0,1,-103.6682434,41.86663818
228,"SCOTTSDALE AZ",8,29,9,13,7,29,-111.9002533,33.50918579
228,"SCRANTON PA",8,5,1,3,1,5,-75.66184998,41.40919113
228,"SEAFORD DE",8,2,1,0,1,2,-75.61972809,38.64723206
228,"SEALY TX",8,1,1,0,0,1,-96.15762329,29.78135109
228,"SEARCY AR",8,1,0,0,1,1,-91.73634338,35.25092697
228,"SEASIDE OR",8,1,1,0,0,1,-123.9250565,45.99291992
228,"SEAT PLEASANT MD",8,1,0,0,1,1,-76.90610504,38.8963623
228,"SEATTLE WA",8,780,233,218,329,780,-122.3343964,47.60571289
228,"SEBASTOPOL CA",8,2,1,0,1,2,-122.8264999,38.40188217
228,"SEBRING FL",8,1,0,0,1,1,-81.4406662,27.49625397
228,"SEDONA AZ",8,19,6,4,9,19,-111.7623367,34.86959839
228,"SEGUIN TX",8,3,1,1,1,3,-97.96529388,29.56933594
228,"SELAH WA",8,1,0,0,1,1,-120.5326233,46.65384674
228,"SELLERSBURG IN",8,1,0,0,1,1,-85.75473785,38.39831543
228,"SEMINOLE FL",8,1,0,1,0,1,-82.79083252,27.84035683
228,"SEMMES AL",8,1,1,0,0,1,-88.25917053,30.7788372
228,"SENATOBIA MS",8,2,1,1,0,2,-89.96900177,34.61786652
228,"SENECA SC",8,1,1,0,0,1,-82.95318604,34.68600845
228,"SEVIERVILLE TN",8,2,1,0,1,2,-83.56149292,35.86820984
228,"SHAKER HEIGHTS OH",8,50,11,18,21,50,-81.53669739,41.47419357
228,"SHARON MA",8,1,0,1,0,1,-71.17311096,42.12431335
228,"SHARPSVILLE IN",8,9,2,4,3,9,-86.08840179,40.37942886
228,"SHAWANO WI",8,1,1,0,0,1,-88.60903931,44.78231049
228,"SHAWNEE KS",8,5,4,0,1,5,-94.7208786,39.0417366
228,"SHAWNEE OK",8,3,2,0,1,3,-96.92608643,35.32754898
228,"SHEBOYGAN WI",8,20,9,6,5,20,-87.71476746,43.75089264
228,"SHELDON IA",8,3,2,1,0,3,-95.8535614,43.18698502
228,"SHELTON CT",8,3,1,1,1,3,-73.09243011,41.31684494
228,"SHENANDOAH IA",8,1,1,0,0,1,-95.3727951,40.76542664
228,"SHERMAN TX",8,2,0,0,2,2,-96.60933685,33.63597488
228,"SHERWOOD AR",8,1,0,1,0,1,-92.22438049,34.81515884
228,"SHERWOOD OR",8,2,0,0,2,2,-122.8425446,45.35624313
228,"SHIVELY KY",8,1,0,0,1,1,-85.82255554,38.20013809
228,"SHREVEPORT LA",8,44,19,7,18,44,-93.7507019,32.52565002
228,"SIERRA MADRE CA",8,2,0,1,1,2,-118.0547943,34.16183853
228,"SIKESTON MO",8,1,0,1,0,1,-89.5878067,36.87693024
228,"SIMI VALLEY CA",8,4,2,1,1,4,-118.7839508,34.26951981
228,"SIMPSONVILLE SC",8,1,1,0,0,1,-82.25405121,34.73744202
228,"SIMSBORO LA",8,1,0,1,0,1,-92.78874969,32.534729
228,"SINTON TX",8,1,0,0,1,1,-97.50976562,28.03709793
228,"SIOUX CITY IA",8,1,1,0,0,1,-96.40085602,42.5001564
228,"SIOUX FALLS SD",8,24,8,6,10,24,-96.73429108,43.54177475
228,"SKOKIE IL",8,1,0,0,1,1,-87.73321533,42.03328705
228,"SLIDELL LA",8,10,1,4,5,10,-89.78143311,30.27558708
228,"SMITHFIELD VA",8,2,0,0,2,2,-76.63034058,36.98272324
228,"SMITHVILLE MO",8,1,1,0,0,1,-94.58171082,39.38669586
228,"SMITHVILLE TN",8,2,1,0,1,2,-85.81411743,35.96058273
228,"SMYRNA GA",8,4,2,1,1,4,-84.51447296,33.88409042
228,"SMYRNA TN",8,1,0,0,1,1,-86.51843262,35.98318863
228,"SNOHOMISH WA",8,1,0,0,1,1,-122.1009903,47.91241837
228,"SOCIAL CIRCLE GA",8,1,0,0,1,1,-83.71785736,33.65628433
228,"SOMERS WI",8,1,0,1,0,1,-87.9103775,42.64015579
228,"SOMERSET KY",8,1,1,0,0,1,-84.60385132,37.09214783
228,"SOMERVILLE MA",8,34,15,8,11,34,-71.09860992,42.38757324
228,"SONORA CA",8,19,7,5,7,19,-120.3842011,37.98400497
228,"SOUDERTON PA",8,1,0,1,0,1,-75.32456207,40.31177902
228,"SOUTH BEND IN",8,46,14,12,20,46,-86.25171661,41.67295837
228,"SOUTH GATE CA",8,16,3,5,8,16,-118.213707,33.95462799
228,"SOUTH HADLEY MA",8,1,0,1,0,1,-72.57582855,42.26013184
228,"SOUTH JORDAN UT",8,2,0,1,1,2,-111.9315186,40.56394577
228,"SOUTH LAKE TAHOE CA",8,7,1,3,3,7,-119.972786,38.94574356
228,"SOUTH PITTSBURG TN",8,1,1,0,0,1,-85.70410156,35.01231766
228,"SOUTH PLAINFIELD NJ",8,2,1,0,1,2,-74.41103363,40.57961655
228,"SOUTH PORTLAND ME",8,1,0,0,1,1,-70.23975372,43.6415062
228,"SOUTH SALT LAKE UT",8,1,0,0,1,1,-111.8901367,40.71858215
228,"SOUTH SAN FRANCISCO CA",8,1,0,0,1,1,-122.4101868,37.65430069
228,"SOUTHAMPTON NY",8,15,6,6,3,15,-72.38861084,40.88444519
228,"SOUTHINGTON CT",8,3,0,1,2,3,-72.8768158,41.59680557
228,"SOUTHLAKE TX",8,1,0,0,1,1,-97.13466644,32.94153214
228,"SPARKS NV",8,1,0,0,1,1,-119.7548142,39.53468704
228,"SPARTA IL",8,2,0,0,2,2,-89.70211792,38.12332535
228,"SPARTA TN",8,1,0,1,0,1,-85.46425629,35.9259491
228,"SPARTANBURG SC",8,25,9,7,9,25,-81.93160248,34.94982529
228,"SPEEDWAY IN",8,13,2,9,2,13,-86.2671051,39.80224609
228,"SPENCER OK",8,1,1,0,0,1,-97.3780365,35.52297974
228,"SPENCERVILLE OH",8,1,1,0,0,1,-84.35338593,40.70881653
228,"SPOKANE WA",8,54,16,13,25,54,-117.4281387,47.65847015
228,"SPRING HILL TN",8,6,0,2,4,6,-86.93003845,35.75111389
228,"SPRINGDALE AR",8,3,0,1,2,3,-94.12921143,36.1869278
228,"SPRINGFIELD IL",8,79,27,18,34,79,-89.6439743,39.80184174
228,"SPRINGFIELD MA",8,4,2,1,1,4,-72.57289124,42.10980606
228,"SPRINGFIELD MO",8,220,60,70,90,220,-93.29862213,37.21548843
228,"SPRINGFIELD OR",8,4,1,2,1,4,-123.024704,44.04590988
228,"SPRINGFIELD TN",8,1,1,0,0,1,-86.88502502,36.50941086
228,"SPRINGFIELD VT",8,1,0,1,0,1,-72.48161316,43.29873657
228,"ST LOUIS MO",8,6156,2166,1351,2639,6156,-90.19819641,38.62716675
228,"STAMFORD CT",8,8,3,4,1,8,-73.53807068,41.05353165
228,"STAPLES MN",8,2,1,1,0,2,-94.79264069,46.35538483
228,"STARKVILLE MS",8,4,1,1,2,4,-88.81492615,33.46545029
228,"STATE COLLEGE PA",8,6,2,1,3,6,-77.85973358,40.79336929
228,"STATESBORO GA",8,9,2,1,6,9,-81.78266907,32.44914246
228,"STATESVILLE NC",8,3,2,0,1,3,-80.88671875,35.78310013
228,"STAUNTON VA",8,4,0,1,3,4,-79.07145691,38.14970016
228,"STEAMBOAT SPRINGS CO",8,2,0,0,2,2,-106.8292313,40.48627853
228,"STEELVILLE MO",8,2,1,0,1,2,-91.35505676,37.96838379
228,"STERLING CO",8,1,1,0,0,1,-103.2093811,40.62519073
228,"STERLING HEIGHTS MI",8,1,0,0,1,1,-83.03016663,42.58047485
228,"STEVENS POINT WI",8,2,2,0,0,2,-89.57467651,44.52337265
228,"STILLWATER OK",8,1,0,1,0,1,-97.0588913,36.11580658
228,"STOCKBRIDGE GA",8,3,2,1,0,3,-84.23356628,33.54455185
228,"STOCKTON CA",8,13,5,4,4,13,-121.293457,37.95776749
228,"STOKESDALE NC",8,1,0,0,1,1,-79.97875977,36.23734283
228,"STONE MOUNTAIN GA",8,11,3,6,2,11,-84.14538574,33.8065033
228,"STOUGHTON MA",8,1,0,1,0,1,-71.10134888,42.12547302
228,"STOW OH",8,4,2,1,1,4,-81.44025421,41.1593895
228,"STRATFORD CT",8,3,1,2,0,3,-73.13223267,41.18459702
228,"STRUTHERS OH",8,1,0,0,1,1,-80.59054565,41.05240631
228,"STUART FL",8,3,2,0,1,3,-80.25237274,27.19645882
228,"SUFFOLK VA",8,5,0,4,1,5,-76.58317566,36.72846985
228,"SUGAR LAND TX",8,2,2,0,0,2,-95.6352005,29.61997795
228,"SULLIGENT AL",8,3,2,1,0,3,-88.13464355,33.90181732
228,"SUMMERVILLE SC",8,7,2,1,4,7,-80.17547607,33.01868439
228,"SUMMIT NJ",8,1,0,1,0,1,-74.3586731,40.74148178
228,"SUMTER SC",8,3,1,0,2,3,-80.34135437,33.92088318
228,"SUNNYVALE CA",8,14,6,5,3,14,-122.0380707,37.36878967
228,"SUNNYVALE TX",8,1,1,0,0,1,-96.56118774,32.7967453
228,"SURFSIDE FL",8,2,1,1,0,2,-80.12493134,25.87931252
228,"SUWANEE GA",8,2,1,0,1,2,-84.0713501,34.05178452
228,"SWEENY TX",8,11,2,6,3,11,-95.69893646,29.03920364
228,"SWEETWATER TX",8,1,1,0,0,1,-100.4070358,32.47128296
228,"SYCAMORE OH",8,1,0,1,0,1,-83.17075348,40.94967651
228,"SYLVANIA OH",8,6,3,2,1,6,-83.71266174,41.71902466
228,"SYRACUSE NY",8,55,18,15,22,55,-76.14653015,43.04846191
228,"TACOMA WA",8,57,14,18,25,57,-122.4466705,47.25242233
228,"TAHLEQUAH OK",8,1,0,0,1,1,-94.9703064,35.91559982
228,"TAKOMA PARK MD",8,5,1,1,3,5,-77.00667572,38.97793198
228,"TALENT OR",8,1,0,0,1,1,-122.7902298,42.24512863
228,"TALLADEGA AL",8,3,2,0,1,3,-86.10553741,33.43610001
228,"TALLAHASSEE FL",8,73,22,25,26,73,-84.27896881,30.44669914
228,"TALLMADGE OH",8,1,1,0,0,1,-81.44173431,41.10177231
228,"TALLULAH LA",8,4,0,3,1,4,-91.18704987,32.40855789
228,"TAMPA FL",8,363,98,116,149,363,-82.4580307,27.94833755
228,"TANGENT OR",8,1,1,0,0,1,-123.1104889,44.54080582
228,"TAOS NM",8,2,1,1,0,2,-105.5769424,36.40658188
228,"TARPON SPRINGS FL",8,66,23,23,20,66,-82.75656128,28.14682198
228,"TAYLOR MI",8,13,2,1,10,13,-83.26967621,42.24112701
228,"TEA SD",8,1,0,1,0,1,-96.83795166,43.44678497
228,"TEANECK NJ",8,10,4,4,2,10,-74.01485443,40.89759064
228,"TECUMSEH MI",8,9,3,4,2,9,-83.94480133,42.00404358
228,"TEMECULA CA",8,7,2,2,3,7,-117.1428146,33.48790741
228,"TEMPE AZ",8,39,15,8,16,39,-111.9108276,33.41504288
228,"TEMPLE TX",8,1,1,0,0,1,-97.34354401,31.09850502
228,"TERRE HAUTE IN",8,11,1,3,7,11,-87.41414642,39.46681976
228,"TEWKSBURY MA",8,34,8,11,15,34,-71.23313904,42.61103439
228,"TEXARKANA TX",8,2,2,0,0,2,-94.04785156,33.42536545
228,"THE DALLES OR",8,1,0,1,0,1,-121.1804581,45.59422684
228,"THIBODAUX LA",8,1,0,0,1,1,-90.82309723,29.79626465
228,"THOMASVILLE GA",8,1,1,0,0,1,-83.97835541,30.8371582
228,"THORNTON CO",8,19,7,8,4,19,-104.9727631,39.86811829
228,"THOUSAND OAKS CA",8,2,0,1,1,2,-118.8398514,34.17078018
228,"THREE RIVERS MI",8,2,0,1,1,2,-85.63246918,41.94419861
228,"TIGARD OR",8,2,2,0,0,2,-122.7737198,45.4310112
228,"TINLEY PARK IL",8,2,0,2,0,2,-87.78465271,41.57352448
228,"TITUSVILLE FL",8,1,0,0,1,1,-80.80722809,28.61296272
228,"TOLEDO OH",8,90,25,30,35,90,-83.55497742,41.66411591
228,"TOMBALL TX",8,1,0,0,1,1,-95.6162262,30.09776115
228,"TOMBSTONE AZ",8,10,4,5,1,10,-110.0689316,31.71310997
228,"TOMS RIVER NJ",8,1,0,1,0,1,-74.19700623,39.95401382
228,"TOOELE UT",8,3,0,1,2,3,-112.3005066,40.53457642
228,"TOPEKA KS",8,37,8,12,17,37,-95.67857361,39.04813766
228,"TOPPENISH WA",8,1,0,1,0,1,-120.3111954,46.37686539
228,"TORONTO KS",8,2,0,1,1,2,-95.94944,37.79908752
228,"TORRANCE CA",8,29,9,9,11,29,-118.3428345,33.8359642
228,"TRAVELERS REST SC",8,2,0,0,2,2,-82.44297028,34.96780014
228,"TRAVERSE CITY MI",8,15,5,8,2,15,-85.6207962,44.76324844
228,"TREMONT IL",8,2,0,1,1,2,-89.49304199,40.52783585
228,"TRENTON FL",8,1,1,0,0,1,-82.81704712,29.61356735
228,"TRENTON IL",8,2,0,1,1,2,-89.68222809,38.60559845
228,"TRENTON NJ",8,16,4,6,6,16,-74.74206543,40.21709442
228,"TRENTON OH",8,2,0,0,2,2,-84.45779419,39.48095703
228,"TROY AL",8,1,0,0,1,1,-85.97013855,31.80913544
228,"TROY MI",8,5,1,3,1,5,-83.14983368,42.60589218
228,"TROY MO",8,13,5,1,7,13,-90.98098755,38.979702
228,"TROY NY",8,7,2,3,2,7,-73.69088745,42.72839737
228,"TROY OH",8,64,23,21,20,64,-84.20330811,40.03966141
228,"TRUTH OR CONSEQUENCES NM",8,1,0,0,1,1,-107.2433853,33.13360596
228,"TUCKER GA",8,1,0,1,0,1,-84.21690369,33.85486603
228,"TUCSON AZ",8,88,37,25,26,88,-110.9277954,32.22209167
228,"TULARE CA",8,5,3,0,2,5,-119.3488922,36.20763016
228,"TULLAHOMA TN",8,2,0,0,2,2,-86.20916748,35.36205673
228,"TULSA OK",8,63,22,20,21,63,-95.98488617,36.1603241
228,"TUMWATER WA",8,2,0,2,0,2,-122.9116669,47.00710678
228,"TURLOCK CA",8,4,0,1,3,4,-120.8488617,37.49431229
228,"TUSCALOOSA AL",8,31,9,14,8,31,-87.56897736,33.21024704
228,"TUSTIN CA",8,1,0,0,1,1,-117.8277283,33.74598312
228,"TWENTYNINE PALMS CA",8,1,0,0,1,1,-116.055397,34.13557053
228,"TWIN FALLS ID",8,4,0,4,0,4,-114.4627686,42.56301498
228,"TYLER TX",8,10,1,2,7,10,-95.3013916,32.35176468
228,"UKIAH CA",8,4,1,0,3,4,-123.2104721,39.15015793
228,"UNION CITY NJ",8,1,1,0,0,1,-74.02296448,40.77968979
228,"UNION KY",8,1,0,1,0,1,-84.68045044,38.94612122
228,"UNION MO",8,4,0,3,1,4,-91.00618744,38.44558716
228,"UNION NJ",8,1,1,0,0,1,-74.26235199,40.69780731
228,"UNIONTOWN PA",8,2,1,1,0,2,-79.7276535,39.89894104
228,"UNIVERSAL CITY TX",8,3,1,0,2,3,-98.29141235,29.54836273
228,"UNIVERSITY CITY MO",8,72,30,15,27,72,-90.33391571,38.66000748
228,"UNIVERSITY HEIGHTS OH",8,2,0,1,1,2,-81.5369873,41.49779892
228,"UNIVERSITY PLACE WA",8,3,2,0,1,3,-122.5529404,47.2352562
228,"UPLAND CA",8,1,0,1,0,1,-117.6498413,34.09745026
228,"UPPER ARLINGTON OH",8,1,0,1,0,1,-83.06159973,39.99918365
228,"UPPER DARBY PA",8,3,0,2,1,3,-75.27319336,39.92858124
228,"URBANA IL",8,16,8,2,6,16,-88.20746613,40.11079025
228,"UTICA NY",8,4,2,0,2,4,-75.23220062,43.10119629
228,"VACAVILLE CA",8,3,1,1,1,3,-121.9900284,38.35633469
228,"VALDEZ AK",8,2,1,0,1,2,-146.3392181,61.13446426
228,"VALDOSTA GA",8,26,6,10,10,26,-83.27806854,30.83293533
228,"VALLEJO CA",8,7,2,4,1,7,-122.2594299,38.1039505
228,"VALLEY AL",8,1,1,0,0,1,-85.17531586,32.81519318
228,"VALPARAISO IN",8,5,1,2,2,5,-87.05838013,41.46813583
228,"VAN ALSTYNE TX",8,1,1,0,0,1,-96.57787323,33.42159271
228,"VANCOUVER WA",8,20,6,5,9,20,-122.6816559,45.63534164
228,"VENICE FL",8,4,1,3,0,4,-82.45388031,27.10065269
228,"VERGENNES VT",8,1,1,0,0,1,-73.25317383,44.16755676
228,"VERMILLION SD",8,3,2,0,1,3,-96.92948914,42.77981949
228,"VERO BEACH FL",8,2,0,0,2,2,-80.39705658,27.63908195
228,"VICKSBURG MS",8,1,0,1,0,1,-90.87818909,32.35280991
228,"VICTORIA TX",8,2,1,0,1,2,-97.00409698,28.80560303
228,"VICTORVILLE CA",8,15,4,6,5,15,-117.2928162,34.53612137
228,"VIENNA VA",8,4,3,0,1,4,-77.2645874,38.90164566
228,"VILLA RICA GA",8,5,0,3,2,5,-84.91907501,33.73210907
228,"VINELAND NJ",8,1,0,1,0,1,-75.02515411,39.48631668
228,"VIRGINIA BEACH VA",8,245,76,69,100,245,-75.97751617,36.8533783
228,"VISALIA CA",8,1,1,0,0,1,-119.2938156,36.33000946
228,"VISTA CA",8,8,4,3,1,8,-117.2447052,33.2000885
228,"WACO TX",8,25,9,8,8,25,-97.14704895,31.54987144
228,"WACONIA MN",8,1,0,0,1,1,-93.78717041,44.85052109
228,"WAGONER OK",8,1,0,1,0,1,-95.37010193,35.95982361
228,"WAITE PARK MN",8,20,6,6,8,20,-94.224823,45.55731201
228,"WAKE FOREST NC",8,10,2,7,1,10,-78.50919342,35.98039246
228,"WAKEFIELD MA",8,1,0,0,1,1,-71.07489014,42.51018906
228,"WALNUT CREEK CA",8,2,0,0,2,2,-122.0670624,37.90636826
228,"WALTHAM MA",8,1,0,0,1,1,-71.2346344,42.37656403
228,"WALTHAM ME",8,1,0,1,0,1,-68.33742523,44.70930862
228,"WARNER ROBINS GA",8,4,1,1,2,4,-83.59963989,32.62118149
228,"WARREN MI",8,221,72,59,90,221,-83.02783203,42.47764969
228,"WARREN OH",8,1,1,0,0,1,-80.81771851,41.23757935
228,"WARRENSBURG MO",8,2,0,1,1,2,-93.73639679,38.76289749
228,"WARRENTON MO",8,2,0,1,1,2,-91.14160919,38.81156921
228,"WARRENTON OR",8,3,1,1,1,3,-123.9260635,46.16466522
228,"WARRENTON VA",8,3,1,2,0,3,-77.79475403,38.71380615
228,"WARSAW IN",8,1,0,0,1,1,-85.85310364,41.23810196
228,"WARWICK PA",8,1,0,1,0,1,-75.78286743,40.16508102
228,"WARWICK RI",8,2,1,0,1,2,-71.37738037,41.69232941
228,"WASHINGTON DC",8,3476,1041,944,1491,3476,-77.01257324,38.88911819
228,"WASHINGTON MO",8,18,7,3,8,18,-91.01213074,38.55807495
228,"WASHOUGAL WA",8,2,1,0,1,2,-122.3545303,45.58441925
228,"WASILLA AK",8,11,5,5,1,11,-149.4517059,61.58290482
228,"WATERBURY CT",8,10,1,4,5,10,-73.05029297,41.55849075
228,"WATERLOO IA",8,15,3,4,8,15,-92.34320831,42.49277496
228,"WATERLOO IL",8,1,0,0,1,1,-90.14981842,38.3361702
228,"WATERTOWN WI",8,2,0,1,1,2,-88.72946167,43.19454193
228,"WATERVILLE ME",8,3,0,1,2,3,-69.63098145,44.55205154
228,"WATERVLIET NY",8,1,0,1,0,1,-73.70020294,42.73034668
228,"WAUCHULA FL",8,7,2,4,1,7,-81.8108902,27.54789543
228,"WAUKESHA WI",8,30,8,9,13,30,-88.23146057,43.01194382
228,"WAUPACA WI",8,1,0,1,0,1,-89.08625793,44.35818863
228,"WAUSAU WI",8,6,0,3,3,6,-89.63059998,44.95904922
228,"WAUWATOSA WI",8,2,1,1,0,2,-88.00754547,43.04960632
228,"WAVERLY NE",8,5,1,2,2,5,-96.52924347,40.9175148
228,"WAYNESBORO GA",8,1,1,0,0,1,-82.01543427,33.09024811
228,"WAYNESVILLE MO",8,1,0,0,1,1,-92.20101166,37.8287735
228,"WAYNESVILLE NC",8,1,0,0,1,1,-82.98840332,35.48899078
228,"WEATHERFORD TX",8,1,0,1,0,1,-97.79758453,32.7595253
228,"WEBSTER GROVES MO",8,5,4,0,1,5,-90.35769653,38.59287262
228,"WEED CA",8,10,4,2,4,10,-122.388382,41.42225266
228,"WEIRTON WV",8,1,0,0,1,1,-80.58799744,40.40523529
228,"WELLESLEY MA",8,1,0,0,1,1,-71.29138947,42.29670715
228,"WELLSVILLE NY",8,1,1,0,0,1,-77.94774628,42.12202454
228,"WENATCHEE WA",8,4,0,2,2,4,-120.3128357,47.42322159
228,"WENTZVILLE MO",8,5,1,1,3,5,-90.85335541,38.81171036
228,"WESLACO TX",8,13,3,1,9,13,-97.99131775,26.16018867
228,"WEST CHESTER OH",8,2,0,2,0,2,-84.40789032,39.33029938
228,"WEST CHESTER PA",8,20,5,8,7,20,-75.60475159,39.96074677
228,"WEST CHICAGO IL",8,1,0,0,1,1,-88.20433807,41.88489914
228,"WEST COVINA CA",8,1,0,0,1,1,-117.9406204,34.0685463
228,"WEST DES MOINES IA",8,1,0,0,1,1,-93.71179962,41.57717514
228,"WEST FARGO ND",8,2,0,0,2,2,-96.90450287,46.87138367
228,"WEST HARTFORD CT",8,8,3,1,4,8,-72.74108887,41.76238251
228,"WEST HOLLYWOOD CA",8,66,18,16,32,66,-118.3634567,34.08982468
228,"WEST JORDAN UT",8,8,4,0,4,8,-111.9405594,40.60975647
228,"WEST LAFAYETTE IN",8,6,2,0,4,6,-86.9082489,40.42613983
228,"WEST LIBERTY IA",8,2,0,0,2,2,-91.26389313,41.57024384
228,"WEST MONROE LA",8,1,1,0,0,1,-92.14794922,32.5187645
228,"WEST ORANGE NJ",8,6,2,2,2,6,-74.23833466,40.7989006
228,"WEST PALM BEACH FL",8,62,14,19,29,62,-80.05298615,26.71585464
228,"WEST PLAINS MO",8,17,8,3,6,17,-91.85284424,36.72810745
228,"WEST SACRAMENTO CA",8,1,0,1,0,1,-121.5324554,38.58049393
228,"WEST TX",8,3,1,1,1,3,-97.09226227,31.80267906
228,"WESTERLY RI",8,2,1,0,1,2,-71.82659149,41.37784958
228,"WESTERVILLE OH",8,19,10,5,4,19,-82.92906952,40.12620926
228,"WESTFIELD IN",8,7,2,3,2,7,-86.12757111,40.04309464
228,"WESTFIELD NJ",8,7,2,2,3,7,-74.34671783,40.65938187
228,"WESTFORD MA",8,1,0,0,1,1,-71.43686676,42.57947159
228,"WESTLAKE OH",8,1,1,0,0,1,-81.91750336,41.45558167
228,"WESTLAND MI",8,2,1,0,1,2,-83.39988708,42.32430649
228,"WESTMINSTER CO",8,4,3,1,0,4,-105.0385208,39.83644867
228,"WESTMINSTER MD",8,3,2,0,1,3,-76.99542999,39.57574463
228,"WESTMONT IL",8,1,0,0,1,1,-87.97566223,41.79613113
228,"WESTPORT NY",8,17,5,4,8,17,-73.43728638,44.18396759
228,"WHEATON IL",8,5,2,1,2,5,-88.10729218,41.86618805
228,"WHITE BEAR LAKE MN",8,1,0,1,0,1,-93.01039886,45.08457947
228,"WHITE HOUSE TN",8,1,1,0,0,1,-86.65110016,36.47054672
228,"WHITE PLAINS NY",8,4,1,2,1,4,-73.76217651,41.03399658
228,"WHITEFISH MT",8,1,0,0,1,1,-114.3380127,48.41337967
228,"WHITEHALL PA",8,2,1,1,0,2,-79.99015045,40.36117554
228,"WHITTIER CA",8,4,3,0,1,4,-118.0349197,33.9793129
228,"WICHITA FALLS TX",8,6,0,2,4,6,-98.49403381,33.91383743
228,"WICHITA KS",8,58,18,14,26,58,-97.3383255,37.69230652
228,"WILKINSBURG PA",8,81,21,23,37,81,-79.88179016,40.44174194
228,"WILLACOOCHEE GA",8,1,1,0,0,1,-83.04568481,31.34116745
228,"WILLARD OH",8,1,0,0,1,1,-82.72633362,41.05332184
228,"WILLIAMSBURG VA",8,12,4,2,6,12,-76.70659637,37.27114868
228,"WILLIAMSPORT PA",8,7,4,0,3,7,-77.00060272,41.24121475
228,"WILLIAMSTOWN KY",8,2,1,1,0,2,-84.56015778,38.63843536
228,"WILLIAMSTOWN MA",8,1,1,0,0,1,-73.21173859,42.70910263
228,"WILLIAMSVILLE NY",8,1,0,0,1,1,-78.73756409,42.96403885
228,"WILLINGBORO NJ",8,5,2,2,1,5,-74.86815643,40.02816391
228,"WILMINGTON DE",8,3,1,1,1,3,-75.54558563,39.74601364
228,"WILMINGTON MA",8,1,0,1,0,1,-71.17237091,42.54682159
228,"WILMINGTON NC",8,20,9,5,6,20,-77.94431305,34.22592926
228,"WILSON NC",8,2,0,1,1,2,-77.914711,35.72143173
228,"WILTON MANORS FL",8,1,1,0,0,1,-80.1386261,26.16088676
228,"WINCHESTER VA",8,1,1,0,0,1,-78.16301727,39.18608475
228,"WINDER GA",8,2,0,1,1,2,-83.71982574,33.99271393
228,"WINDSOR MO",8,26,7,9,10,26,-93.5224762,38.53234863
228,"WINONA MN",8,2,1,0,1,2,-91.63965607,44.04986572
228,"WINSTON-SALEM NC",8,63,19,17,27,63,-80.24356842,36.1001091
228,"WINTER HAVEN FL",8,4,3,0,1,4,-81.73223114,28.02276421
228,"WINTER PARK CO",8,1,0,1,0,1,-105.7649307,39.89161301
228,"WINTER PARK FL",8,13,4,3,6,13,-81.33872223,28.6003685
228,"WISCONSIN RAPIDS WI",8,1,0,0,1,1,-89.81743622,44.38348007
228,"WOBURN MA",8,1,0,0,1,1,-71.15155029,42.47951508
228,"WOODBRIDGE NJ",8,1,1,0,0,1,-74.28398895,40.55769348
228,"WOODBURN OR",8,5,0,2,3,5,-122.8577652,45.14351273
228,"WOODBURY MN",8,9,3,3,3,9,-92.95999908,44.92368698
228,"WOODLAND CA",8,1,0,0,1,1,-121.7751541,38.67827225
228,"WOODLAND PARK CO",8,1,0,0,1,1,-105.0628204,38.98442078
228,"WOOSTER OH",8,3,0,1,2,3,-81.93497467,40.80502319
228,"WORCESTER MA",8,33,9,10,14,33,-71.801651,42.26288986
228,"WRIGHT CITY MO",8,21,5,8,8,21,-91.02021027,38.82786942
228,"WRIGHTSVILLE GA",8,1,0,1,0,1,-82.71939087,32.72949219
228,"WYANDOTTE MI",8,1,0,0,1,1,-83.15003204,42.21445465
228,"WYLIE TX",8,1,0,0,1,1,-96.5396347,33.01520157
228,"WYOMING MI",8,6,3,2,1,6,-85.70549011,42.9133873
228,"YAKIMA WA",8,4,2,0,2,4,-120.508812,46.60157394
228,"YEADON PA",8,1,1,0,0,1,-75.25486755,39.93914032
228,"YELM WA",8,2,0,2,0,2,-122.608902,46.94182968
228,"YONKERS NY",8,6,2,0,4,6,-73.89792633,40.93142319
228,"YORK NE",8,1,0,0,1,1,-97.59262848,40.8681221
228,"YORK PA",8,13,4,3,6,13,-76.72687531,39.96264267
228,"YOUNGSTOWN OH",8,138,28,27,83,138,-80.64901733,41.1000061
228,"YPSILANTI MI",8,14,7,4,3,14,-83.61315155,42.24105453
228,"YUCAIPA CA",8,1,0,0,1,1,-117.0447998,34.03347397
228,"YUMA AZ",8,1,0,0,1,1,-114.6262665,32.72531128
228,"ZANESVILLE OH",8,2,0,0,2,2,-82.01314545,39.94056702
229,"ABERDEEN WA",9,2,1,0,1,2,-123.8181381,46.97493744
229,"ABILENE KS",9,3,0,2,1,3,-97.21461487,38.9171524
229,"ABILENE TX",9,10,2,6,2,10,-99.73384094,32.44894028
229,"ABINGTON PA",9,1,0,1,0,1,-75.11743164,40.12073898
229,"ABSECON NJ",9,10,4,1,5,10,-74.49462128,39.42850494
229,"ACTON MA",9,3,3,0,0,3,-71.43197632,42.48540115
229,"ACWORTH GA",9,2,0,0,2,2,-84.67662811,34.06597519
229,"ADA OK",9,3,0,2,1,3,-96.67899323,34.77481842
229,"ADAIRSVILLE GA",9,2,1,0,1,2,-84.93426514,34.36875153
229,"ADAMS MA",9,1,0,1,0,1,-73.1167984,42.62440872
229,"ADDISON TX",9,5,2,0,3,5,-96.82976532,32.96215057
229,"ADEL GA",9,2,0,1,1,2,-83.42346191,31.13760948
229,"ADRIAN MI",9,3,1,0,2,3,-84.03691101,41.89771652
229,"AIKEN SC",9,5,0,1,4,5,-81.71619415,33.55714417
229,"AKRON OH",9,231,92,47,92,231,-81.51885223,41.08151627
229,"ALAMEDA CA",9,22,5,6,11,22,-122.2444763,37.76513672
229,"ALAMOGORDO NM",9,5,1,4,0,5,-105.9584656,32.90003967
229,"ALAMOSA CO",9,2,0,0,2,2,-105.8724442,37.46229935
229,"ALBANY GA",9,3,0,0,3,3,-84.15510559,31.58296013
229,"ALBANY NY",9,68,20,17,31,68,-73.75520325,42.6529007
229,"ALBANY OR",9,12,5,2,5,12,-123.1083984,44.63620758
229,"ALBEMARLE NC",9,1,0,0,1,1,-80.19947815,35.3506012
229,"ALBUQUERQUE NM",9,300,75,81,144,300,-106.6517639,35.08336639
229,"ALEXANDRIA LA",9,9,4,1,4,9,-92.44517517,31.31143761
229,"ALEXANDRIA MN",9,9,3,4,2,9,-95.37786865,45.88516617
229,"ALEXANDRIA VA",9,71,18,16,37,71,-77.04605103,38.80503082
229,"ALHAMBRA CA",9,2,0,0,2,2,-118.1287003,34.0954628
229,"ALICE TX",9,6,1,3,2,6,-98.07035828,27.7528286
229,"ALIQUIPPA PA",9,1,1,0,0,1,-80.23978424,40.63685608
229,"ALLEN PARK MI",9,5,1,2,2,5,-83.21057892,42.25782394
229,"ALLEN TX",9,1,0,0,1,1,-96.67116547,33.10336685
229,"ALLENTOWN PA",9,11,4,0,7,11,-75.46569824,40.60851288
229,"ALLIANCE NE",9,2,0,0,2,2,-102.8736877,42.10169601
229,"ALPENA MI",9,3,0,1,2,3,-83.43292999,45.06164551
229,"ALPHARETTA GA",9,3,1,0,2,3,-84.29410553,34.07542419
229,"ALSIP IL",9,1,0,1,0,1,-87.73867035,41.66915894
229,"ALTAMONTE SPRINGS FL",9,3,0,2,1,3,-81.39485931,28.66284752
229,"ALTON IL",9,46,17,8,21,46,-90.18429565,38.89074326
229,"ALTOONA IA",9,3,1,0,2,3,-93.46868896,41.64997482
229,"ALTOONA PA",9,2,0,1,1,2,-78.39411163,40.51860046
229,"ALTUS OK",9,2,0,1,1,2,-99.33457184,34.63834
229,"AMARILLO TX",9,16,5,7,4,16,-101.8324051,35.22210312
229,"AMELIA OH",9,1,0,0,1,1,-84.21751404,39.0284462
229,"AMERICUS GA",9,1,0,0,1,1,-84.23246002,32.07291031
229,"AMES IA",9,12,3,1,8,12,-93.61370087,42.02269363
229,"AMHERST MA",9,8,2,1,5,8,-72.5192337,42.37371826
229,"AMHERST NY",9,1,0,0,1,1,-78.79901886,42.9784317
229,"ANAHEIM CA",9,28,8,5,15,28,-117.9165115,33.8354454
229,"ANCHORAGE AK",9,80,18,19,43,80,-149.8811951,61.21649933
229,"ANDERSON IN",9,17,2,3,12,17,-85.68051147,40.1053772
229,"ANDERSON SC",9,8,4,2,2,8,-82.65641785,34.50934219
229,"ANDOVER KS",9,2,0,1,1,2,-97.13726807,37.71379852
229,"ANDOVER MN",9,1,0,1,0,1,-93.29158783,45.23327637
229,"ANKENY IA",9,2,0,2,0,2,-93.60646057,41.72983551
229,"ANN ARBOR MI",9,178,56,43,79,178,-83.74536896,42.28347015
229,"ANNAPOLIS MD",9,12,6,2,4,12,-76.49166107,38.97844696
229,"ANNISTON AL",9,1,1,0,0,1,-85.8313446,33.65997314
229,"ANNVILLE PA",9,1,0,0,1,1,-76.51483917,40.32979584
229,"ANTIOCH CA",9,7,1,2,4,7,-121.808136,38.0049057
229,"APACHE JUNCTION AZ",9,9,4,2,3,9,-111.5511551,33.41511536
229,"APEX NC",9,4,2,0,2,4,-78.84952545,35.73279572
229,"APOPKA FL",9,1,1,0,0,1,-81.5089798,28.68117523
229,"APPLE VALLEY MN",9,1,1,0,0,1,-93.21794128,44.73189926
229,"APPLETON WI",9,5,0,3,2,5,-88.41551208,44.2618866
229,"ARANSAS PASS TX",9,1,1,0,0,1,-97.150383,27.91025734
229,"ARCADIA CA",9,6,1,1,4,6,-118.0368881,34.1397934
229,"ARCATA CA",9,4,1,1,2,4,-124.08564,40.86624527
229,"ARCHDALE NC",9,1,1,0,0,1,-79.97145844,35.91481018
229,"ARDMORE OK",9,5,2,0,3,5,-97.14401245,34.17425156
229,"ARKANSAS CITY KS",9,1,0,0,1,1,-97.03897858,37.06211472
229,"ARLINGTON HEIGHTS IL",9,15,3,5,7,15,-87.98104858,42.08821106
229,"ARLINGTON MA",9,1,1,0,0,1,-71.15559387,42.41545486
229,"ARLINGTON TX",9,99,23,30,46,99,-97.10882568,32.73590469
229,"ARNOLD MO",9,3,0,1,2,3,-90.37690735,38.43906784
229,"ARROYO GRANDE CA",9,3,0,1,2,3,-120.5928879,35.11868668
229,"ASBURY PARK NJ",9,6,1,1,4,6,-74.01100159,40.22047806
229,"ASHEBORO NC",9,2,1,1,0,2,-79.81291199,35.70822525
229,"ASHEVILLE NC",9,74,19,22,33,74,-82.55367279,35.60134888
229,"ASHLAND IL",9,1,0,1,0,1,-90.00800323,39.88794327
229,"ASHLAND KY",9,2,1,0,1,2,-82.63764954,38.47874069
229,"ASHLAND MO",9,4,0,0,4,4,-92.25737762,38.77433395
229,"ASHLAND OR",9,19,8,2,9,19,-122.7111359,42.19425583
229,"ASHLAND VA",9,11,2,3,6,11,-77.47959137,37.75937653
229,"ASHLAND WI",9,1,0,0,1,1,-90.88419342,46.59241104
229,"ASPEN CO",9,8,3,2,3,8,-106.8185959,39.19105911
229,"ASTORIA OR",9,2,0,0,2,2,-123.8339157,46.18756866
229,"ATASCADERO CA",9,4,0,3,1,4,-120.6487961,35.47494888
229,"ATHENS AL",9,1,0,1,0,1,-86.97190857,34.80292892
229,"ATHENS IL",9,1,0,0,1,1,-89.72410583,39.96085739
229,"ATHENS OH",9,11,3,3,5,11,-82.10113525,39.32934952
229,"ATLANTA GA",9,2711,759,621,1331,2711,-84.38757324,33.74927521
229,"ATLANTIC CITY NJ",9,38,15,8,15,38,-74.42202759,39.36457062
229,"AUBURN AL",9,18,4,9,5,18,-85.48087311,32.61021423
229,"AUBURN CA",9,236,72,56,108,236,-121.0794067,38.89623642
229,"AUBURN WA",9,2,0,2,0,2,-122.2304688,47.30677795
229,"AURORA CO",9,58,16,14,28,58,-104.8693161,39.73983765
229,"AURORA IL",9,16,6,2,8,16,-88.32048798,41.76070023
229,"AUSTIN MN",9,1,0,0,1,1,-92.97491455,43.6665535
229,"AUSTIN TX",9,1222,333,307,582,1222,-97.74386597,30.26748466
229,"AUSTINTOWN OH",9,3,1,2,0,3,-80.76424408,41.10162354
229,"AVA MO",9,1,0,0,1,1,-92.6605835,36.95189667
229,"AVIS PA",9,1,1,0,0,1,-77.31352997,41.1848526
229,"AVON OH",9,1,0,0,1,1,-82.0351944,41.45196533
229,"AVONDALE AZ",9,5,1,1,3,5,-112.3513947,33.43592072
229,"AZLE TX",9,17,1,3,13,17,-97.54621887,32.89556885
229,"BABYLON NY",9,1,0,0,1,1,-73.3247757,40.696064
229,"BAKERSFIELD CA",9,41,9,7,25,41,-119.0206375,35.37326813
229,"BALDWIN CITY KS",9,3,2,1,0,3,-95.18656921,38.77522659
229,"BALDWIN IL",9,1,0,1,0,1,-89.84280396,38.1832962
229,"BALDWYN MS",9,3,1,1,1,3,-88.63553619,34.5099411
229,"BALLWIN MO",9,51,22,7,22,51,-90.54669189,38.5951004
229,"BALTIMORE MD",9,783,213,184,386,783,-76.6115799,39.29075623
229,"BANDON OR",9,2,0,0,2,2,-124.4105606,43.11890793
229,"BANGOR ME",9,9,3,2,4,9,-68.77653503,44.80109406
229,"BANGOR PA",9,1,0,1,0,1,-75.20609283,40.86587524
229,"BAR HARBOR ME",9,15,8,2,5,15,-68.20309448,44.38752747
229,"BARBOURVILLE KY",9,1,0,0,1,1,-83.88861084,36.86665726
229,"BARDSTOWN KY",9,4,1,0,1,2,-85.46318817,37.810512545
229,"BARNESVILLE GA",9,1,0,1,0,1,-84.15583038,33.05487442
229,"BARSTOW CA",9,2,1,1,0,2,-117.0245132,34.89870071
229,"BARTLETT TN",9,3,1,0,2,3,-89.87441254,35.20460892
229,"BARTONVILLE IL",9,50,14,17,19,50,-89.65235138,40.6502037
229,"BASALT CO",9,1,0,0,1,1,-107.0336685,39.36895752
229,"BASTROP LA",9,1,0,0,1,1,-91.91439819,32.77897644
229,"BASTROP TX",9,2,1,0,1,2,-97.31572723,30.11092758
229,"BATAVIA NY",9,3,2,0,1,3,-78.18697357,42.99835587
229,"BATESVILLE MS",9,1,1,0,0,1,-89.94464874,34.31167603
229,"BATON ROUGE LA",9,120,30,29,61,120,-91.15479279,30.45132256
229,"BAXTER SPRINGS KS",9,1,0,0,1,1,-94.73813629,37.02472305
229,"BAY LAKE FL",9,3,1,1,1,3,-81.92185974,28.45840073
229,"BAY VILLAGE OH",9,6,5,1,0,6,-81.92155457,41.48464966
229,"BAYONNE NJ",9,1,0,0,1,1,-74.10975647,40.66794968
229,"BAYTOWN TX",9,21,7,5,9,21,-94.97782135,29.73608589
229,"BEACON NY",9,4,1,1,2,4,-73.9688797,41.50502014
229,"BEAUFORT SC",9,4,1,1,2,4,-80.68718719,32.44019699
229,"BEAUMONT CA",9,1,1,0,0,1,-116.9783173,33.9292717
229,"BEAUMONT TX",9,13,0,3,10,13,-94.10238647,30.08622551
229,"BEAVER PA",9,1,1,0,0,1,-80.30450439,40.69532776
229,"BEAVER UT",9,1,0,1,0,1,-112.6483307,38.27668381
229,"BEAVERTON OR",9,15,6,6,3,15,-122.8055344,45.48670197
229,"BEDFORD OH",9,2,1,1,0,2,-81.53594208,41.39339828
229,"BEDFORD PA",9,6,3,2,1,6,-78.50319672,40.01898575
229,"BEDFORD TX",9,1,1,0,0,1,-97.14364624,32.8442955
229,"BEECH GROVE IN",9,1,0,0,1,1,-86.08973694,39.72201157
229,"BEL AIR MD",9,2,2,0,0,2,-76.34788513,39.53611374
229,"BELL CA",9,1,0,1,0,1,-118.1889572,33.97753906
229,"BELLAIRE MI",9,1,0,0,1,1,-85.21157837,44.98040009
229,"BELLAIRE TX",9,1,1,0,0,1,-95.4592514,29.70632935
229,"BELLE GLADE FL",9,1,0,0,1,1,-80.66747284,26.68785477
229,"BELLEVIEW FL",9,3,0,2,1,3,-82.06185913,29.05568314
229,"BELLEVILLE IL",9,44,11,8,25,44,-89.98438263,38.52002716
229,"BELLEVILLE NJ",9,1,0,0,1,1,-74.14912415,40.79369736
229,"BELLEVUE IA",9,1,1,0,0,1,-90.42323303,42.25885773
229,"BELLEVUE NE",9,1,1,0,0,1,-95.89156342,41.13648224
229,"BELLEVUE WA",9,31,11,7,13,31,-122.2029648,47.61014557
229,"BELLFLOWER CA",9,4,1,1,2,4,-118.1186295,33.88169479
229,"BELLINGHAM WA",9,31,5,6,20,31,-122.4727402,48.76121521
229,"BELLMAWR NJ",9,1,1,0,0,1,-75.09385681,39.86771774
229,"BELMONT CA",9,5,3,0,2,5,-122.2783508,37.51996613
229,"BELMONT MS",9,1,0,1,0,1,-88.20941162,34.51007462
229,"BELTON MO",9,3,0,0,3,3,-94.53222656,38.81176376
229,"BELTON TX",9,4,1,2,1,4,-97.46511841,31.05611229
229,"BEMIDJI MN",9,2,1,0,1,2,-94.88105774,47.47352982
229,"BEND OR",9,24,2,7,15,24,-121.3171387,44.0577774
229,"BENSENVILLE IL",9,2,0,2,0,2,-87.94012451,41.95510483
229,"BENTON AR",9,1,0,0,1,1,-92.58699036,34.56454468
229,"BENTON HARBOR MI",9,1,0,0,1,1,-86.45429993,42.11692429
229,"BENTONVILLE AR",9,13,3,3,7,13,-94.20933533,36.3728447
229,"BEREA OH",9,2,0,0,2,2,-81.85396576,41.36633301
229,"BERGENFIELD NJ",9,1,0,1,0,1,-73.99640656,40.92791748
229,"BERKELEY CA",9,320,92,77,151,320,-122.2752533,37.87145615
229,"BERKELEY MO",9,2,1,0,1,2,-90.33169556,38.75470734
229,"BERWYN IL",9,1,0,1,0,1,-87.79390717,41.85061646
229,"BESSEMER AL",9,2,0,0,2,2,-86.95465851,33.40222549
229,"BETHALTO IL",9,1,1,0,0,1,-90.04077911,38.90911865
229,"BETHEL PARK PA",9,2,0,0,2,2,-80.01592255,40.33843613
229,"BETHLEHEM PA",9,7,4,0,3,7,-75.36949921,40.62598801
229,"BETTENDORF IA",9,2,0,2,0,2,-90.51612854,41.52465439
229,"BEVERLY HILLS CA",9,34,11,9,14,34,-118.4019775,34.07383347
229,"BEVERLY MA",9,2,0,0,2,2,-70.87913513,42.55848312
229,"BEXLEY OH",9,2,1,1,0,2,-82.93772888,39.96929932
229,"BIG SPRING TX",9,1,1,0,0,1,-101.4811173,32.25181198
229,"BILLINGS MT",9,6,1,0,5,6,-108.504631,45.7833786
229,"BILOXI MS",9,2,0,0,2,2,-88.89369202,30.40021133
229,"BINGHAMTON NY",9,17,1,7,9,17,-75.91755676,42.0986557
229,"BIRMINGHAM AL",9,150,39,35,76,150,-86.80226898,33.52098846
229,"BIRMINGHAM MI",9,10,2,1,7,10,-83.21121216,42.54697418
229,"BISBEE AZ",9,53,19,13,21,53,-109.9298477,31.44821548
229,"BISMARCK ND",9,2,1,0,1,2,-100.7789612,46.80673981
229,"BIXBY OK",9,31,5,8,18,31,-95.88382721,35.94215775
229,"BLACKFOOT ID",9,1,0,0,1,1,-112.3463059,43.1905098
229,"BLACKSBURG VA",9,9,3,3,3,9,-80.41369629,37.22999573
229,"BLANKET TX",9,1,0,0,1,1,-98.78768921,31.82418633
229,"BLOOMFIELD HILLS MI",9,5,1,2,2,5,-83.24560547,42.58376312
229,"BLOOMINGTON IL",9,6,3,0,3,6,-88.99375916,40.48418045
229,"BLOOMINGTON IN",9,42,11,6,25,42,-86.53382874,39.16920471
229,"BLOOMINGTON MN",9,6,0,2,4,6,-93.29154205,44.82648849
229,"BLUE ASH OH",9,1,1,0,0,1,-84.37797546,39.23192215
229,"BLUE ISLAND IL",9,1,0,0,1,1,-87.67993927,41.657444
229,"BLUE SPRINGS MO",9,3,2,1,0,3,-94.2820816,39.01689148
229,"BLUEFIELD WV",9,1,0,1,0,1,-81.21854401,37.27106094
229,"BLUFF CITY TN",9,1,0,1,0,1,-82.26051331,36.47451019
229,"BLUFFTON SC",9,1,0,1,0,1,-80.86026001,32.23733902
229,"BOARDMAN OH",9,1,0,0,1,1,-80.66256714,41.02441788
229,"BOCA RATON FL",9,22,7,3,12,22,-80.08280182,26.35960197
229,"BOILING SPRINGS NC",9,2,1,0,1,2,-81.66678619,35.25450516
229,"BOLINGBROOK IL",9,14,4,5,5,14,-88.06878662,41.69866562
229,"BOMBAY NY",9,1,1,0,0,1,-74.5668869,44.93919373
229,"BONNE TERRE MO",9,2,0,2,0,2,-90.55574036,37.92339325
229,"BONNER SPRINGS KS",9,1,0,1,0,1,-94.88421631,39.05975342
229,"BONNEY LAKE WA",9,1,1,0,0,1,-122.1883698,47.17679596
229,"BOONE IA",9,5,1,1,3,5,-93.88450623,42.06530762
229,"BOONE NC",9,3,1,1,1,3,-81.67436218,36.21696472
229,"BORDENTOWN NJ",9,7,1,2,4,7,-74.7159729,40.15003586
229,"BOSTON MA",9,1467,384,358,725,1467,-71.05905151,42.35883713
229,"BOTHELL WA",9,7,1,3,3,7,-122.2075424,47.75966263
229,"BOULDER CO",9,132,48,32,52,132,-105.2715302,40.01483917
229,"BOUNTIFUL UT",9,9,3,3,3,9,-111.8825684,40.88913345
229,"BOWIE MD",9,9,3,3,3,9,-76.77848816,39.00718689
229,"BOWLING GREEN KY",9,21,5,6,10,21,-86.4437027,36.99057388
229,"BOWLING GREEN OH",9,7,3,2,2,7,-83.65102386,41.37505341
229,"BOYNTON BEACH FL",9,15,6,2,7,15,-80.066185,26.52592087
229,"BOYS TOWN NE",9,3,0,1,2,3,-96.13262177,41.26118088
229,"BOZEMAN MT",9,5,1,2,2,5,-111.0471649,45.6803093
229,"BRADENTON FL",9,6,3,2,1,6,-82.57459259,27.49969101
229,"BRANDON MS",9,3,0,1,2,3,-89.98616028,32.27327728
229,"BRANSON MO",9,10,1,2,7,10,-93.21912384,36.64381409
229,"BRATTLEBORO VT",9,3,1,1,1,3,-72.55673981,42.85120392
229,"BRECKENRIDGE CO",9,2,0,2,0,2,-106.0398636,39.48156357
229,"BREMEN GA",9,1,1,0,0,1,-85.1452179,33.72130585
229,"BREMERTON WA",9,2,1,0,1,2,-122.6345291,47.56690598
229,"BRENTWOOD CA",9,3,1,0,2,3,-121.6984329,37.93167496
229,"BRENTWOOD TN",9,3,1,1,1,3,-86.78275299,36.03345108
229,"BREVARD NC",9,7,0,2,5,7,-82.73400116,35.23363113
229,"BRIDGEPORT CT",9,14,7,6,1,14,-73.2040863,41.16743088
229,"BRIDGETON MO",9,1,1,0,0,1,-90.41161346,38.76696396
229,"BRIDGETON NJ",9,4,0,1,3,4,-75.23321533,39.42769623
229,"BRIGHAM CITY UT",9,1,0,1,0,1,-112.0170517,41.50990677
229,"BRIGHTON MI",9,4,1,2,1,4,-83.78043365,42.52965546
229,"BRISTOL CT",9,6,1,2,3,6,-72.94853973,41.67193222
229,"BRISTOL RI",9,2,1,0,1,2,-71.26984406,41.67538452
229,"BRISTOL TN",9,9,2,2,5,9,-82.17338562,36.58886719
229,"BROADVIEW HEIGHTS OH",9,1,0,0,1,1,-81.68503571,41.31410217
229,"BROADVIEW IL",9,2,1,1,0,2,-87.85337067,41.86410522
229,"BROCKPORT NY",9,1,0,0,1,1,-77.93889618,43.213871
229,"BROCKTON MA",9,5,0,1,4,5,-71.01748657,42.08340454
229,"BROKEN ARROW OK",9,6,3,3,0,6,-95.79160309,36.05273056
229,"BROOKFIELD IL",9,32,10,4,18,32,-87.85184479,41.82412338
229,"BROOKFIELD WI",9,1,0,0,1,1,-88.10640717,43.06070328
229,"BROOKINGS OR",9,4,1,2,1,4,-124.2865219,42.05229187
229,"BROOKINGS SD",9,2,0,1,1,2,-96.79450989,44.3097229
229,"BROOKLINE MA",9,2,0,0,2,2,-71.12002563,42.33176804
229,"BROOKSIDE VILLAGE TX",9,2,1,0,1,2,-95.32555389,29.58737183
229,"BROOMFIELD CO",9,5,1,1,3,5,-105.0877686,39.92069244
229,"BROWNSTOWN IN",9,1,1,0,0,1,-86.04185486,38.87921143
229,"BROWNSVILLE OR",9,1,0,1,0,1,-122.9877396,44.39308929
229,"BROWNSVILLE TX",9,14,4,2,8,14,-97.4977951,25.90228081
229,"BRUNSWICK ME",9,3,0,1,2,3,-69.96412659,43.91474533
229,"BRUNSWICK OH",9,9,1,5,3,9,-81.84169769,41.23830795
229,"BRYAN OH",9,1,0,0,1,1,-84.54946899,41.47367859
229,"BRYAN TX",9,3,3,0,0,3,-96.3704071,30.67456818
229,"BRYANT AR",9,1,0,0,1,1,-92.48953247,34.59588242
229,"BUCKHANNON WV",9,1,1,0,0,1,-80.22968292,38.99204254
229,"BUENA PARK CA",9,1,0,0,1,1,-117.999939,33.86748123
229,"BUENA VISTA CO",9,2,1,0,1,2,-106.1334534,38.84151459
229,"BUFFALO NY",9,229,56,61,112,229,-78.87787628,42.8867836
229,"BURBANK CA",9,23,7,7,9,23,-118.3104782,34.18065262
229,"BURLINGAME CA",9,2,0,1,1,2,-122.3685074,37.58408737
229,"BURLINGTON MA",9,2,1,0,1,2,-71.19434357,42.50506973
229,"BURLINGTON NJ",9,1,0,0,1,1,-74.86417389,40.07125092
229,"BURLINGTON VT",9,79,30,23,26,79,-73.20542908,44.47687531
229,"BURNSVILLE MN",9,2,1,1,0,2,-93.27822113,44.76760483
229,"BURNSVILLE NC",9,1,1,0,0,1,-82.30067444,35.91744614
229,"BUTLER PA",9,4,0,0,4,4,-79.89468384,40.86117172
229,"BYRON WY",9,9,2,1,6,9,-108.5082169,44.79620361
229,"CABLE WI",9,1,1,0,0,1,-91.2926712,46.20778275
229,"CAHOKIA IL",9,4,1,0,3,4,-90.19016266,38.57118225
229,"CAIRO GA",9,3,1,0,2,3,-84.20102692,30.87791824
229,"CALABASAS CA",9,3,1,0,2,3,-118.6473236,34.1558876
229,"CALDWELL ID",9,1,0,0,1,1,-116.6891098,43.66285324
229,"CALEDONIA MI",9,1,0,0,1,1,-85.51702118,42.78935623
229,"CALERA AL",9,1,0,1,0,1,-86.75354004,33.10300064
229,"CALIFORNIA PA",9,2,0,0,2,2,-79.89154053,40.06599426
229,"CALIMESA CA",9,1,1,0,0,1,-117.0634689,34.00385666
229,"CALLAHAN FL",9,1,0,0,1,1,-81.83045959,30.56256294
229,"CALUMET CITY IL",9,1,1,0,0,1,-87.5293045,41.61571884
229,"CALUMET MI",9,2,1,1,0,2,-88.45446777,47.24640274
229,"CAMARILLO CA",9,26,9,7,10,26,-119.0400391,34.21628952
229,"CAMBRIDGE MA",9,91,29,23,39,91,-71.10369873,42.36532593
229,"CAMDEN NJ",9,13,7,1,5,13,-75.118927,39.92608261
229,"CAMP HILL PA",9,1,1,0,0,1,-76.9335022,40.24120331
229,"CAMPBELL CA",9,2,0,0,2,2,-121.951973,37.287117
229,"CANAL WINCHESTER OH",9,1,0,0,1,1,-82.80456543,39.84274673
229,"CANANDAIGUA NY",9,7,1,2,4,7,-77.28107452,42.88830948
229,"CANBY OR",9,1,0,0,1,1,-122.6948166,45.26276779
229,"CANTON GA",9,2,1,0,1,2,-84.48571014,34.23356628
229,"CANTON IL",9,2,0,1,1,2,-90.03516388,40.55800247
229,"CANTON NY",9,5,3,0,2,5,-75.16870117,44.59575272
229,"CANTON OH",9,14,3,3,8,14,-81.37824249,40.79906845
229,"CANTON TX",9,1,0,0,1,1,-95.86379242,32.55702591
229,"CAPE CORAL FL",9,16,8,3,5,16,-81.9491806,26.56343079
229,"CAPE GIRARDEAU MO",9,51,18,9,24,51,-89.51838684,37.30613327
229,"CAPE MAY NJ",9,1,0,0,1,1,-74.90522766,38.93513107
229,"CAPITOL HEIGHTS MD",9,2,1,0,1,2,-76.91506195,38.88552475
229,"CARBONDALE IL",9,5,2,1,2,5,-89.2168808,37.7274704
229,"CARBONDALE PA",9,1,1,0,0,1,-75.50098419,41.57386398
229,"CARLSBAD CA",9,8,3,1,4,8,-117.3528137,33.1580162
229,"CARMEL IN",9,7,0,3,4,7,-86.12607574,39.97961426
229,"CARMEL NY",9,1,0,0,1,1,-73.67949677,41.43042755
229,"CAROLINA BEACH NC",9,1,0,1,0,1,-77.89279175,34.03543472
229,"CARPINTERIA CA",9,1,1,0,0,1,-119.5201263,34.39894485
229,"CARRBORO NC",9,14,5,2,7,14,-79.07286835,35.91213989
229,"CARRIZO SPRINGS TX",9,1,0,0,1,1,-99.86119843,28.52256584
229,"CARROLL IA",9,1,0,0,1,1,-94.86740875,42.06593704
229,"CARROLLTON GA",9,7,3,0,4,7,-85.07631683,33.58019638
229,"CARROLLTON OH",9,1,0,0,1,1,-81.08522034,40.57297134
229,"CARROLLTON TX",9,6,1,0,5,6,-96.89080811,32.95380783
229,"CARSON CA",9,9,2,1,6,9,-118.2837448,33.8312645
229,"CARSON CITY NV",9,8,3,2,3,8,-119.7687988,39.16352844
229,"CARTERET NJ",9,5,0,0,5,5,-74.2276535,40.57754135
229,"CARTERSVILLE GA",9,1,0,0,1,1,-84.79982758,34.1654892
229,"CARTHAGE MO",9,1,0,0,1,1,-94.31087494,37.17650223
229,"CARTHAGE TN",9,1,0,1,0,1,-85.95146179,36.2523613
229,"CARY NC",9,40,17,7,16,40,-78.78055573,35.79200745
229,"CARYVILLE TN",9,1,0,0,1,1,-84.22605133,36.2987175
229,"CASA GRANDE AZ",9,16,4,5,7,16,-111.7590179,32.87965393
229,"CASCADE LOCKS OR",9,2,1,0,1,2,-121.8928452,45.66971588
229,"CASTLE ROCK CO",9,2,2,0,0,2,-104.857811,39.37207031
229,"CAVE CREEK AZ",9,1,0,1,0,1,-111.9523544,33.83345795
229,"CAYCE SC",9,1,1,0,0,1,-81.05870819,33.97318649
229,"CAZENOVIA NY",9,3,1,1,1,3,-75.85186005,42.93000031
229,"CEDAR FALLS IA",9,1,0,0,1,1,-92.44594574,42.52773285
229,"CEDAR HILL TX",9,10,3,0,2,5,-99.08098985,33.36628723
229,"CEDAR PARK TX",9,1,0,1,0,1,-97.82061005,30.50554466
229,"CEDAR RAPIDS IA",9,34,4,12,18,34,-91.66259766,41.98337555
229,"CENTER LINE MI",9,1,0,0,1,1,-83.02747345,42.48490524
229,"CENTER POINT AL",9,2,0,0,2,2,-86.68362427,33.64584732
229,"CENTRAL SC",9,8,4,4,0,8,-82.78075409,34.72467041
229,"CENTRALIA IL",9,1,0,0,1,1,-89.13375092,38.52496719
229,"CENTRALIA WA",9,1,1,0,0,1,-122.9679337,46.71740723
229,"CERES CA",9,15,5,2,8,15,-120.9599075,37.59457016
229,"CHAMBERLAIN SD",9,1,0,0,1,1,-99.33099365,43.80810547
229,"CHAMBERSBURG PA",9,1,1,0,0,1,-77.66046906,39.93768692
229,"CHAMBLEE GA",9,1,0,0,1,1,-84.29881287,33.89216995
229,"CHAMPAIGN IL",9,46,12,11,23,46,-88.24346161,40.11659622
229,"CHANDLER AZ",9,38,13,11,14,38,-111.8428345,33.3062439
229,"CHANDLER OK",9,3,0,3,0,3,-96.88135529,35.70169067
229,"CHAPEL HILL NC",9,104,32,15,57,104,-79.05697632,35.91110611
229,"CHARLESTON IL",9,1,0,0,1,1,-88.17610931,39.49612045
229,"CHARLESTON SC",9,153,40,39,74,153,-79.93032074,32.77671814
229,"CHARLESTON WV",9,43,14,13,16,43,-81.63149261,38.34872055
229,"CHARLESTOWN IN",9,1,1,0,0,1,-85.67014313,38.45307159
229,"CHARLOTTE MI",9,1,0,0,1,1,-84.83589935,42.56380844
229,"CHARLOTTE NC",9,552,167,122,263,552,-80.84257507,35.22746277
229,"CHARLOTTESVILLE VA",9,77,19,19,39,77,-78.49123383,38.03798676
229,"CHASKA MN",9,1,0,0,1,1,-93.60231781,44.78918457
229,"CHATHAM IL",9,1,0,0,1,1,-89.70467377,39.67619324
229,"CHATHAM MA",9,1,0,0,1,1,-69.95849609,41.68234253
229,"CHATTANOOGA TN",9,70,17,19,34,70,-85.30583954,35.04058456
229,"CHEEKTOWAGA NY",9,3,1,1,1,3,-78.75413513,42.90357208
229,"CHELSEA AL",9,4,0,4,0,4,-86.63014984,33.34026718
229,"CHENEY WA",9,3,2,1,0,3,-117.5782547,47.48730087
229,"CHERRY HILL NJ",9,11,3,3,5,11,-75.03024292,39.93510437
229,"CHERRYVALE KS",9,1,0,0,1,1,-95.55271912,37.270504
229,"CHESAPEAKE VA",9,32,13,6,13,32,-76.27422333,36.81948853
229,"CHESHIRE CT",9,1,0,0,1,1,-72.89962006,41.50049591
229,"CHESTER PA",9,3,1,0,2,3,-75.35475159,39.84973145
229,"CHESTER SC",9,10,5,1,4,10,-81.2141037,34.7049675
229,"CHESTER WV",9,1,0,1,0,1,-80.56246948,40.61351013
229,"CHESTERFIELD MO",9,26,13,3,10,26,-90.5772934,38.6631279
229,"CHEVERLY MD",9,1,1,0,0,1,-76.91530609,38.92858505
229,"CHEVY CHASE MD",9,2,0,1,1,2,-77.07595825,38.97138977
229,"CHEWELAH WA",9,4,1,1,2,4,-117.7169418,48.27609634
229,"CHEYENNE WY",9,5,3,2,0,5,-104.8183899,41.13345718
229,"CHICAGO IL",9,2549,693,612,1244,2549,-87.6503067,41.85000992
229,"CHICO CA",9,128,38,32,58,128,-121.839447,39.72846222
229,"CHICOPEE MA",9,1,1,0,0,1,-72.60691071,42.14902496
229,"CHILLICOTHE MO",9,4,1,0,3,4,-93.55298615,39.79542542
229,"CHINA GROVE NC",9,1,0,0,1,1,-80.58115387,35.56945801
229,"CHINO CA",9,2,1,1,0,2,-117.6906662,34.0121727
229,"CHOCTAW OK",9,1,1,0,0,1,-97.26795197,35.49282074
229,"CHULA VISTA CA",9,5,1,2,2,5,-117.0857468,32.64037704
229,"CIMARRON NM",9,1,0,0,1,1,-104.9185333,36.51176453
229,"CINCINNATI OH",9,223,62,51,110,223,-84.51939392,39.10413742
229,"CITRUS HEIGHTS CA",9,1,0,0,1,1,-121.2829208,38.70672607
229,"CLAREMONT CA",9,1,0,0,1,1,-117.7214508,34.09675217
229,"CLARKS SUMMIT PA",9,1,0,1,0,1,-75.70759583,41.48881531
229,"CLARKSBURG WV",9,5,3,0,2,5,-80.34414673,39.28092575
229,"CLARKSDALE MS",9,1,1,0,0,1,-90.57128143,34.20030212
229,"CLARKSVILLE TN",9,12,3,2,7,12,-87.35944366,36.52993011
229,"CLAYPOOL IN",9,1,1,0,0,1,-85.88032532,41.1293335
229,"CLAYTON MO",9,7,4,1,2,7,-90.32382965,38.64260101
229,"CLEAR LAKE SHORES TX",9,237,70,87,80,237,-95.03226471,29.54773712
229,"CLEARFIELD UT",9,1,0,0,1,1,-112.0273361,41.11647415
229,"CLEARWATER FL",9,18,3,5,10,18,-82.79984283,27.9665451
229,"CLEBURNE TX",9,3,1,0,2,3,-97.38722992,32.34804535
229,"CLEMSON SC",9,3,1,1,1,3,-82.83683014,34.68382645
229,"CLEVELAND HEIGHTS OH",9,16,4,8,4,16,-81.55568695,41.52017975
229,"CLEVELAND OH",9,650,178,154,318,650,-81.69516754,41.49978256
229,"CLEVELAND TN",9,4,0,3,1,4,-84.87675476,35.15940094
229,"CLEVELAND TX",9,4,2,0,2,4,-95.08600616,30.34188652
229,"CLIFTON NJ",9,1,0,0,1,1,-74.16278076,40.85860062
229,"CLINTON IN",9,1,1,0,0,1,-87.39801025,39.65688324
229,"CLINTON LA",9,1,0,1,0,1,-91.0161438,30.86631775
229,"CLINTON MS",9,1,1,0,0,1,-90.33226776,32.34069061
229,"CLIVE IA",9,6,2,3,1,6,-93.72477722,41.60302734
229,"CLOVIS CA",9,10,4,2,4,10,-119.7047043,36.82522583
229,"COACHELLA CA",9,1,0,0,1,1,-116.1753616,33.68059158
229,"COATESVILLE PA",9,1,0,0,1,1,-75.82329559,39.98334885
229,"COATS NC",9,1,0,1,0,1,-78.6716156,35.40827179
229,"COCOA BEACH FL",9,1,1,0,0,1,-80.6068573,28.3203907
229,"COEUR D'ALENE ID",9,4,0,2,2,4,-116.781929,47.67768478
229,"COLLEGE PARK GA",9,14,2,3,9,14,-84.44933319,33.65347672
229,"COLLEGE PARK MD",9,314,86,71,157,314,-76.93619537,38.98080444
229,"COLLEGE STATION TX",9,25,2,12,11,25,-96.33758545,30.62316895
229,"COLLINGSWOOD NJ",9,1,1,0,0,1,-75.07028961,39.9186058
229,"COLLINSVILLE AL",9,1,0,0,1,1,-85.86063385,34.26427078
229,"COLLINSVILLE IL",9,14,3,3,8,14,-89.98478699,38.67050171
229,"COLMA CA",9,3,1,0,2,3,-122.4610977,37.67665482
229,"COLOMA MI",9,1,0,0,1,1,-86.30813599,42.18628693
229,"COLONIE NY",9,3,0,1,2,3,-73.83889771,42.72444534
229,"COLORADO SPRINGS CO",9,78,25,12,41,78,-104.8225174,38.83369446
229,"COLTON CA",9,1,1,0,0,1,-117.3153687,34.0738945
229,"COLUMBIA IL",9,2,1,1,0,2,-90.20130157,38.44375992
229,"COLUMBIA KY",9,3,1,0,2,3,-85.30601501,37.10298538
229,"COLUMBIA MO",9,238,68,46,124,238,-92.33429718,38.95169067
229,"COLUMBIA MS",9,1,1,0,0,1,-89.82949829,31.25465012
229,"COLUMBIA SC",9,122,30,26,66,122,-81.04045105,34.00138855
229,"COLUMBIA TN",9,10,2,2,6,10,-87.03533173,35.61502457
229,"COLUMBUS GA",9,122,29,19,74,122,-84.98313141,32.46828842
229,"COLUMBUS IN",9,5,4,0,1,5,-85.92284393,39.20959473
229,"COLUMBUS MS",9,2,0,2,0,2,-88.42742157,33.49581909
229,"COLUMBUS OH",9,746,212,195,339,746,-82.99890137,39.96136475
229,"COMER GA",9,1,0,0,1,1,-83.12491608,34.06397629
229,"COMPTON CA",9,35,6,10,19,35,-118.2218704,33.89606857
229,"CONCORD CA",9,15,2,8,5,15,-122.0333328,37.97780228
229,"CONCORD NC",9,3,1,0,2,3,-80.57880402,35.4092598
229,"CONCORD NH",9,1,0,0,1,1,-71.53688812,43.20820999
229,"CONNELL WA",9,18,7,2,9,18,-118.863533,46.66334534
229,"CONNERSVILLE IN",9,1,0,0,1,1,-85.13545227,39.64817047
229,"CONOVER NC",9,8,1,2,5,8,-81.21835327,35.70663834
229,"CONROE TX",9,1,1,0,0,1,-95.45646667,30.31249237
229,"CONSHOHOCKEN PA",9,1,1,0,0,1,-75.30096436,40.07962418
229,"CONWAY AR",9,14,4,2,8,14,-92.4426651,35.08877563
229,"CONWAY SC",9,3,1,0,2,3,-79.04202271,33.83802795
229,"CONYERS GA",9,2,0,2,0,2,-84.0175705,33.66764832
229,"COON RAPIDS MN",9,1,1,0,0,1,-93.32348633,45.16527176
229,"COOPERSVILLE MI",9,1,1,0,0,1,-85.93455505,43.06417847
229,"COOS BAY OR",9,1,0,0,1,1,-124.219841,43.36757278
229,"COPPERAS COVE TX",9,1,0,1,0,1,-97.90343475,31.12462616
229,"CORAL GABLES FL",9,1,0,0,1,1,-80.26779938,25.72242165
229,"CORCORAN CA",9,1,0,1,0,1,-119.5620728,36.09794235
229,"CORDOVA AL",9,2,0,1,1,2,-87.18320465,33.75994492
229,"CORINTH MS",9,2,1,0,1,2,-88.52302551,34.93960571
229,"CORNELIUS NC",9,1,0,0,1,1,-80.85160828,35.48339462
229,"CORNERSVILLE TN",9,2,0,1,1,2,-86.83959198,35.36151505
229,"CORNING NY",9,1,0,1,0,1,-77.05406189,42.14312744
229,"CORONA CA",9,25,6,11,8,25,-117.5688171,33.87516785
229,"CORONADO CA",9,9,3,3,3,9,-117.1846619,32.6861763
229,"CORPUS CHRISTI TX",9,12,5,3,4,12,-97.42076874,27.77859879
229,"CORSICANA TX",9,4,2,1,1,4,-96.46954346,32.09554291
229,"CORTLAND NY",9,7,2,1,4,7,-76.17972565,42.60138702
229,"CORVALLIS OR",9,11,0,4,7,11,-123.2646637,44.56417084
229,"COSHOCTON OH",9,1,0,0,1,1,-81.85901642,40.27225113
229,"COSTA MESA CA",9,5,1,1,3,5,-117.9204407,33.64131927
229,"COUNCIL BLUFFS IA",9,1,1,0,0,1,-95.86154938,41.26196289
229,"COUNCIL GROVE KS",9,39,6,13,20,39,-96.49236298,38.66096115
229,"COVINA CA",9,1,0,0,1,1,-117.8919067,34.09014511
229,"COVINGTON GA",9,1,1,0,0,1,-83.86009216,33.59708405
229,"COVINGTON IN",9,1,0,0,1,1,-87.39381409,40.13796234
229,"COVINGTON KY",9,9,2,0,7,9,-84.50816345,39.08356476
229,"COVINGTON VA",9,1,0,0,1,1,-79.99378204,37.79362106
229,"COXSACKIE NY",9,1,1,0,0,1,-73.80188751,42.35128403
229,"CRANSTON RI",9,2,0,0,2,2,-71.43634033,41.77997971
229,"CRESCENT CITY FL",9,1,0,1,0,1,-81.51012421,29.43062973
229,"CRESTON IA",9,1,0,0,1,1,-94.3616333,41.05845642
229,"CRESTVIEW KY",9,3,1,1,1,3,-84.41716003,39.02523804
229,"CREVE COEUR MO",9,2,1,0,1,2,-90.42288971,38.66108322
229,"CROSS PLAINS TN",9,1,0,0,1,1,-86.69587708,36.54875183
229,"CROSSVILLE TN",9,7,2,0,5,7,-85.0270462,35.9490509
229,"CROTON-ON-HUDSON NY",9,18,3,0,15,18,-73.89041901,41.2085762
229,"CROWN POINT IN",9,2,0,1,1,2,-87.36541748,41.41695023
229,"CRYSTAL LAKE IL",9,1,0,1,0,1,-88.3161087,42.2411499
229,"CRYSTAL MN",9,1,1,0,0,1,-93.36638641,45.05664063
229,"CUBA MO",9,1,0,0,1,1,-91.40387726,38.06311035
229,"CUERO TX",9,1,0,0,1,1,-97.28947449,29.09457397
229,"CULLMAN AL",9,2,0,1,1,2,-86.84370422,34.17510605
229,"CULPEPER VA",9,3,2,1,0,3,-77.99610901,38.47347641
229,"CULVER IN",9,1,0,0,1,1,-86.42308044,41.21883011
229,"CUMBERLAND MD",9,1,1,0,0,1,-78.76217651,39.65284729
229,"CUMMING GA",9,1,1,0,0,1,-84.1401825,34.2074852
229,"CUPERTINO CA",9,15,2,1,12,15,-122.0342026,37.32306671
229,"CUT AND SHOOT TX",9,1,1,0,0,1,-95.35832214,30.33357811
229,"CUYAHOGA FALLS OH",9,43,11,5,27,43,-81.48397064,41.1338768
229,"D'IBERVILLE MS",9,3,0,2,1,3,-88.88684845,30.43582153
229,"DACULA GA",9,3,2,1,0,3,-83.89762878,33.9887352
229,"DADEVILLE AL",9,1,1,0,0,1,-85.76355743,32.83142853
229,"DALLAS GA",9,2,0,0,2,2,-84.84075165,33.92391586
229,"DALLAS TX",9,1487,374,338,775,1487,-96.80088043,32.78369904
229,"DALTON GA",9,2,0,0,2,2,-84.97008514,34.76976776
229,"DANBURY CT",9,4,0,0,4,4,-73.45310974,41.39499664
229,"DANVILLE CA",9,1,0,0,1,1,-122.0023193,37.82156754
229,"DANVILLE IL",9,1,1,0,0,1,-87.62978363,40.12442398
229,"DANVILLE PA",9,2,1,1,0,2,-76.61188507,40.96371078
229,"DANVILLE VA",9,5,1,2,2,5,-79.39437866,36.58641434
229,"DAPHNE AL",9,2,1,0,1,2,-87.90383148,30.60381317
229,"DASSEL MN",9,1,1,0,0,1,-94.30751801,45.08166885
229,"DAVENPORT IA",9,26,6,12,8,26,-90.57814026,41.52380753
229,"DAVIDSON NC",9,3,1,0,2,3,-80.8433075,35.49843216
229,"DAVIE FL",9,11,3,4,4,11,-80.23148346,26.0657177
229,"DAVIS CA",9,9,1,5,3,9,-121.7421722,38.54467773
229,"DAYTON KY",9,24,9,4,11,24,-84.47278595,39.11274338
229,"DAYTON OH",9,127,40,33,54,127,-84.19126892,39.75915146
229,"DAYTON TN",9,3,0,0,3,3,-85.01251221,35.49424744
229,"DAYTONA BEACH FL",9,29,8,10,11,29,-81.02253723,29.21147537
229,"DE SOTO KS",9,4,2,0,2,4,-94.96877289,38.97918701
229,"DE SOTO MO",9,9,1,6,2,9,-90.55529022,38.13964462
229,"DEARBORN MI",9,6,1,3,2,6,-83.1758728,42.32239914
229,"DEBARY FL",9,1,0,0,1,1,-81.30838776,28.88345909
229,"DECATUR AL",9,8,4,1,3,8,-86.98355103,34.60622406
229,"DECATUR GA",9,35,11,5,19,35,-84.29631805,33.77489471
229,"DECATUR IL",9,10,2,3,5,10,-88.95516968,39.84060287
229,"DECATUR IN",9,4,2,1,1,4,-84.93001556,40.82580566
229,"DEDHAM MA",9,3,0,1,2,3,-71.16512299,42.24193954
229,"DEERFIELD BEACH FL",9,4,0,2,2,4,-80.09928131,26.31905365
229,"DEERFIELD IL",9,4,0,3,1,4,-87.84490204,42.17103577
229,"DEL MAR CA",9,2,2,0,0,2,-117.2663345,32.95969391
229,"DEL RIO TX",9,2,0,2,0,2,-100.8970642,29.36329842
229,"DELAWARE CITY DE",9,8,0,4,4,8,-75.59502411,39.57416534
229,"DELPHOS OH",9,1,0,0,1,1,-84.34170532,40.84327698
229,"DELRAY BEACH FL",9,6,2,0,4,6,-80.07209778,26.46233368
229,"DELTA CO",9,1,1,0,0,1,-108.0698395,38.74222946
229,"DEMING NM",9,1,0,0,1,1,-107.7599793,32.26507187
229,"DEMOPOLIS AL",9,1,0,1,0,1,-87.8364563,32.51809692
229,"DENMARK SC",9,7,3,0,4,7,-81.14172363,33.32278824
229,"DENTON TX",9,79,22,16,41,79,-97.13349915,33.21514893
229,"DENVER CO",9,718,192,180,346,718,-104.9853745,39.73901749
229,"DENVER IA",9,3,1,1,1,3,-92.33773041,42.67134857
229,"DENVILLE NJ",9,1,0,0,1,1,-74.47631836,40.89261246
229,"DEPEW NY",9,3,0,1,2,3,-78.69154358,42.90420532
229,"DES MOINES IA",9,28,8,7,13,28,-93.6210022,41.59817123
229,"DES PLAINES IL",9,5,2,0,3,5,-87.8833847,42.03343964
229,"DESTIN FL",9,5,2,1,2,5,-86.49551392,30.39405632
229,"DETROIT MI",9,554,155,106,293,554,-83.04567719,42.33172226
229,"DEXTER MO",9,1,1,0,0,1,-89.95834351,36.79595947
229,"DIAMOND BAR CA",9,2,2,0,0,2,-117.8404999,33.97759247
229,"DILLON SC",9,1,0,1,0,1,-79.37909698,34.41096115
229,"DINUBA CA",9,1,0,1,0,1,-119.3888931,36.543293
229,"DODGE CITY KS",9,1,1,0,0,1,-100.0181732,37.75279617
229,"DONIPHAN MO",9,10,2,2,6,10,-90.82394409,36.62110138
229,"DOTHAN AL",9,4,2,0,2,4,-85.39019775,31.22351265
229,"DOUGLAS GA",9,22,6,3,13,22,-82.84980011,31.50903511
229,"DOUGLASSVILLE TX",9,1,0,1,0,1,-94.35386658,33.19242096
229,"DOUGLASVILLE GA",9,1,0,0,1,1,-84.74777222,33.75165939
229,"DOVER DE",9,12,5,2,5,12,-75.52090454,39.15853882
229,"DOVER NH",9,1,0,0,1,1,-70.88840485,43.2059021
229,"DOVER OH",9,1,0,0,1,1,-81.4782486,40.51688766
229,"DOYLESTOWN PA",9,9,0,5,4,9,-75.1292038,40.31054688
229,"DRAPER UT",9,1,0,1,0,1,-111.8741074,40.5280838
229,"DREW MS",9,1,0,0,1,1,-90.53083038,33.81049728
229,"DRIPPING SPRINGS TX",9,2,0,1,1,2,-98.08734131,30.19070816
229,"DUBLIN CA",9,4,0,0,4,4,-121.9383392,37.70181274
229,"DUBLIN GA",9,3,1,0,2,3,-82.90332794,32.540802
229,"DUBLIN VA",9,1,1,0,0,1,-80.68517303,37.10611343
229,"DUBUQUE IA",9,6,5,0,1,6,-90.67155457,42.51130295
229,"DULUTH MN",9,6,2,4,0,6,-92.10697174,46.78300858
229,"DUNBAR WV",9,2,0,0,2,2,-81.73683167,38.36086655
229,"DUNCAN OK",9,1,1,0,0,1,-97.95820618,34.50245667
229,"DUNCANVILLE TX",9,3,0,0,3,3,-96.9091568,32.65229034
229,"DUNEDIN FL",9,2,1,1,0,2,-82.77127838,28.02050591
229,"DUNNELLON FL",9,1,0,0,1,1,-82.46072388,29.04970551
229,"DUNWOODY GA",9,1,0,0,1,1,-84.33460236,33.94631958
229,"DURANGO CO",9,2,0,0,2,2,-107.8810043,37.27463913
229,"DURHAM NC",9,301,80,71,150,301,-78.89787292,35.99412918
229,"DYERSBURG TN",9,1,0,0,1,1,-89.38568878,36.03469849
229,"EAGAN MN",9,2,0,1,1,2,-93.16746521,44.80387878
229,"EAGLE PASS TX",9,2,0,0,2,2,-100.5002899,28.70978737
229,"EAGLE POINT OR",9,1,0,0,1,1,-122.8052063,42.47254181
229,"EAGLE RIVER WI",9,4,2,0,2,4,-89.24466705,45.91718674
229,"EAGLEVILLE MO",9,2,0,1,1,2,-93.9878006,40.46938705
229,"EAST CHICAGO IN",9,1,0,0,1,1,-87.44509125,41.64970398
229,"EAST GRAND FORKS MN",9,1,0,0,1,1,-97.02550507,47.93012619
229,"EAST GREENWICH RI",9,2,0,0,2,2,-71.45487976,41.66058731
229,"EAST HAMPTON NY",9,1,0,0,1,1,-72.18353271,40.96551895
229,"EAST HARTFORD CT",9,8,2,3,3,8,-72.64693451,41.77160263
229,"EAST LANSING MI",9,58,15,17,26,58,-84.48403931,42.73703384
229,"EAST MCKEESPORT PA",9,9,2,1,6,9,-79.80618286,40.38326645
229,"EAST ORANGE NJ",9,9,4,1,4,9,-74.21418762,40.76618958
229,"EAST PALO ALTO CA",9,3,2,0,1,3,-122.143013,37.46857452
229,"EAST PEORIA IL",9,1,0,1,0,1,-89.58027649,40.66614151
229,"EAST POINT GA",9,3,1,2,0,3,-84.43933868,33.67996979
229,"EAST ROCHESTER NY",9,1,0,0,1,1,-77.48701477,43.1086731
229,"EASTMAN GA",9,5,1,1,3,5,-83.17722321,32.19805527
229,"EASTON MD",9,1,0,0,1,1,-76.07592773,38.77448654
229,"EASTON PA",9,15,4,4,7,15,-75.21966553,40.68871689
229,"EATON OH",9,1,0,1,0,1,-84.6366806,39.74417877
229,"EAU CLAIRE WI",9,4,1,0,3,4,-91.49876404,44.81137466
229,"EDEN PRAIRIE MN",9,2,1,1,0,2,-93.48716736,44.85310745
229,"EDINA MO",9,2,2,0,0,2,-92.1732254,40.16763306
229,"EDINBORO PA",9,11,2,5,4,11,-80.13100433,41.87437439
229,"EDINBURG TX",9,10,5,2,3,10,-98.16417694,26.30259705
229,"EDMOND OK",9,19,6,11,2,19,-97.48453522,35.65326309
229,"EDMONDS WA",9,6,2,2,2,6,-122.3799057,47.81037521
229,"EDNA TX",9,6,2,4,0,6,-96.64674377,28.97920609
229,"EDWARDSVILLE IL",9,78,19,20,39,78,-89.95322418,38.8115654
229,"EFFINGHAM IL",9,4,2,1,1,4,-88.54359436,39.12008667
229,"EL CAJON CA",9,1,0,1,0,1,-116.9467392,32.83002472
229,"EL CENTRO CA",9,1,0,0,1,1,-115.5646057,32.79199982
229,"EL CERRITO CA",9,19,7,5,7,19,-122.3142548,37.91544342
229,"EL LAGO TX",9,2,0,0,2,2,-95.04547119,29.56394196
229,"EL MIRAGE AZ",9,1,0,0,1,1,-112.3263016,33.61337662
229,"EL MONTE CA",9,5,0,1,4,5,-118.0298996,34.06880569
229,"EL PASO TX",9,65,17,12,36,65,-106.4620514,31.78388405
229,"EL RENO OK",9,2,0,2,0,2,-97.95549011,35.53218842
229,"EL SEGUNDO CA",9,2,0,2,0,2,-118.4185257,33.91943741
229,"ELDORADO IL",9,1,0,1,0,1,-88.43813324,37.8138237
229,"ELGIN IL",9,1,0,1,0,1,-88.28123474,42.03733444
229,"ELIZABETH CITY NC",9,2,1,0,1,2,-76.22274017,36.3025322
229,"ELIZABETHTOWN PA",9,4,0,2,2,4,-76.60209656,40.15314865
229,"ELK GROVE CA",9,213,68,66,79,213,-121.3743591,38.40848923
229,"ELK POINT SD",9,3,1,2,0,3,-96.68419647,42.68325424
229,"ELK RIVER MN",9,1,0,0,1,1,-93.56745911,45.30422974
229,"ELKHART IN",9,1,0,1,0,1,-85.97689056,41.68212128
229,"ELKINS WV",9,2,0,1,1,2,-79.85980225,38.92602921
229,"ELKO NV",9,1,0,1,0,1,-115.7643967,40.83226395
229,"ELKTON MD",9,1,0,1,0,1,-75.83261108,39.60694122
229,"ELLENSBURG WA",9,3,0,1,2,3,-120.5507507,46.99611664
229,"ELMHURST IL",9,1,0,1,0,1,-87.9407196,41.89970398
229,"ELMIRA NY",9,15,2,7,6,15,-76.80737305,42.08998108
229,"ELMORE AL",9,1,0,1,0,1,-86.31501007,32.53902054
229,"ELMWOOD IL",9,1,0,0,1,1,-89.96702576,40.77780151
229,"ELMWOOD PARK NJ",9,1,0,0,1,1,-74.1175766,40.90429306
229,"ELYRIA OH",9,4,1,1,2,4,-82.10734558,41.36825562
229,"EMMAUS PA",9,3,1,1,1,3,-75.49610138,40.53958893
229,"EMPORIA KS",9,3,0,0,3,3,-96.18218994,38.40393448
229,"ENCINITAS CA",9,8,2,2,4,8,-117.2937012,33.0371666
229,"ENGLEWOOD CO",9,4,2,1,1,4,-104.9884491,39.6479187
229,"ENGLEWOOD NJ",9,6,0,1,5,6,-73.97172546,40.8928833
229,"ENID OK",9,1,1,0,0,1,-97.87895203,36.39573288
229,"ERIE PA",9,28,8,5,15,28,-80.08492279,42.12926483
229,"ERWIN TN",9,1,0,0,1,1,-82.41162109,36.15189362
229,"ESCONDIDO CA",9,5,1,3,1,5,-117.0886231,33.11952591
229,"ESSEX JUNCTION VT",9,3,1,2,0,3,-73.11017609,44.49057007
229,"ESTERO FL",9,2,1,0,1,2,-81.80654144,26.43899536
229,"ESTES PARK CO",9,1,0,1,0,1,-105.5249558,40.37337112
229,"EUGENE OR",9,102,26,21,55,102,-123.0898361,44.05194855
229,"EULESS TX",9,11,4,2,5,11,-97.08273315,32.83728409
229,"EUNICE LA",9,1,1,0,0,1,-92.41770172,30.49472046
229,"EUREKA CA",9,1,1,0,0,1,-124.1653366,40.80156708
229,"EUREKA MO",9,2,0,1,1,2,-90.62799835,38.50252533
229,"EUREKA SPRINGS AR",9,1,0,1,0,1,-93.73842621,36.40146255
229,"EVANSTON IL",9,18,7,6,5,18,-87.69037628,42.04132843
229,"EVANSTON WY",9,3,0,2,1,3,-110.9652634,41.26803589
229,"EVANSVILLE IN",9,31,6,9,16,31,-87.56850433,37.97795486
229,"EVERETT MA",9,2,0,0,2,2,-71.05252075,42.40878296
229,"EVERETT WA",9,10,2,2,6,10,-122.2045441,47.97843552
229,"EVERMAN TX",9,2,0,0,2,2,-97.28966522,32.63102341
229,"EXETER NH",9,1,0,0,1,1,-70.95800781,42.98471451
229,"FAIR HAVEN NJ",9,15,9,2,4,15,-74.03659821,40.35977936
229,"FAIRBANKS AK",9,1,1,0,0,1,-147.7185669,64.83367157
229,"FAIRBORN OH",9,1,0,1,0,1,-84.01902771,39.82121658
229,"FAIRCHILD WI",9,1,1,0,0,1,-90.96333313,44.60019302
229,"FAIRFAX VA",9,20,8,6,6,20,-77.30588531,38.84661865
229,"FAIRFIELD CA",9,6,3,1,2,6,-122.0420914,38.24917603
229,"FAIRFIELD IA",9,1,0,0,1,1,-91.96311188,41.00863266
229,"FAIRFIELD OH",9,2,0,1,1,2,-84.56064606,39.34600449
229,"FAIRFIELD TX",9,1,0,0,1,1,-96.16577911,31.72510147
229,"FAIRHAVEN MA",9,1,0,0,1,1,-70.902565,41.63794327
229,"FAIRHOPE AL",9,1,1,0,0,1,-87.90351105,30.52334213
229,"FAIRMONT WV",9,1,0,1,0,1,-80.14244843,39.48347473
229,"FAIRVIEW PARK OH",9,1,1,0,0,1,-81.86431885,41.44171524
229,"FALL RIVER MA",9,4,2,1,1,4,-71.15414429,41.70151138
229,"FALLS CHURCH VA",9,6,2,2,2,6,-77.17056274,38.88268661
229,"FARGO ND",9,30,7,8,15,30,-96.79805756,46.87498474
229,"FARIBAULT MN",9,3,0,2,1,3,-93.26953125,44.29466248
229,"FARMERS BRANCH TX",9,1,1,0,0,1,-96.89679718,32.92665482
229,"FARMINGDALE NY",9,1,0,0,1,1,-73.44436646,40.73298645
229,"FARMINGTON HILLS MI",9,8,3,2,3,8,-83.3771286,42.48558807
229,"FARMINGTON MI",9,1,0,0,1,1,-83.37620544,42.46465302
229,"FARMINGTON MO",9,4,3,0,1,4,-90.4220047,37.78110504
229,"FARMVILLE VA",9,2,0,0,2,2,-78.39121246,37.30234909
229,"FAYETTE MO",9,2,1,0,1,2,-92.68386078,39.14609146
229,"FAYETTEVILLE AR",9,17,4,9,4,17,-94.15759277,36.06256104
229,"FAYETTEVILLE GA",9,3,1,1,1,3,-84.45489502,33.44916916
229,"FAYETTEVILLE NC",9,33,9,7,17,33,-78.87771606,35.05313873
229,"FAYETTEVILLE TN",9,3,0,1,2,3,-86.57073212,35.15206146
229,"FEDERAL WAY WA",9,20,7,3,10,20,-122.314415,47.32177734
229,"FEDERALSBURG MD",9,1,0,1,0,1,-75.77262115,38.69446945
229,"FENTON MI",9,5,1,2,2,5,-83.70490265,42.79768372
229,"FENTON MO",9,71,18,19,34,71,-90.43593597,38.51305771
229,"FERGUSON MO",9,112,39,14,59,112,-90.306633,38.74429321
229,"FERNANDINA BEACH FL",9,1,0,0,1,1,-81.46240234,30.66996193
229,"FERNDALE MI",9,23,9,4,10,23,-83.13441467,42.46089172
229,"FESTUS MO",9,4,0,0,4,4,-90.39609528,38.22088623
229,"FILLMORE CA",9,1,0,0,1,1,-118.919754,34.39930344
229,"FINDLAY OH",9,2,1,0,1,2,-83.64990997,41.04424286
229,"FISHERS IN",9,3,1,1,1,3,-86.0140152,39.95565414
229,"FLAGLER BEACH FL",9,9,1,2,6,9,-81.12680054,29.47527695
229,"FLAGSTAFF AZ",9,18,1,5,12,18,-111.6533051,35.19802475
229,"FLAT ROCK MI",9,1,0,0,1,1,-83.29182434,42.09670639
229,"FLATWOODS KY",9,3,0,0,3,3,-82.71713257,38.52272797
229,"FLINT MI",9,57,16,12,29,57,-83.68744659,43.01246643
229,"FLORENCE AL",9,9,4,1,4,9,-87.67726898,34.7997818
229,"FLORENCE AZ",9,1,0,1,0,1,-111.3891525,33.0316925
229,"FLORENCE CO",9,16,7,4,5,16,-105.119751,38.39019012
229,"FLORENCE KY",9,1,0,0,1,1,-84.62657166,38.99923706
229,"FLORENCE SC",9,2,0,1,1,2,-79.76351166,34.19935226
229,"FLORISSANT MO",9,105,29,24,52,105,-90.32299042,38.78946304
229,"FLOSSMOOR IL",9,1,0,0,1,1,-87.68474579,41.54309845
229,"FLOYD VA",9,8,3,1,4,8,-80.31944275,36.91149902
229,"FOLEY AL",9,2,0,1,1,2,-87.68378448,30.40701675
229,"FOND DU LAC WI",9,19,3,4,12,19,-88.44734955,43.77285004
229,"FONTANA CA",9,1,0,0,1,1,-117.4363785,34.09202576
229,"FOREST PARK GA",9,1,0,0,1,1,-84.36103058,33.62044144
229,"FORNEY TX",9,1,0,0,1,1,-96.47270966,32.74848175
229,"FORREST CITY AR",9,4,3,1,0,4,-90.79021454,35.00848389
229,"FORSYTH MO",9,3,1,2,0,3,-93.120224,36.68517685
229,"FORT COLLINS CO",9,84,20,20,44,84,-105.0858688,40.58546066
229,"FORT LAUDERDALE FL",9,81,25,17,39,81,-80.14283752,26.12309074
229,"FORT LEE NJ",9,2,0,0,2,2,-73.96900177,40.85113907
229,"FORT LUPTON CO",9,1,0,0,1,1,-104.8086929,40.07614517
229,"FORT MILL SC",9,4,2,2,0,4,-80.94496155,35.00762558
229,"FORT MYERS FL",9,11,1,4,6,11,-81.87184143,26.64133644
229,"FORT SCOTT KS",9,1,0,0,1,1,-94.70889282,37.83989716
229,"FORT SMITH AR",9,12,3,5,4,12,-94.39919281,35.3862114
229,"FORT STOCKTON TX",9,2,1,1,0,2,-102.8801041,30.89455986
229,"FORT WALTON BEACH FL",9,1,0,1,0,1,-86.61834717,30.40767479
229,"FORT WAYNE IN",9,29,7,5,17,29,-85.13967896,41.07278061
229,"FORT WORTH TX",9,228,57,48,123,228,-97.32135773,32.72562027
229,"FORT YATES ND",9,1,0,0,1,1,-100.6290817,46.09021378
229,"FOUNTAIN INN SC",9,2,0,1,1,2,-82.20529175,34.69663239
229,"FOUNTAIN VALLEY CA",9,1,1,0,0,1,-117.9555054,33.70910645
229,"FRAMINGHAM MA",9,1,0,1,0,1,-71.41543579,42.27958298
229,"FRANKFORT KY",9,22,4,1,17,22,-84.87322235,38.20124054
229,"FRANKLIN KY",9,9,4,2,3,9,-86.57696533,36.72238159
229,"FRANKLIN MI",9,1,0,1,0,1,-83.30574799,42.52250671
229,"FRANKLIN TN",9,2,1,1,0,2,-86.87760162,35.92164993
229,"FREDERICK MD",9,14,5,2,7,14,-77.40981293,39.41444397
229,"FREDERICKSBURG VA",9,10,5,1,4,10,-77.45996094,38.30348969
229,"FREDERICKTOWN MO",9,3,3,0,0,3,-90.29403687,37.5598793
229,"FREDONIA NY",9,2,0,1,1,2,-79.33128357,42.4403038
229,"FREEPORT IL",9,21,6,6,9,21,-89.62126923,42.29691696
229,"FREEPORT NY",9,1,0,1,0,1,-73.58229065,40.65803146
229,"FREEPORT TX",9,1,0,0,1,1,-95.35985565,28.95484543
229,"FREMONT CA",9,16,2,1,13,16,-121.9740372,37.55101776
229,"FREMONT OH",9,4,1,1,2,4,-83.12195587,41.35057831
229,"FRESNO CA",9,101,25,17,59,101,-119.7739868,36.74755478
229,"FRIDLEY MN",9,7,2,2,3,7,-93.2636261,45.08617401
229,"FRIENDSWOOD TX",9,2,1,0,1,2,-95.20127106,29.53010368
229,"FRISCO CO",9,3,1,1,1,3,-106.0990143,39.57444763
229,"FRISCO TX",9,6,3,1,2,6,-96.82434082,33.15098572
229,"FRUITPORT MI",9,1,0,1,0,1,-86.154953,43.13179398
229,"FULLERTON CA",9,12,3,3,6,12,-117.9268646,33.87014771
229,"GADSDEN AL",9,7,1,0,6,7,-86.00675201,34.01457596
229,"GAINESVILLE FL",9,87,27,14,46,87,-82.32462311,29.65203285
229,"GAINESVILLE GA",9,9,1,5,3,9,-83.82389832,34.29787827
229,"GAITHERSBURG MD",9,15,2,7,6,15,-77.20072174,39.14352417
229,"GALESBURG IL",9,1,0,0,1,1,-90.37152863,40.9480629
229,"GALVESTON IN",9,1,0,0,1,1,-86.19012451,40.57881165
229,"GALVESTON TX",9,1,0,0,1,1,-94.79576111,29.30070114
229,"GARDEN CITY NY",9,2,1,1,0,2,-73.63320923,40.72684097
229,"GARDEN GROVE CA",9,13,6,3,4,13,-117.943718,33.77397156
229,"GARDENA CA",9,9,2,3,4,9,-118.3105164,33.88837814
229,"GARDNER KS",9,3,0,1,2,3,-94.92789459,38.81066132
229,"GARLAND TX",9,9,0,5,4,9,-96.63926697,32.91297531
229,"GARNER NC",9,1,1,0,0,1,-78.61359406,35.71166992
229,"GARY IN",9,19,9,2,8,19,-87.33873749,41.59325409
229,"GASTONIA NC",9,3,2,0,1,3,-81.18706512,35.26216507
229,"GAYLORD MI",9,1,1,0,0,1,-84.67483521,45.02762222
229,"GENEVA IL",9,10,3,5,2,10,-88.30541992,41.8876915
229,"GENEVA NY",9,3,1,1,1,3,-76.97723389,42.86890793
229,"GENEVA OH",9,1,0,1,0,1,-80.94763184,41.80530167
229,"GEORGETOWN KY",9,1,1,0,0,1,-84.55860138,38.21012115
229,"GEORGETOWN LA",9,1,0,0,1,1,-92.38475037,31.76140976
229,"GEORGETOWN TX",9,8,2,2,4,8,-97.67801666,30.6329689
229,"GETTYSBURG PA",9,2,0,0,2,2,-77.23023224,39.83097076
229,"GIBSONBURG OH",9,1,0,1,0,1,-83.32060242,41.38440323
229,"GIG HARBOR WA",9,16,7,5,4,16,-122.590683,47.32983398
229,"GILBERT AZ",9,9,2,2,5,9,-111.7899933,33.35302353
229,"GLADSTONE MO",9,7,2,1,4,7,-94.55509186,39.20398331
229,"GLASGOW KY",9,5,0,2,3,5,-85.91189575,36.99584961
229,"GLASSBORO NJ",9,1,0,0,1,1,-75.11103058,39.70306778
229,"GLEN COVE NY",9,1,0,0,1,1,-73.63267517,40.86247635
229,"GLEN ROCK PA",9,3,0,0,3,3,-76.7299118,39.79356384
229,"GLENDALE AZ",9,12,3,4,5,12,-112.1871796,33.5386467
229,"GLENDALE CA",9,19,5,5,9,19,-118.2566681,34.1423645
229,"GLENDIVE MT",9,1,1,0,0,1,-104.7115021,47.11004257
229,"GLENDORA CA",9,2,1,0,1,2,-117.8665314,34.13615417
229,"GLENS FALLS NY",9,1,0,0,1,1,-73.64286041,43.30945969
229,"GLOBE AZ",9,3,1,1,1,3,-110.7881393,33.3945961
229,"GLOUCESTER CITY NJ",9,3,0,1,2,3,-75.11563873,39.89209747
229,"GLOUCESTER MA",9,1,1,0,0,1,-70.66117096,42.61589432
229,"GOLDEN CO",9,3,1,0,2,3,-105.2226791,39.75567627
229,"GOLDEN VALLEY MN",9,29,13,7,9,29,-93.33234406,44.98583603
229,"GOLDONNA LA",9,1,0,0,1,1,-92.90959167,32.0173645
229,"GOLDSBORO NC",9,1,0,0,1,1,-77.99216461,35.38506317
229,"GOLETA CA",9,1,0,1,0,1,-119.8299332,34.43574142
229,"GOODRICH TX",9,7,2,1,4,7,-94.9467926,30.60574341
229,"GOSHEN IN",9,4,1,2,1,4,-85.8345871,41.58250046
229,"GOWER MO",9,1,0,0,1,1,-94.60014343,39.61081314
229,"GOWRIE IA",9,2,0,2,0,2,-94.29121399,42.28058243
229,"GRAHAM NC",9,1,0,0,1,1,-79.39993286,36.06936646
229,"GRAMBLING LA",9,1,0,0,1,1,-92.71523285,32.52869415
229,"GRANBURY TX",9,1,1,0,0,1,-97.79492187,32.44239044
229,"GRAND BLANC MI",9,2,0,2,0,2,-83.62955475,42.92750168
229,"GRAND FORKS ND",9,11,2,4,5,11,-97.03855133,47.92044067
229,"GRAND HAVEN MI",9,1,0,0,1,1,-86.22866058,43.06328964
229,"GRAND JUNCTION CO",9,8,3,4,1,8,-108.5520706,39.06374741
229,"GRAND PRAIRIE TX",9,28,9,6,13,28,-96.99823761,32.74625015
229,"GRAND RAPIDS MI",9,80,21,18,41,80,-85.66797638,42.96317291
229,"GRANDVIEW MO",9,1,0,0,1,1,-94.53369904,38.88563538
229,"GRANITE CITY IL",9,74,24,11,39,74,-90.14891815,38.70147705
229,"GRANITE FALLS WA",9,1,0,0,1,1,-121.9720459,48.08432007
229,"GRANT PARK IL",9,1,0,0,1,1,-87.64607239,41.24023056
229,"GRANTS PASS OR",9,2,1,1,0,2,-123.3306351,42.43851471
229,"GRAPEVINE TX",9,16,6,1,9,16,-97.07859802,32.93464279
229,"GRAY GA",9,3,1,2,0,3,-83.53361511,33.00989532
229,"GREAT BEND KS",9,3,2,0,1,3,-98.76521301,38.36428452
229,"GREAT FALLS MT",9,1,1,0,0,1,-111.2823257,47.50692368
229,"GREECE NY",9,2,1,0,1,2,-77.69234467,43.21003342
229,"GREELEY CO",9,3,1,0,2,3,-104.7104645,40.42345047
229,"GREEN BAY WI",9,22,5,7,10,22,-88.01370239,44.51335907
229,"GREENBELT MD",9,20,5,8,7,20,-76.87561035,39.00544357
229,"GREENEVILLE TN",9,6,0,4,2,6,-82.83133698,36.16376495
229,"GREENFIELD IN",9,1,0,1,0,1,-85.76914978,39.78491974
229,"GREENFIELD WI",9,1,0,1,0,1,-88.01258087,42.96144104
229,"GREENSBORO NC",9,110,22,25,63,110,-79.79152679,36.0729599
229,"GREENSBURG PA",9,1,0,1,0,1,-79.53821564,40.30168915
229,"GREENVILLE IL",9,1,1,0,0,1,-89.41333008,38.89213562
229,"GREENVILLE NC",9,18,6,4,8,18,-77.37215424,35.61170959
229,"GREENVILLE PA",9,4,3,0,1,4,-80.39095306,41.40464401
229,"GREENVILLE SC",9,165,35,61,69,165,-82.39870453,34.84753418
229,"GREENWICH CT",9,9,1,4,4,9,-73.62783051,41.02645111
229,"GREENWOOD IN",9,12,2,3,7,12,-86.10647583,39.61371994
229,"GREER SC",9,2,1,0,1,2,-82.22647095,34.9389267
229,"GRESHAM OR",9,4,1,1,2,4,-122.4333954,45.4980278
229,"GRETNA VA",9,1,0,0,1,1,-79.35816193,36.95412445
229,"GRINNELL IA",9,1,0,1,0,1,-92.72964478,41.7466507
229,"GROSSE POINTE WOODS MI",9,4,0,1,3,4,-82.90637207,42.4438858
229,"GROTON CT",9,18,5,5,8,18,-72.07763672,41.3502121
229,"GROTON NY",9,1,1,0,0,1,-76.36643982,42.58802032
229,"GROVE CITY OH",9,1,1,0,0,1,-83.09304047,39.88161087
229,"GULF SHORES AL",9,3,3,0,0,3,-87.70103455,30.24625969
229,"GULFPORT FL",9,9,2,2,5,9,-82.70953369,27.74733734
229,"GULFPORT MS",9,15,6,3,6,15,-89.09369659,30.37276649
229,"GURDON AR",9,1,0,0,1,1,-93.15445709,33.9209137
229,"GUSTINE CA",9,3,2,0,1,3,-121.001297,37.25769043
229,"GYPSUM CO",9,9,2,1,6,9,-106.9528198,39.64703369
229,"HACKENSACK NJ",9,5,1,2,2,5,-74.04291534,40.88635254
229,"HADDONFIELD NJ",9,28,6,9,13,28,-75.03710937,39.89155197
229,"HAGERSTOWN IN",9,1,0,1,0,1,-85.16162872,39.91140747
229,"HAGERSTOWN MD",9,19,4,6,9,19,-77.71956635,39.641819
229,"HALF MOON BAY CA",9,2,0,0,2,2,-122.4299774,37.46336365
229,"HALLS TN",9,1,0,0,1,1,-89.39619446,35.87596893
229,"HALLSTEAD PA",9,4,2,0,2,4,-75.74239349,41.96153259
229,"HALLSVILLE MO",9,1,0,0,1,1,-92.22124481,39.11693573
229,"HAMBURG PA",9,1,1,0,0,1,-75.98101044,40.55582809
229,"HAMILTON NJ",9,2,1,1,0,2,-74.0803299,40.20712662
229,"HAMILTON OH",9,7,2,2,3,7,-84.56098175,39.39949799
229,"HAMMOND IN",9,7,1,3,3,7,-87.50006104,41.58346558
229,"HAMMOND LA",9,2,0,0,2,2,-90.46140289,30.50458908
229,"HAMPSHIRE IL",9,1,0,0,1,1,-88.53064728,42.09803772
229,"HAMPTON GA",9,1,0,1,0,1,-84.28277588,33.3870697
229,"HAMPTON VA",9,12,3,3,6,12,-76.34473419,37.03002548
229,"HANAHAN SC",9,2,1,1,0,2,-80.01743317,32.92184448
229,"HARBOR SPRINGS MI",9,8,2,2,4,8,-84.99181366,45.43172455
229,"HARKER HEIGHTS TX",9,15,2,4,9,15,-97.66394806,31.08788109
229,"HARLINGEN TX",9,8,2,3,3,8,-97.69669342,26.19152069
229,"HARRIMAN TN",9,1,0,0,1,1,-84.55221558,35.93426514
229,"HARRISBURG NC",9,4,0,4,0,4,-80.65539551,35.32398224
229,"HARRISBURG PA",9,59,17,13,29,59,-76.88382721,40.27407455
229,"HARRISON OH",9,1,0,0,1,1,-84.81867981,39.26198959
229,"HARRISONBURG VA",9,54,19,10,25,54,-78.86815643,38.44975281
229,"HARTFORD CT",9,51,22,14,15,51,-72.68445587,41.76383591
229,"HARTLAND VT",9,1,0,0,1,1,-72.39821625,43.54077911
229,"HARTLAND WI",9,2,0,1,1,2,-88.34208679,43.1048317
229,"HARTSVILLE SC",9,5,2,1,2,5,-80.07303619,34.37445068
229,"HARTVILLE OH",9,1,0,1,0,1,-81.33060455,40.96377563
229,"HARVARD MA",9,2,0,1,1,2,-71.58187103,42.5003891
229,"HARVEY IL",9,2,1,0,1,2,-87.64677429,41.61020279
229,"HASTINGS MN",9,4,1,1,2,4,-92.85280609,44.7434082
229,"HATTIESBURG MS",9,11,3,4,4,11,-89.29040527,31.32738686
229,"HAVERFORD PA",9,1,1,0,0,1,-75.29338837,40.01327896
229,"HAWTHORNE CA",9,8,2,3,3,8,-118.3549194,33.91656113
229,"HAYMARKET VA",9,2,0,0,2,2,-77.63591766,38.81214142
229,"HAYS KS",9,1,0,1,0,1,-99.32746887,38.87940598
229,"HAYWARD CA",9,13,3,3,7,13,-122.0832672,37.66890335
229,"HAZELWOOD MO",9,2,1,0,1,2,-90.37133789,38.77171707
229,"HAZLETON PA",9,1,1,0,0,1,-75.97418213,40.95857239
229,"HEARNE TX",9,1,0,1,0,1,-96.59375763,30.87876701
229,"HELENA MT",9,5,4,0,1,5,-112.0374527,46.59269333
229,"HELOTES TX",9,12,1,4,7,12,-98.69043732,29.57864761
229,"HEMET CA",9,1,0,0,1,1,-116.9736557,33.74770737
229,"HEMPSTEAD NY",9,1,0,0,1,1,-73.61798096,40.70619965
229,"HENDERSON NV",9,117,30,21,66,117,-114.9741058,36.03540421
229,"HENDERSON TX",9,1,0,1,0,1,-94.79977417,32.15364456
229,"HENDERSONVILLE NC",9,15,1,4,10,15,-82.46079254,35.31912994
229,"HERCULANEUM MO",9,8,4,1,3,8,-90.38007355,38.26866531
229,"HERMOSA BEACH CA",9,2,2,0,0,2,-118.401619,33.86245728
229,"HERNANDO MS",9,1,0,0,1,1,-89.99411774,34.82405853
229,"HESPERIA CA",9,1,0,0,1,1,-117.3026352,34.42634964
229,"HIALEAH FL",9,11,2,1,8,11,-80.27757263,25.85853386
229,"HICKORY NC",9,2,1,0,1,2,-81.34054565,35.72800827
229,"HIGH POINT NC",9,6,2,2,2,6,-80.00497437,35.95609665
229,"HIGHLAND CA",9,4,1,2,1,4,-117.2105789,34.12824631
229,"HIGHLAND PARK MI",9,1,0,0,1,1,-83.09667969,42.40581131
229,"HIGHLAND PARK TX",9,3,0,2,1,3,-96.80493164,32.8320961
229,"HIGHWOOD IL",9,1,0,1,0,1,-87.80953979,42.19964218
229,"HILLSBORO IL",9,2,0,1,1,2,-89.4937439,39.16139603
229,"HILLSBORO OH",9,2,1,1,0,2,-83.61119843,39.20261765
229,"HILLSBORO OR",9,28,8,6,14,28,-122.9927826,45.52270508
229,"HILLSBOROUGH NC",9,1,0,1,0,1,-79.09932709,36.07565308
229,"HILLSDALE MI",9,1,0,0,1,1,-84.63027191,41.91994095
229,"HOBART IN",9,2,0,0,2,2,-87.24478912,41.53391266
229,"HOBOKEN NJ",9,9,0,3,6,9,-74.0316925,40.7443428
229,"HOLCOMB KS",9,1,1,0,0,1,-100.9902344,37.98623276
229,"HOLLY HILL FL",9,2,1,0,1,2,-81.03705597,29.24398613
229,"HOLLYWOOD FL",9,26,3,5,18,26,-80.14926147,26.01175499
229,"HOLTON KS",9,1,0,0,1,1,-95.73680115,39.46525955
229,"HOLTS SUMMIT MO",9,1,1,0,0,1,-92.12291718,38.64030457
229,"HOLYOKE MA",9,17,5,3,9,17,-72.61522675,42.20437241
229,"HOMESTEAD FL",9,5,2,1,2,5,-80.47710419,25.46927071
229,"HOMEWOOD IL",9,6,1,2,3,6,-87.66596222,41.55735779
229,"HONESDALE PA",9,1,1,0,0,1,-75.25775909,41.57712555
229,"HOOD RIVER OR",9,2,1,0,1,2,-121.5108719,45.70785141
229,"HOQUIAM WA",9,1,0,1,0,1,-123.8915939,46.98048782
229,"HOT SPRINGS AR",9,17,3,8,6,17,-93.05556488,34.5039978
229,"HOUGHTON MI",9,7,0,4,3,7,-88.56951141,47.12665558
229,"HOUSTON TX",9,2223,618,590,1015,2223,-95.36399841,29.76376343
229,"HOWELL MI",9,1,0,0,1,1,-83.92946625,42.6072464
229,"HUDSON OH",9,3,0,1,2,3,-81.44026947,41.2401619
229,"HUMBLE TX",9,2,0,1,1,2,-95.26166534,29.99774551
229,"HUMBOLDT IA",9,1,0,0,1,1,-94.22392273,42.72631454
229,"HUNTERSVILLE NC",9,1,0,0,1,1,-80.83785248,35.41359711
229,"HUNTINGDON PA",9,1,1,0,0,1,-78.00988007,40.48491669
229,"HUNTINGTON BEACH CA",9,19,4,1,14,19,-118.0006027,33.66012955
229,"HUNTINGTON NY",9,2,1,0,1,2,-73.42463684,40.86833191
229,"HUNTINGTON WV",9,21,3,6,12,21,-82.44620514,38.4181366
229,"HUNTSVILLE AL",9,120,34,29,57,120,-86.58609772,34.73073959
229,"HUNTSVILLE TN",9,1,0,1,0,1,-84.49047852,36.40984726
229,"HUNTSVILLE TX",9,5,1,2,2,5,-95.55122375,30.72374153
229,"HURST TX",9,1,1,0,0,1,-97.17115021,32.82357407
229,"HYATTSVILLE MD",9,8,3,2,3,8,-76.94467163,38.95636749
229,"IDAHO FALLS ID",9,5,2,0,3,5,-112.035408,43.46630478
229,"IMPERIAL CA",9,2,0,1,1,2,-115.5716705,32.84782791
229,"INDEPENDENCE KY",9,1,0,1,0,1,-84.54380035,38.94332886
229,"INDEPENDENCE MO",9,25,7,5,13,25,-94.41611481,39.09104538
229,"INDIAN ROCKS BEACH FL",9,5,1,3,1,5,-82.85096741,27.87600517
229,"INDIAN TRAIL NC",9,1,0,1,0,1,-80.66901398,35.07696915
229,"INDIANA PA",9,4,0,1,3,4,-79.15187073,40.6216507
229,"INDIANAPOLIS IN",9,309,80,70,159,309,-86.15828705,39.76844788
229,"INDIANOLA IA",9,1,0,0,1,1,-93.55815887,41.35812378
229,"INDIANOLA MS",9,2,1,0,1,2,-90.65548706,33.45103073
229,"INDIO CA",9,6,1,2,3,6,-116.2173004,33.72047043
229,"INGLEWOOD CA",9,32,6,6,20,32,-118.354805,33.96157074
229,"INGLIS FL",9,1,0,1,0,1,-82.66842651,29.03089333
229,"IOWA CITY IA",9,49,16,8,25,49,-91.53023529,41.66130066
229,"IPSWICH MA",9,5,0,4,1,5,-70.84001923,42.67964554
229,"IRMO SC",9,1,0,0,1,1,-81.18247223,34.08623123
229,"IRVINE CA",9,26,10,8,8,26,-117.8243942,33.66952515
229,"IRVING TX",9,13,4,3,6,13,-96.94924927,32.81419754
229,"ITHACA NY",9,67,19,13,35,67,-76.49575043,42.44075775
229,"JACKSON AL",9,2,0,0,2,2,-87.89234924,31.51841354
229,"JACKSON MI",9,8,4,3,1,8,-84.40149689,42.24575043
229,"JACKSON MO",9,1,0,1,0,1,-89.66656494,37.38225174
229,"JACKSON MS",9,138,49,30,59,138,-90.19654846,32.298172
229,"JACKSON OH",9,1,1,0,0,1,-82.63652039,39.05205917
229,"JACKSON TN",9,83,24,14,45,83,-88.81397247,35.61472321
229,"JACKSON WY",9,4,0,1,3,4,-110.7644806,43.4798851
229,"JACKSONVILLE AL",9,3,2,0,1,3,-85.76148987,33.81370163
229,"JACKSONVILLE AR",9,3,0,3,0,3,-92.11023712,34.86617279
229,"JACKSONVILLE BEACH FL",9,19,7,4,8,19,-81.39300537,30.29505539
229,"JACKSONVILLE FL",9,207,57,54,96,207,-81.65545654,30.33253288
229,"JACKSONVILLE IL",9,1,0,1,0,1,-90.22943115,39.73405838
229,"JANESVILLE WI",9,3,0,0,3,3,-89.01893616,42.68303299
229,"JASPER AL",9,1,0,0,1,1,-87.27728271,33.83164597
229,"JEFFERSON CITY MO",9,36,11,4,21,36,-92.17385864,38.57698441
229,"JEFFERSONVILLE IN",9,1,1,0,0,1,-85.73719788,38.27765656
229,"JENNINGS MO",9,27,5,10,12,27,-90.26077271,38.71944046
229,"JERSEY CITY NJ",9,158,37,55,66,158,-74.07667542,40.72816849
229,"JERSEYVILLE IL",9,1,0,0,1,1,-90.32881165,39.12010956
229,"JOHNSON CITY TN",9,24,6,8,10,24,-82.35308075,36.31352615
229,"JOLIET IL",9,35,9,16,10,35,-88.08213043,41.52493668
229,"JONES OK",9,5,2,1,2,5,-97.28777313,35.56618881
229,"JONESBORO AR",9,3,0,1,2,3,-90.70430756,35.84226608
229,"JONESBORO GA",9,12,8,2,2,12,-84.35381317,33.52181625
229,"JONESTOWN MS",9,2,1,1,0,2,-90.45589447,34.31987381
229,"JOPLIN MO",9,19,6,3,10,19,-94.5140686,37.08442688
229,"JUPITER FL",9,6,1,2,3,6,-80.09382629,26.9349556
229,"JUSTIN TX",9,1,0,0,1,1,-97.29656219,33.08527374
229,"KAHOKA MO",9,1,0,0,1,1,-91.71973419,40.42050934
229,"KALAMAZOO MI",9,184,53,45,86,184,-85.58725739,42.29179764
229,"KALISPELL MT",9,4,1,1,2,4,-114.3166199,48.20161438
229,"KANKAKEE IL",9,2,0,0,2,2,-87.86149597,41.12018204
229,"KANSAS CITY KS",9,5,4,1,0,5,-94.62808228,39.1141777
229,"KANSAS CITY MO",9,772,216,200,356,772,-94.57884979,39.09976578
229,"KAPLAN LA",9,2,1,0,1,2,-92.28516388,29.99839401
229,"KATY TX",9,22,7,6,9,22,-95.82484436,29.78606224
229,"KAUFMAN TX",9,1,1,0,0,1,-96.30930328,32.58925247
229,"KAUKAUNA WI",9,1,0,1,0,1,-88.27227783,44.27797699
229,"KEARNEY NE",9,6,3,2,1,6,-99.08208466,40.69932938
229,"KEARNY NJ",9,6,2,2,2,6,-74.14439392,40.76873398
229,"KELLER TX",9,12,4,3,5,12,-97.25247192,32.93486786
229,"KENDALL WI",9,2,1,0,1,2,-90.36859894,43.79189682
229,"KENDALLVILLE IN",9,2,1,1,0,2,-85.27036285,41.44488525
229,"KENLY NC",9,1,0,1,0,1,-78.12352753,35.59648514
229,"KENMORE NY",9,2,0,0,2,2,-78.86985779,42.96615982
229,"KENNEDALE TX",9,1,0,0,1,1,-97.22646332,32.64726639
229,"KENNER LA",9,1,0,0,1,1,-90.24167633,29.99442101
229,"KENNESAW GA",9,12,3,5,4,12,-84.61528015,34.02365875
229,"KENNETT MO",9,4,1,1,2,4,-90.05591583,36.23639297
229,"KENNETT SQUARE PA",9,1,0,0,1,1,-75.71079254,39.84713364
229,"KENNEWICK WA",9,3,0,2,1,3,-119.1395264,46.2107811
229,"KENOSHA WI",9,7,2,2,3,7,-87.82134247,42.58494949
229,"KENT OH",9,45,9,10,26,45,-81.35736084,41.15368271
229,"KENT WA",9,141,39,32,70,141,-122.2377701,47.38068008
229,"KETTERING OH",9,2,0,0,2,2,-84.1687088,39.68964005
229,"KEY BISCAYNE FL",9,2,0,0,2,2,-80.16217804,25.6944294
229,"KEY WEST FL",9,28,9,9,10,28,-81.78218079,24.556427
229,"KILL DEVIL HILLS NC",9,1,0,0,1,1,-75.6541214,36.01398468
229,"KILLEEN TX",9,6,1,2,3,6,-97.72832489,31.11753464
229,"KINGSLAND GA",9,1,0,0,1,1,-81.68964386,30.80049896
229,"KINGSPORT TN",9,136,37,29,70,136,-82.56182861,36.54841232
229,"KINGSTON NY",9,4,1,0,3,4,-73.99665833,41.92714691
229,"KINLOCH MO",9,1,0,0,1,1,-90.32682037,38.74011612
229,"KIRKLAND WA",9,25,10,4,11,25,-122.2108688,47.6813736
229,"KIRKSVILLE MO",9,4,2,0,2,4,-92.58364105,40.19476318
229,"KIRKWOOD MO",9,43,14,11,18,43,-90.40686798,38.5832901
229,"KISSIMMEE FL",9,13,5,4,4,13,-81.40729523,28.29271317
229,"KITTERY ME",9,1,0,1,0,1,-70.73544312,43.08844376
229,"KLAMATH FALLS OR",9,3,0,2,1,3,-121.7844772,42.2244873
229,"KNOXVILLE TN",9,71,17,18,36,71,-83.92067719,35.96077728
229,"KODIAK AK",9,23,9,9,5,23,-152.3966675,57.7966423
229,"KOKOMO IN",9,22,5,7,10,22,-86.12706757,40.48566818
229,"KOSCIUSKO MS",9,1,1,0,0,1,-89.58911133,33.06314087
229,"KOUNTZE TX",9,19,4,3,12,19,-94.31259918,30.3719101
229,"KUTZTOWN PA",9,2,0,1,1,2,-75.77677917,40.51739502
229,"KYLE TX",9,2,1,0,1,2,-97.87797546,29.9895649
229,"LA CROSSE WI",9,21,7,7,7,21,-91.23967743,43.80151367
229,"LA GRANDE OR",9,7,1,3,3,7,-118.090126,45.32435989
229,"LA GRANGE TX",9,1,0,1,0,1,-96.87730408,29.90603638
229,"LA MARQUE TX",9,1,1,0,0,1,-94.97169495,29.37788391
229,"LA MESA CA",9,1,0,0,1,1,-117.0447464,32.76841354
229,"LA MIRADA CA",9,1,0,0,1,1,-118.0295639,33.85194778
229,"LA VERNE CA",9,2,0,0,2,2,-117.7696304,34.1006546
229,"LACEY WA",9,9,2,0,7,9,-122.8096161,47.03732681
229,"LADY LAKE FL",9,2,0,1,1,2,-81.92842865,28.92837715
229,"LAFAYETTE CA",9,4,0,1,3,4,-122.1200104,37.88574982
229,"LAFAYETTE CO",9,2,1,0,1,2,-105.0904388,39.99370956
229,"LAFAYETTE IN",9,12,4,3,5,12,-86.88406372,40.42077255
229,"LAFAYETTE LA",9,67,15,18,34,67,-92.01987457,30.22468185
229,"LAFAYETTE TN",9,1,0,1,0,1,-86.02629089,36.52130127
229,"LAGUNA BEACH CA",9,13,5,2,6,13,-117.7847061,33.54205322
229,"LAKE BLUFF IL",9,2,0,0,2,2,-87.83427429,42.2790184
229,"LAKE CHARLES LA",9,4,1,1,2,4,-93.21766663,30.22713852
229,"LAKE FOREST IL",9,1,1,0,0,1,-87.84095764,42.25865555
229,"LAKE GENEVA WI",9,1,0,0,1,1,-88.43348694,42.59184265
229,"LAKE JACKSON TX",9,1,0,1,0,1,-95.43475342,29.03430176
229,"LAKE STATION IN",9,1,1,0,0,1,-87.23908997,41.57525253
229,"LAKE WORTH FL",9,3,2,0,1,3,-80.05649567,26.61662102
229,"LAKELAND FL",9,22,7,3,12,22,-81.95620728,28.04432487
229,"LAKEWOOD CA",9,2,0,1,1,2,-118.1357193,33.85370636
229,"LAKEWOOD CO",9,4,1,1,2,4,-105.0827332,39.70486069
229,"LAKEWOOD OH",9,50,12,13,25,50,-81.79773712,41.48223114
229,"LAKEWOOD WA",9,4,1,1,0,2,-122.3653679,47.661533355
229,"LANCASTER CA",9,5,1,1,3,5,-118.1386871,34.69804001
229,"LANCASTER NY",9,3,0,2,1,3,-78.67009735,42.90063477
229,"LANCASTER OH",9,1,1,0,0,1,-82.59890747,39.71387482
229,"LANCASTER PA",9,29,9,7,13,29,-76.30498505,40.03824234
229,"LANCASTER SC",9,1,0,0,1,1,-80.76622772,34.71495819
229,"LANCASTER TX",9,1,1,0,0,1,-96.75682831,32.59244156
229,"LANDER WY",9,1,1,0,0,1,-108.7319489,42.83276749
229,"LANDOVER HILLS MD",9,1,1,0,0,1,-76.89152527,38.94342804
229,"LANGLEY WA",9,5,1,0,4,5,-122.4162674,48.03789139
229,"LANSDOWNE PA",9,6,2,0,4,6,-75.27108765,39.93852234
229,"LANSING IL",9,2,1,0,1,2,-87.5393219,41.56502151
229,"LANSING MI",9,51,10,14,27,51,-84.55532074,42.73265839
229,"LAPEER MI",9,1,0,0,1,1,-83.31890869,43.05135345
229,"LARAMIE WY",9,7,3,1,3,7,-105.592804,41.3115387
229,"LAREDO TX",9,12,0,4,8,12,-99.50824738,27.50720978
229,"LARGO FL",9,52,17,18,17,52,-82.78675079,27.91026115
229,"LARKSPUR CA",9,3,0,2,1,3,-122.5373993,37.93414688
229,"LAS CRUCES NM",9,10,2,2,6,10,-106.7798538,32.31209564
229,"LAS VEGAS NV",9,787,197,202,388,787,-115.1382141,36.17488098
229,"LATHROP MO",9,1,0,0,1,1,-94.33037567,39.54841995
229,"LAUDERDALE LAKES FL",9,3,1,0,2,3,-80.20793915,26.1671524
229,"LAWRENCE KS",9,87,27,17,43,87,-95.23565674,38.97153091
229,"LAWRENCE MA",9,1,0,1,0,1,-71.15792084,42.70630646
229,"LAWRENCEBURG KY",9,1,0,0,1,1,-84.89624023,38.03728867
229,"LAWRENCEBURG TN",9,2,0,2,0,2,-87.33492279,35.24256897
229,"LAWRENCEVILLE GA",9,20,2,4,14,20,-83.98753357,33.95662308
229,"LAWTON OK",9,10,1,1,8,10,-98.39124298,34.60861969
229,"LAYTONSVILLE MD",9,1,0,0,1,1,-77.14225006,39.21226501
229,"LEAGUE CITY TX",9,19,4,4,11,19,-95.09550476,29.50793457
229,"LEANDER TX",9,4,1,0,3,4,-97.85368347,30.57936287
229,"LEAWOOD KS",9,3,0,1,2,3,-94.61756897,38.96688461
229,"LEBANON PA",9,1,0,0,1,1,-76.41091156,40.34118652
229,"LEBANON TN",9,6,1,3,2,6,-86.29133606,36.20846939
229,"LEBANON VA",9,1,0,1,0,1,-82.07959747,36.90112305
229,"LEESBURG FL",9,12,3,6,3,12,-81.87727356,28.81123161
229,"LEESBURG VA",9,6,1,2,3,6,-77.56890869,39.11256027
229,"LEESPORT PA",9,1,1,0,0,1,-75.96580505,40.44723892
229,"LELAND NC",9,2,0,1,1,2,-78.04415131,34.25672913
229,"LEMOORE CA",9,1,0,1,0,1,-119.7849197,36.30083084
229,"LENEXA KS",9,3,0,2,1,3,-94.73374176,38.95368576
229,"LESLIE MO",9,2,0,1,1,2,-91.23233795,38.41774368
229,"LEWES DE",9,10,6,2,2,10,-75.1359024,38.77365494
229,"LEWISPORT KY",9,1,0,1,0,1,-86.90222931,37.93730164
229,"LEWISTON ID",9,2,1,1,0,2,-117.0198975,46.41637421
229,"LEWISVILLE TX",9,15,3,4,8,15,-96.99449921,33.04630661
229,"LEXINGTON MA",9,2,1,0,1,2,-71.22381592,42.44742584
229,"LEXINGTON SC",9,11,0,4,7,11,-81.23597717,33.98204041
229,"LEXINGTON VA",9,2,1,0,1,2,-79.4422226,37.78420639
229,"LIBBY MT",9,7,4,2,1,7,-115.5511856,48.38265991
229,"LIBERAL MO",9,4,1,3,0,4,-94.52056122,37.55810547
229,"LIBERTY MO",9,21,9,6,6,21,-94.4196167,39.24604034
229,"LIGONIER PA",9,1,0,1,0,1,-79.23710632,40.24316025
229,"LILBURN GA",9,2,0,1,1,2,-84.14273834,33.89017868
229,"LINCOLN CA",9,6,3,1,2,6,-121.2951202,38.89149475
229,"LINCOLN CITY OR",9,1,0,1,0,1,-124.0207748,44.95772934
229,"LINCOLN IL",9,1,0,0,1,1,-89.36495209,40.1486702
229,"LINCOLN NE",9,36,15,7,14,36,-96.6674118,40.80001068
229,"LINCOLN PARK MI",9,2,1,0,1,2,-83.17868042,42.25064468
229,"LINDEN NJ",9,1,0,1,0,1,-74.24382782,40.62202454
229,"LINN MO",9,1,1,0,0,1,-91.85089874,38.48598862
229,"LISBON OH",9,4,2,2,0,4,-80.76804352,40.77227402
229,"LITCHFIELD IL",9,1,0,1,0,1,-89.65457916,39.17536163
229,"LITITZ PA",9,2,0,1,1,2,-76.30600739,40.15749741
229,"LITTLE ROCK AR",9,195,60,44,91,195,-92.28178406,34.7369194
229,"LITTLETON CO",9,7,1,4,2,7,-105.0176163,39.6132431
229,"LITTLETON MA",9,1,1,0,0,1,-71.50911713,42.54176712
229,"LIVERPOOL NY",9,1,0,0,1,1,-76.21547699,43.10769653
229,"LIVINGSTON MT",9,1,0,0,1,1,-110.5622253,45.66219711
229,"LIVONIA MI",9,3,1,0,2,3,-83.35256958,42.36862564
229,"LLANO TX",9,1,0,0,1,1,-98.67580414,30.7595768
229,"LOCKPORT NY",9,3,0,1,2,3,-78.69011688,43.17089081
229,"LODI CA",9,2,1,1,0,2,-121.2742386,38.12984467
229,"LOGAN UT",9,17,6,2,9,17,-111.8171616,41.73900604
229,"LOGANSPORT IN",9,2,1,0,1,2,-86.36410522,40.75329208
229,"LOGANVILLE GA",9,5,2,1,2,5,-83.90035248,33.83914948
229,"LOMIRA WI",9,9,1,3,5,9,-88.44380188,43.59117126
229,"LOMITA CA",9,3,0,2,1,3,-118.3169556,33.79204941
229,"LOMPOC CA",9,1,0,0,1,1,-120.4598694,34.63894272
229,"LONDON KY",9,1,1,0,0,1,-84.08328247,37.12937546
229,"LONG BEACH CA",9,115,40,19,56,115,-118.1908112,33.7670517
229,"LONG BEACH NY",9,2,1,1,0,2,-73.6654129,40.58349991
229,"LONGMONT CO",9,6,1,2,3,6,-105.1026764,40.16700745
229,"LONGVIEW TX",9,7,2,2,3,7,-94.73707581,32.4966507
229,"LONGVIEW WA",9,2,1,0,1,2,-122.9404221,46.1375885
229,"LORAIN OH",9,4,0,0,4,4,-82.17118073,41.45874023
229,"LOS ALTOS CA",9,3,1,2,0,3,-122.1163025,37.38525772
229,"LOS ANGELES CA",9,3139,850,736,1553,3139,-118.2459106,34.05225754
229,"LOS GATOS CA",9,5,0,2,3,5,-121.9771652,37.22674561
229,"LOUISA KY",9,2,0,0,2,2,-82.60322571,38.11429596
229,"LOUISA VA",9,1,0,1,0,1,-78.00349426,38.0253067
229,"LOUISVILLE CO",9,1,1,0,0,1,-105.1326523,39.97768402
229,"LOVELAND CO",9,13,0,2,11,13,-105.0755997,40.39763641
229,"LOVELAND OH",9,1,1,0,0,1,-84.25993347,39.26356506
229,"LOWELL IN",9,8,2,1,5,8,-87.42073059,41.29130173
229,"LOWELL MA",9,2,0,0,2,2,-71.31530762,42.63344574
229,"LUBBOCK TX",9,43,13,14,16,43,-101.8544312,33.59677505
229,"LUCEDALE MS",9,4,1,1,2,4,-88.59013367,30.92567635
229,"LUFKIN TX",9,1,0,0,1,1,-94.72932434,31.33858681
229,"LUMBERTON NC",9,3,2,1,0,3,-79.00803375,34.61832428
229,"LYNCHBURG VA",9,2,1,1,0,2,-79.14174652,37.41383362
229,"LYNDHURST NJ",9,1,1,0,0,1,-74.12353516,40.81222153
229,"LYNDHURST OH",9,1,0,0,1,1,-81.48820496,41.52012253
229,"LYNN MA",9,8,3,1,4,8,-70.94833374,42.46699905
229,"LYNNWOOD WA",9,13,2,4,7,13,-122.3175736,47.82042313
229,"LYNWOOD CA",9,12,3,2,7,12,-118.2135544,33.93053055
229,"MACKINAW IL",9,1,0,1,0,1,-89.35753632,40.53728104
229,"MACOMB IL",9,1,0,1,0,1,-90.67189026,40.45938873
229,"MADISON GA",9,2,1,1,0,2,-83.4675827,33.59574127
229,"MADISON HEIGHTS MI",9,2,0,0,2,2,-83.10519409,42.48604965
229,"MADISON IL",9,2,0,0,2,2,-90.15700531,38.68284988
229,"MADISON MS",9,6,1,1,4,6,-90.11543274,32.46231079
229,"MADISON NJ",9,3,1,0,2,3,-74.41627502,40.76013184
229,"MADISON WI",9,169,65,24,80,169,-89.40128326,43.07303619
229,"MAGNOLIA TX",9,2,0,0,2,2,-95.75150299,30.20981598
229,"MAHWAH NJ",9,1,0,0,1,1,-74.14279175,41.08900452
229,"MAIZE KS",9,1,0,1,0,1,-97.46515656,37.77322006
229,"MALDEN MA",9,2,0,1,1,2,-71.06546783,42.42518234
229,"MALVERN PA",9,4,4,0,0,4,-75.51319885,40.03642654
229,"MANASQUAN NJ",9,1,1,0,0,1,-74.04832458,40.12630463
229,"MANASSAS PARK VA",9,1,0,1,0,1,-77.46895599,38.7841301
229,"MANASSAS VA",9,5,2,1,2,5,-77.47459412,38.75112534
229,"MANCHESTER CT",9,1,1,0,0,1,-72.52075958,41.77622986
229,"MANCHESTER MO",9,1,0,0,1,1,-90.50953674,38.597229
229,"MANCHESTER NH",9,37,10,7,20,37,-71.45406342,42.99581528
229,"MANDEVILLE LA",9,3,0,1,2,3,-90.06562805,30.35881805
229,"MANHATTAN BEACH CA",9,8,2,1,5,8,-118.4129181,33.88484192
229,"MANHATTAN KS",9,18,2,6,10,18,-96.57228851,39.18354034
229,"MANITOU SPRINGS CO",9,2,0,0,2,2,-104.9184494,38.85948944
229,"MANKATO MN",9,56,7,17,32,56,-94.02125549,44.15895462
229,"MANSFIELD OH",9,2,0,1,1,2,-82.51545715,40.75864792
229,"MANSFIELD TX",9,2,0,1,1,2,-97.14230347,32.56362152
229,"MANTECA CA",9,4,0,1,3,4,-121.2179031,37.79747391
229,"MAPLE GROVE MN",9,1,0,1,0,1,-93.47679138,45.14711761
229,"MAPLE HEIGHTS OH",9,1,0,0,1,1,-81.5656662,41.41540146
229,"MAPLETON KS",9,1,1,0,0,1,-94.8840332,38.01527786
229,"MAPLEWOOD MO",9,10,6,1,3,10,-90.32471466,38.6126976
229,"MAPLEWOOD NJ",9,2,0,0,2,2,-74.27243805,40.77401733
229,"MARIANNA FL",9,9,4,2,3,9,-85.22673798,30.77488518
229,"MARICOPA AZ",9,4,1,0,3,4,-112.0491562,33.05832672
229,"MARIETTA GA",9,46,15,14,17,46,-84.54958344,33.9527359
229,"MARIETTA OK",9,1,1,0,0,1,-97.11754608,33.93697739
229,"MARINGOUIN LA",9,1,1,0,0,1,-91.51993561,30.49166107
229,"MARION AR",9,7,2,3,2,7,-90.19646454,35.21472931
229,"MARION IL",9,3,0,1,2,3,-88.93344116,37.73056412
229,"MARION IN",9,2,1,1,0,2,-85.65896606,40.55827332
229,"MARION NC",9,3,1,2,0,3,-82.00868225,35.68405914
229,"MARION OH",9,2,2,0,0,2,-83.12861633,40.58881378
229,"MARION SC",9,1,1,0,0,1,-79.40047455,34.18493271
229,"MARKHAM IL",9,1,0,1,0,1,-87.69510651,41.59363937
229,"MARKS MS",9,8,1,5,2,8,-90.27207947,34.25684357
229,"MARLBOROUGH MA",9,4,1,0,3,4,-71.55128479,42.34592819
229,"MARSHALL MI",9,1,1,0,0,1,-84.9631424,42.27227402
229,"MARSHALL MN",9,15,3,4,8,15,-95.78921509,44.4466362
229,"MARSHALL MO",9,4,0,2,2,4,-93.19745636,39.12294769
229,"MARSHALLTOWN IA",9,3,1,1,1,3,-92.90861511,42.04956055
229,"MARSHFIELD MO",9,1,1,0,0,1,-92.90744781,37.33891678
229,"MARTIN GA",9,1,0,0,1,1,-83.1847229,34.48738861
229,"MARTIN TN",9,2,1,1,0,2,-88.85335541,36.34902573
229,"MARTINEZ CA",9,1,1,0,0,1,-122.1364365,38.01914597
229,"MARTINS FERRY OH",9,1,1,0,0,1,-80.72425842,40.09586716
229,"MARTINSBURG WV",9,1,1,0,0,1,-77.96557617,39.45707703
229,"MARYLAND HEIGHTS MO",9,8,1,2,5,8,-90.43025208,38.71334076
229,"MARYSVILLE WA",9,3,1,1,1,3,-122.179451,48.05155182
229,"MARYVILLE MO",9,4,2,0,2,4,-94.87281036,40.34609604
229,"MASON CITY IA",9,1,0,0,1,1,-93.20175934,43.15355301
229,"MASON OH",9,1,0,0,1,1,-84.30989075,39.36032104
229,"MASSENA NY",9,2,0,1,1,2,-74.89122772,44.92828751
229,"MASSILLON OH",9,4,2,0,2,4,-81.52096558,40.7966156
229,"MATTHEWS NC",9,1,0,1,0,1,-80.72332001,35.11704254
229,"MAYETTA KS",9,1,0,1,0,1,-95.72317505,39.33889008
229,"MAYFIELD KY",9,2,2,0,0,2,-88.63654327,36.74169922
229,"MAYVILLE WI",9,1,0,0,1,1,-88.54499817,43.49409103
229,"MAYWOOD IL",9,1,0,0,1,1,-87.84314728,41.87941742
229,"MCALLEN TX",9,21,6,6,9,21,-98.23077393,26.20433426
229,"MCCOMB MS",9,2,1,0,1,2,-90.45623016,31.2437973
229,"MCDONOUGH GA",9,7,6,1,0,7,-84.1467514,33.44765472
229,"MCGREGOR TX",9,1,0,0,1,1,-97.41001129,31.44441986
229,"MCHENRY IL",9,1,0,1,0,1,-88.2740097,42.34480286
229,"MCKINNEY TX",9,3,0,1,2,3,-96.6155777,33.19782257
229,"MCLEANSBORO IL",9,1,0,0,1,1,-88.53587341,38.09341049
229,"MCMINNVILLE OR",9,3,0,2,1,3,-123.2019272,45.20968628
229,"MEADVILLE PA",9,2,0,0,2,2,-80.15116119,41.64140701
229,"MECHANICSBURG PA",9,1,0,0,1,1,-77.00779724,40.21432114
229,"MEDFORD MA",9,2,1,0,1,2,-71.10526276,42.41849518
229,"MEDFORD OR",9,8,4,2,2,8,-122.8773193,42.32625961
229,"MEDIA PA",9,2,2,0,0,2,-75.38693237,39.91692734
229,"MEDINA OH",9,3,0,0,3,3,-81.86336517,41.13858795
229,"MELBOURNE FL",9,9,1,5,3,9,-80.60625458,28.07838249
229,"MEMPHIS TN",9,458,119,104,235,458,-90.01696014,35.1194191
229,"MENA AR",9,9,2,6,1,9,-94.24035645,34.58638
229,"MENDOTA CA",9,4,1,1,2,4,-120.3840103,36.75325012
229,"MENLO PARK CA",9,12,4,4,4,12,-122.1842423,37.45361328
229,"MENOMINEE MI",9,1,0,0,1,1,-87.61431885,45.10792542
229,"MENOMONEE FALLS WI",9,2,0,1,1,2,-88.11719513,43.17907715
229,"MENTOR OH",9,2,2,0,0,2,-81.33918762,41.66637421
229,"MERCED CA",9,7,0,1,6,7,-120.4848785,37.30197525
229,"MERCEDES TX",9,2,0,0,2,2,-97.91394043,26.15032959
229,"MERIDEN CT",9,1,0,1,0,1,-72.80596161,41.5384407
229,"MERRILL WI",9,2,0,0,2,2,-89.6834259,45.18042755
229,"MERRILLVILLE IN",9,1,0,1,0,1,-87.33312988,41.48298645
229,"MESA AZ",9,60,9,16,35,60,-111.8239059,33.42222214
229,"MESQUITE NV",9,1,0,1,0,1,-114.0683136,36.80557251
229,"MESQUITE TX",9,14,4,6,4,14,-96.59959412,32.76692581
229,"MIAMI BEACH FL",9,52,15,13,24,52,-80.12982178,25.79146576
229,"MIAMI FL",9,521,122,128,271,521,-80.19329071,25.77483749
229,"MIAMI OK",9,3,0,2,1,3,-94.87779999,36.87476349
229,"MIAMISBURG OH",9,2,0,1,1,2,-84.28652191,39.643116
229,"MIDDLEBURY VT",9,5,2,0,3,5,-73.16629028,44.01540756
229,"MIDDLESEX NJ",9,1,1,0,0,1,-74.49213409,40.57284164
229,"MIDDLETON WI",9,1,0,0,1,1,-89.50476074,43.09717941
229,"MIDDLETOWN CT",9,2,1,0,1,2,-72.64955902,41.56232071
229,"MIDDLETOWN NY",9,2,0,1,1,2,-74.4223938,41.44607544
229,"MIDDLETOWN OH",9,4,0,3,1,4,-84.39844513,39.51361084
229,"MIDLAND MI",9,5,1,1,3,5,-84.24700928,43.61585236
229,"MIDLAND TX",9,5,0,3,2,5,-102.0793686,31.99754143
229,"MIDWEST CITY OK",9,3,0,1,2,3,-97.39709473,35.44970703
229,"MILAN IL",9,3,1,0,2,3,-90.57264709,41.45294952
229,"MILAN TN",9,1,1,0,0,1,-88.75936127,35.91966248
229,"MILFORD MA",9,3,0,1,2,3,-71.51522064,42.14015198
229,"MILFORD NY",9,22,5,11,6,22,-74.94455719,42.59064865
229,"MILL VALLEY CA",9,10,2,5,3,10,-122.5473328,37.90579224
229,"MILLBROOK NY",9,4,2,1,1,4,-73.69306183,41.78520966
229,"MILLEDGEVILLE GA",9,1,0,0,1,1,-83.23179626,33.08055878
229,"MILLTOWN NJ",9,2,1,1,0,2,-74.44260406,40.45628738
229,"MILPITAS CA",9,1,0,0,1,1,-121.9090805,37.42808533
229,"MILTON DE",9,1,1,0,0,1,-75.31299591,38.77088547
229,"MILTON FL",9,1,0,1,0,1,-87.03953552,30.63289833
229,"MILTON MA",9,3,0,1,2,3,-71.06531525,42.25027466
229,"MILWAUKEE WI",9,344,97,78,169,344,-87.90684509,43.03887939
229,"MILWAUKIE OR",9,3,1,1,1,3,-122.6417084,45.44596481
229,"MINDEN LA",9,102,31,8,63,102,-93.28716278,32.61589432
229,"MINNEAPOLIS MN",9,506,129,129,248,506,-93.26397705,44.97980118
229,"MINNESOTA CITY MN",9,1,1,0,0,1,-91.74989319,44.09374237
229,"MINNETONKA MN",9,1,0,0,1,1,-93.43367004,44.92795181
229,"MINOT ND",9,4,0,2,2,4,-101.2953949,48.23139572
229,"MIRAMAR FL",9,3,1,0,2,3,-80.23181915,25.98794746
229,"MISSION KS",9,34,10,11,13,34,-94.65638733,39.02796173
229,"MISSION TX",9,6,0,2,4,6,-98.32580566,26.21655273
229,"MISSION VIEJO CA",9,5,3,2,0,5,-117.6737366,33.59992218
229,"MISSOULA MT",9,16,4,4,8,16,-113.9832687,46.87278366
229,"MISSOURI CITY TX",9,5,2,1,2,5,-95.5381012,29.61878204
229,"MOAB UT",9,1,0,0,1,1,-109.5508347,38.57315063
229,"MOBERLY MO",9,1,1,0,0,1,-92.43862152,39.41818619
229,"MOBILE AL",9,62,15,11,36,62,-88.04309845,30.69476128
229,"MODESTO CA",9,48,8,19,21,48,-120.9991455,37.63897324
229,"MOKENA IL",9,1,1,0,0,1,-87.88947296,41.52630615
229,"MOLINE IL",9,1,0,1,0,1,-90.51522064,41.5069809
229,"MONESSEN PA",9,2,0,1,1,2,-79.88707733,40.14862442
229,"MONMOUTH OR",9,1,0,0,1,1,-123.2363892,44.84816742
229,"MONROE LA",9,44,11,16,17,44,-92.11960602,32.50980759
229,"MONROE WA",9,4,0,1,3,4,-121.9735718,47.85487747
229,"MONROVIA CA",9,3,2,0,1,3,-118.0006485,34.14796829
229,"MONTCLAIR NJ",9,6,2,0,4,6,-74.20848083,40.82605362
229,"MONTEBELLO CA",9,1,0,0,1,1,-118.1069412,34.00930023
229,"MONTEVALLO AL",9,1,0,1,0,1,-86.86419678,33.10087967
229,"MONTGOMERY AL",9,37,11,7,19,37,-86.29966736,32.36724472
229,"MONTGOMERY TX",9,5,2,0,3,5,-95.69664001,30.38855171
229,"MONTPELIER VT",9,3,1,0,2,3,-72.57458496,44.26039124
229,"MOORE OK",9,23,3,5,15,23,-97.48735046,35.33969498
229,"MOORESTOWN NJ",9,1,1,0,0,1,-74.94165039,39.96718597
229,"MOORESVILLE IN",9,1,0,0,1,1,-86.37399292,39.61291504
229,"MOORESVILLE NC",9,8,4,1,3,8,-80.80976868,35.58535004
229,"MOORHEAD MN",9,4,2,1,1,4,-96.76844025,46.87382507
229,"MOREHEAD CITY NC",9,1,0,0,1,1,-76.72536469,34.72343445
229,"MOREHEAD KY",9,2,0,2,0,2,-83.43223572,38.18409348
229,"MORGAN CITY LA",9,2,1,1,0,2,-91.20729065,29.69994926
229,"MORGAN HILL CA",9,1,1,0,0,1,-121.6563797,37.1303978
229,"MORGANTOWN WV",9,29,5,13,11,29,-79.95038605,39.63131714
229,"MORNINGSIDE MD",9,1,0,0,1,1,-76.89069366,38.8301239
229,"MORRIS IL",9,1,1,0,0,1,-88.42147064,41.3571167
229,"MORRIS MN",9,1,0,1,0,1,-95.91436005,45.58617401
229,"MORRISON IL",9,2,1,0,1,2,-89.96530914,41.80975723
229,"MORRISTOWN NJ",9,3,1,2,0,3,-74.48057556,40.79689789
229,"MORRISTOWN TN",9,1,0,0,1,1,-83.29478455,36.21415329
229,"MORRISVILLE NC",9,1,1,0,0,1,-78.82486725,35.82374954
229,"MORRO BAY CA",9,2,0,0,2,2,-120.8519135,35.36568451
229,"MOSCOW ID",9,9,2,4,3,9,-117.0021973,46.73223877
229,"MOSES LAKE WA",9,2,0,1,1,2,-119.2802811,47.12987137
229,"MOULTON AL",9,4,1,1,2,4,-87.29332733,34.48143387
229,"MOULTRIE GA",9,1,0,1,0,1,-83.78891754,31.18035507
229,"MOUND MN",9,1,1,0,0,1,-93.66635132,44.93652725
229,"MOUND VALLEY KS",9,3,1,2,0,3,-95.40553284,37.20561218
229,"MOUNDSVILLE WV",9,55,12,9,34,55,-80.74716949,39.92013931
229,"MOUNT JOY PA",9,1,0,0,1,1,-76.50283051,40.10977936
229,"MOUNT MORRIS NY",9,1,0,0,1,1,-77.87361145,42.72562408
229,"MOUNT PLEASANT MI",9,3,1,0,2,3,-84.76785278,43.59777832
229,"MOUNT PLEASANT SC",9,1,0,0,1,1,-79.86242676,32.79427719
229,"MOUNT RAINIER MD",9,7,4,0,3,7,-76.96430206,38.9414978
229,"MOUNT VERNON IL",9,2,0,0,2,2,-88.90307617,38.31738663
229,"MOUNT VERNON IN",9,1,1,0,0,1,-87.89586639,37.93523407
229,"MOUNT VERNON NY",9,6,1,0,2,3,-76.36322403,41.83351135
229,"MOUNT VERNON TX",9,3,1,1,1,3,-95.22182465,33.18909454
229,"MOUNTAIN BROOK AL",9,2,0,0,2,2,-86.7520752,33.50109482
229,"MOUNTAIN HOME AR",9,1,0,1,0,1,-92.38542175,36.33543015
229,"MOUNTAIN HOME ID",9,3,1,1,1,3,-115.6928406,43.13270187
229,"MOUNTAIN VIEW AR",9,1,1,0,0,1,-92.11795807,35.86831665
229,"MOUNTAIN VIEW CA",9,28,8,7,13,28,-122.0861969,37.3859024
229,"MUKILTEO WA",9,1,1,0,0,1,-122.3008041,47.94359589
229,"MUNCIE IN",9,14,3,4,7,14,-85.38398743,40.18970871
229,"MUNFORDVILLE KY",9,1,0,0,1,1,-85.89085388,37.27248383
229,"MUNISING MI",9,1,0,1,0,1,-86.64807892,46.410923
229,"MURFREESBORO TN",9,22,4,7,11,22,-86.39038086,35.84575653
229,"MURPHY NC",9,3,1,1,1,3,-84.03442383,35.08757019
229,"MURRAY KY",9,3,1,0,2,3,-88.31504059,36.61037827
229,"MURRIETA CA",9,1,1,0,0,1,-117.2157898,33.55398941
229,"MUSCATINE IA",9,26,4,10,12,26,-91.05540466,41.4216156
229,"MUSKEGON MI",9,18,5,1,3,9,-86.25441742,43.23139763
229,"MUSKOGEE OK",9,14,6,2,6,14,-95.36999512,35.74824142
229,"MYRTLE BEACH SC",9,10,3,4,3,10,-78.88601685,33.69656372
229,"NACOGDOCHES TX",9,5,1,1,3,5,-94.6559906,31.60386467
229,"NAMPA ID",9,8,2,1,5,8,-116.5658188,43.54054642
229,"NAPA CA",9,11,1,5,5,11,-122.2872086,38.29692841
229,"NAPAVINE WA",9,1,0,0,1,1,-122.911026,46.57439804
229,"NAPERVILLE IL",9,31,13,8,10,31,-88.14768219,41.78578949
229,"NAPLES FL",9,15,5,1,9,15,-81.79434204,26.14280128
229,"NASHVILLE GA",9,2,0,1,1,2,-83.24996185,31.20802689
229,"NASHVILLE IL",9,3,1,0,2,3,-89.3805542,38.34370804
229,"NATCHITOCHES LA",9,2,0,0,2,2,-93.08662415,31.76096535
229,"NATICK MA",9,1,0,0,1,1,-71.3484726,42.2836113
229,"NAUGATUCK CT",9,4,1,2,1,4,-73.04972076,41.4863205
229,"NAVASOTA TX",9,1,0,0,1,1,-96.08838654,30.38853645
229,"NAZARETH PA",9,16,3,2,11,16,-75.30902863,40.74064255
229,"NECHE ND",9,1,0,1,0,1,-97.54907227,48.97986603
229,"NEDERLAND TX",9,2,0,0,2,2,-93.99260712,29.97476387
229,"NEEDHAM MA",9,3,2,1,0,3,-71.21767426,42.27159119
229,"NEENAH WI",9,2,0,2,0,2,-88.4626236,44.18569183
229,"NEODESHA KS",9,1,1,0,0,1,-95.68075562,37.41866684
229,"NEW ALBANY IN",9,4,0,1,3,4,-85.80917358,38.29167938
229,"NEW BEDFORD MA",9,2,1,0,1,2,-70.93328857,41.63626862
229,"NEW BERN NC",9,4,1,0,3,4,-77.04354095,35.10897827
229,"NEW BRAUNFELS TX",9,2,0,0,2,2,-98.12486267,29.70325089
229,"NEW BRITAIN CT",9,2,0,1,1,2,-72.77884674,41.6615181
229,"NEW BRUNSWICK NJ",9,3,0,1,2,3,-74.45104218,40.48620987
229,"NEW CANAAN CT",9,2,0,0,2,2,-73.49369049,41.14690018
229,"NEW CARLISLE OH",9,2,0,0,2,2,-84.02508545,39.93630219
229,"NEW CARROLLTON MD",9,3,2,0,1,3,-76.8794632,38.97011185
229,"NEW CASTLE DE",9,5,0,2,3,5,-75.56227875,39.66440964
229,"NEW HARMONY IN",9,2,0,0,2,2,-87.93526459,38.12969589
229,"NEW HAVEN CT",9,169,49,52,68,169,-72.92726898,41.3084259
229,"NEW HYDE PARK NY",9,1,0,0,1,1,-73.68697357,40.73532867
229,"NEW KENSINGTON PA",9,2,0,0,2,2,-79.76441956,40.57001114
229,"NEW LONDON CT",9,4,0,3,1,4,-72.09841156,41.35572815
229,"NEW LONDON MN",9,2,0,1,1,2,-94.94470978,45.30108261
229,"NEW MADRID MO",9,7,2,1,4,7,-89.52796936,36.58650589
229,"NEW MILFORD NJ",9,1,0,0,1,1,-74.01824951,40.93526077
229,"NEW ORLEANS LA",9,663,192,147,324,663,-90.07525635,29.95483589
229,"NEW PALTZ NY",9,2,1,1,0,2,-74.08605194,41.74787903
229,"NEW PORT RICHEY FL",9,5,1,2,2,5,-82.71899414,28.24477577
229,"NEW ROCHELLE NY",9,2,1,0,1,2,-73.78160858,40.91175842
229,"NEW YORK NY",9,2303,640,560,1103,2303,-74.00528717,40.7145195
229,"NEWARK CA",9,1,0,1,0,1,-122.0424347,37.5296669
229,"NEWARK DE",9,30,9,8,13,30,-75.74462128,39.68774414
229,"NEWARK NJ",9,319,89,69,161,319,-74.17185211,40.73570633
229,"NEWARK OH",9,4,0,0,4,4,-82.40110779,40.05843353
229,"NEWBURGH NY",9,4,2,1,1,4,-74.00939941,41.50367737
229,"NEWCASTLE WA",9,25,6,9,10,25,-122.1575165,47.53847504
229,"NEWNAN GA",9,4,0,0,4,4,-84.79645538,33.37108231
229,"NEWPORT NEWS VA",9,15,5,3,7,15,-76.42758942,36.97909927
229,"NEWPORT OR",9,1,0,1,0,1,-124.0554047,44.6362915
229,"NEWPORT RI",9,12,6,2,4,12,-71.31213379,41.49024963
229,"NEWPORT TN",9,1,0,1,0,1,-83.18756104,35.96707916
229,"NEWTON KS",9,1,0,0,1,1,-97.3455658,38.04684067
229,"NEWTON MA",9,26,6,8,12,26,-71.20809937,42.33743286
229,"NEWTON NC",9,3,0,2,1,3,-81.22117615,35.67030334
229,"NEWTOWN PA",9,1,1,0,0,1,-74.93606567,40.22966003
229,"NIAGARA FALLS NY",9,8,2,0,6,8,-79.05632019,43.09456253
229,"NICEVILLE FL",9,1,0,1,0,1,-86.50150299,30.52109146
229,"NILES IL",9,1,0,0,1,1,-87.80277252,42.01877594
229,"NIXA MO",9,37,14,7,16,37,-93.29502869,37.04324341
229,"NOBLESVILLE IN",9,13,4,3,6,13,-86.01766205,40.03728104
229,"NOCONA TX",9,1,1,0,0,1,-97.72662354,33.78715515
229,"NODAWAY IA",9,1,0,0,1,1,-94.89551544,40.93712997
229,"NOEL MO",9,2,0,1,1,2,-94.4858551,36.54568481
229,"NOGALES AZ",9,2,0,1,1,2,-110.9357224,31.34046173
229,"NORCROSS GA",9,7,2,3,2,7,-84.21324158,33.94129181
229,"NORFOLK VA",9,91,24,19,48,91,-76.28334045,36.84831619
229,"NORMAL IL",9,5,1,2,2,5,-88.99052429,40.51409912
229,"NORMAN OK",9,29,8,5,16,29,-97.44689178,35.22203827
229,"NORRIS CITY IL",9,1,1,0,0,1,-88.32944489,37.98145676
229,"NORTH ADAMS MA",9,2,0,0,2,2,-73.10797882,42.70087814
229,"NORTH ANDOVER MA",9,1,1,0,0,1,-71.13425446,42.69897079
229,"NORTH AUGUSTA SC",9,6,1,2,3,6,-81.96509552,33.5021019
229,"NORTH BEND WA",9,23,6,7,10,23,-121.7899017,47.49547195
229,"NORTH BERGEN NJ",9,20,1,5,14,20,-74.0112381,40.8045845
229,"NORTH CANTON OH",9,7,0,1,6,7,-81.40194702,40.87594223
229,"NORTH CHARLESTON SC",9,3,0,2,1,3,-79.97457886,32.85499191
229,"NORTH CHICAGO IL",9,1,0,1,0,1,-87.8412323,42.3254509
229,"NORTH EAST PA",9,1,0,0,1,1,-79.83345795,42.21583176
229,"NORTH LAS VEGAS NV",9,4,2,2,0,4,-115.1192093,36.19900131
229,"NORTH LIBERTY IA",9,1,0,1,0,1,-91.59856415,41.74905777
229,"NORTH LITTLE ROCK AR",9,18,5,3,10,18,-92.26677704,34.76465988
229,"NORTH MIAMI BEACH FL",9,2,0,2,0,2,-80.16223907,25.93397713
229,"NORTH MIAMI FL",9,4,2,0,2,4,-80.18624115,25.8908596
229,"NORTH OLMSTED OH",9,1,0,1,0,1,-81.92334747,41.41566849
229,"NORTH PLATTE NE",9,4,1,0,3,4,-100.7660141,41.12404633
229,"NORTH RICHLAND HILLS TX",9,1,0,1,0,1,-97.22973633,32.83457947
229,"NORTH RIDGEVILLE OH",9,1,0,0,1,1,-82.04491425,41.37031937
229,"NORTH ROYALTON OH",9,1,0,0,1,1,-81.72419739,41.31388855
229,"NORTH SALT LAKE UT",9,1,1,0,0,1,-111.9105759,40.85150528
229,"NORTHAMPTON MA",9,4,0,2,2,4,-72.64012146,42.32544708
229,"NORTHBROOK IL",9,1,1,0,0,1,-87.82922363,42.12767792
229,"NORWALK CA",9,2,0,1,1,2,-118.0839539,33.90219116
229,"NORWALK CT",9,4,1,0,3,4,-73.40729523,41.11759949
229,"NORWALK OH",9,1,0,0,1,1,-82.61576843,41.24267197
229,"NORWICH CT",9,1,0,0,1,1,-72.07475281,41.52449036
229,"NORWOOD OH",9,1,0,1,0,1,-84.45967865,39.15586853
229,"NOVATO CA",9,6,1,2,3,6,-122.576561,38.11727142
229,"NOVI MI",9,1,0,1,0,1,-83.47566223,42.48064423
229,"NUCLA CO",9,1,0,0,1,1,-108.5491257,38.26947784
229,"NUTLEY NJ",9,3,1,0,2,3,-74.15930939,40.82229996
229,"NYACK NY",9,1,0,0,1,1,-73.91687012,41.09091568
229,"O'FALLON MO",9,43,12,10,21,43,-90.69979095,38.8109436
229,"OAK BLUFFS MA",9,2,2,0,0,2,-70.56096649,41.45436859
229,"OAK CREEK WI",9,1,0,1,0,1,-87.86346436,42.88599014
229,"OAK FOREST IL",9,1,0,0,1,1,-87.74399567,41.60294342
229,"OAK HARBOR WA",9,1,0,0,1,1,-122.6395798,48.29240036
229,"OAK LAWN IL",9,5,0,1,4,5,-87.7545929,41.721138
229,"OAK PARK IL",9,3,1,0,2,3,-87.78443909,41.88500595
229,"OAK PARK MI",9,2,1,0,0,1,-84.21956253,42.40898132
229,"OAK RIDGE TN",9,1,0,0,1,1,-84.26974487,36.01036072
229,"OAKDALE LA",9,3,1,1,1,3,-92.66092682,30.8165493
229,"OAKLAND CA",9,696,184,164,348,696,-122.2733154,37.80438614
229,"OAKLAND PARK FL",9,2,0,1,1,2,-80.13152313,26.1731205
229,"OBERLIN OH",9,1,1,0,0,1,-82.21720886,41.29413223
229,"OBLONG IL",9,6,0,1,5,6,-87.90914154,39.00207138
229,"OCALA FL",9,7,2,3,2,7,-82.13973236,29.18780708
229,"OCEAN CITY NJ",9,1,0,0,1,1,-74.57369232,39.2779808
229,"OCEAN SPRINGS MS",9,3,1,1,1,3,-88.82833862,30.41417313
229,"OCEANSIDE CA",9,43,7,13,23,43,-117.3814011,33.19587326
229,"OCOEE FL",9,1,0,1,0,1,-81.54336548,28.56987
229,"ODESSA MO",9,1,0,1,0,1,-93.95418549,38.99940491
229,"ODESSA TX",9,3,0,1,2,3,-102.3682938,31.84587097
229,"OGALLALA NE",9,1,0,0,1,1,-101.7200775,41.1279068
229,"OGDEN UT",9,30,6,9,15,30,-111.9730225,41.22582626
229,"OHIO IL",9,4,0,0,4,4,-89.46100616,41.55773544
229,"OKEECHOBEE FL",9,2,0,1,1,2,-80.82913971,27.24450302
229,"OKLAHOMA CITY OK",9,95,25,30,40,95,-97.51699829,35.46761322
229,"OLATHE KS",9,17,6,4,7,17,-94.81970215,38.88142395
229,"OLD BRIDGE NJ",9,1,0,0,1,1,-74.36474609,40.41495895
229,"OLD ORCHARD BEACH ME",9,1,0,0,1,1,-70.37640381,43.51769257
229,"OLD SAYBROOK CT",9,1,0,0,1,1,-72.37509918,41.29185104
229,"OLEAN NY",9,17,3,6,8,17,-78.42921448,42.07747269
229,"OLIVE BRANCH MS",9,3,0,0,3,3,-89.82355499,34.96377563
229,"OLYMPIA FIELDS IL",9,2,0,1,1,2,-87.67446899,41.51344299
229,"OLYMPIA WA",9,53,19,8,26,53,-122.8909378,47.04053497
229,"OMAHA NE",9,98,23,24,51,98,-95.93825531,41.25878906
229,"ONEONTA NY",9,3,2,1,0,3,-75.0631485,42.45296097
229,"ONTARIO CA",9,10,1,3,6,10,-117.6528702,34.06340408
229,"OOSTBURG WI",9,1,0,0,1,1,-87.79463959,43.62262726
229,"OPELIKA AL",9,2,0,1,1,2,-85.3780365,32.64568329
229,"OPELOUSAS LA",9,4,1,0,3,4,-92.08177948,30.53403282
229,"ORANGE CA",9,17,4,7,6,17,-117.8544846,33.7877388
229,"ORANGE CITY IA",9,6,3,0,3,6,-96.05925751,43.00707626
229,"ORANGE PARK FL",9,4,0,2,2,4,-81.70614624,30.16655731
229,"ORANGEBURG SC",9,3,0,1,2,3,-80.86129761,33.48974228
229,"OREGON CITY OR",9,2,0,1,1,2,-122.6096726,45.35689163
229,"OREM UT",9,1,0,0,1,1,-111.6960449,40.29695892
229,"ORLAND PARK IL",9,2,1,1,0,2,-87.85391235,41.63027573
229,"ORLANDO FL",9,436,112,114,210,436,-81.3789978,28.53886795
229,"ORMOND BEACH FL",9,41,15,9,17,41,-81.05541992,29.28623772
229,"OSCEOLA MILLS PA",9,1,0,0,1,1,-78.27013397,40.85004807
229,"OSHKOSH WI",9,3,1,0,2,3,-88.54268646,44.02453613
229,"OSSINING NY",9,5,2,1,2,5,-73.86093903,41.16327286
229,"OSWEGO IL",9,2,1,0,1,2,-88.3513031,41.68288422
229,"OTTAWA IL",9,1,0,0,1,1,-88.8425827,41.34545898
229,"OTTAWA OH",9,1,0,1,0,1,-84.04722595,41.01917267
229,"OTTUMWA IA",9,2,0,1,1,2,-92.41059113,41.01459122
229,"OVERLAND PARK KS",9,35,4,12,19,35,-94.67124939,38.98216248
229,"OVIEDO FL",9,4,2,1,1,4,-81.20778656,28.67054749
229,"OWASSO OK",9,1,1,0,0,1,-95.85546875,36.26954651
229,"OWATONNA MN",9,4,2,0,2,4,-93.22633362,44.08358383
229,"OWEGO NY",9,1,0,0,1,1,-76.26147461,42.1034317
229,"OWENSBORO KY",9,8,1,1,6,8,-87.11345673,37.77421188
229,"OXFORD MI",9,8,1,2,5,8,-83.26428986,42.82481766
229,"OXFORD MS",9,43,12,13,18,43,-89.52319336,34.37203979
229,"OXFORD OH",9,3,0,2,1,3,-84.74536133,39.50694275
229,"OXNARD CA",9,18,5,4,9,18,-119.1790085,34.19766998
229,"OZARK MO",9,3,2,1,0,3,-93.20661163,37.02112198
229,"PACIFIC WA",9,1,0,0,1,1,-122.2527084,47.26421356
229,"PACIFICA CA",9,1,1,0,0,1,-122.4893951,37.61383438
229,"PADUCAH KY",9,35,7,7,21,35,-88.60009766,37.08333206
229,"PAHOKEE FL",9,2,1,0,1,2,-80.66488647,26.82079887
229,"PAINTSVILLE KY",9,2,1,1,0,2,-82.80673218,37.8147049
229,"PALATINE IL",9,3,2,0,1,3,-88.03440857,42.11017609
229,"PALESTINE TX",9,1,1,0,0,1,-95.6313324,31.76263046
229,"PALM BAY FL",9,3,2,0,1,3,-80.58313751,28.03806496
229,"PALM BEACH FL",9,19,3,5,11,19,-80.03616333,26.70643616
229,"PALM BEACH GARDENS FL",9,2,0,1,1,2,-80.07454681,26.8109169
229,"PALM DESERT CA",9,7,2,1,4,7,-116.3907166,33.72164154
229,"PALM SPRINGS CA",9,71,19,20,32,71,-116.5467758,33.83036423
229,"PALM SPRINGS FL",9,1,0,1,0,1,-80.09664154,26.63662338
229,"PALMDALE CA",9,6,1,0,5,6,-118.118454,34.57925034
229,"PALMER AK",9,6,1,0,5,6,-149.1138458,61.59459305
229,"PALMETTO FL",9,2,0,2,0,2,-82.57216644,27.52223396
229,"PALO ALTO CA",9,21,4,9,8,21,-122.1449661,37.44177628
229,"PALOS HILLS IL",9,1,1,0,0,1,-87.81729889,41.6969986
229,"PANAMA CITY BEACH FL",9,3,2,0,1,3,-85.80211639,30.1792717
229,"PANAMA CITY FL",9,9,1,3,5,9,-85.65970612,30.16412926
229,"PAPILLION NE",9,2,1,1,0,2,-96.04257202,41.15442276
229,"PARAGOULD AR",9,2,1,0,1,2,-90.5002594,36.05854034
229,"PARAMOUNT CA",9,1,0,0,1,1,-118.161644,33.88947678
229,"PARIS IL",9,29,8,2,19,29,-87.69623566,39.61117172
229,"PARIS KY",9,1,0,0,1,1,-84.25283051,38.21011353
229,"PARIS TN",9,1,0,0,1,1,-88.3266983,36.30187225
229,"PARIS TX",9,11,4,5,2,11,-95.55589294,33.66113663
229,"PARK CITY UT",9,35,13,8,14,35,-111.5018539,40.65143204
229,"PARKER CO",9,1,1,0,0,1,-104.7624359,39.51849365
229,"PARKERSBURG WV",9,10,1,4,5,10,-81.54850006,39.28261948
229,"PARKVILLE MO",9,1,0,0,1,1,-94.68252563,39.19501114
229,"PARLIER CA",9,1,0,0,1,1,-119.5286789,36.61136627
229,"PARMA OH",9,5,3,1,1,5,-81.72257996,41.40510178
229,"PASADENA CA",9,82,34,18,30,82,-118.1466675,34.14794922
229,"PASADENA TX",9,8,1,2,5,8,-95.20979309,29.69150162
229,"PASCAGOULA MS",9,2,0,1,1,2,-88.55257416,30.36789703
229,"PASCO WA",9,1,1,0,0,1,-119.1023636,46.2282753
229,"PATCHOGUE NY",9,1,0,0,1,1,-73.01426697,40.76568985
229,"PATERSON NJ",9,155,36,41,78,155,-74.17102051,40.91714478
229,"PATTEN ME",9,7,1,0,6,7,-68.45036316,45.99417496
229,"PAULSBORO NJ",9,1,1,0,0,1,-75.23970032,39.83067322
229,"PAVILION NY",9,2,0,0,2,2,-78.02204895,42.87609482
229,"PAYETTE ID",9,1,0,0,1,1,-116.9361572,44.07813263
229,"PAYNE OH",9,1,0,0,1,1,-84.72699738,41.07762909
229,"PAYSON UT",9,1,1,0,0,1,-111.7331848,40.04447937
229,"PEABODY MA",9,2,1,0,1,2,-70.92794037,42.52825928
229,"PEARLAND TX",9,7,2,1,4,7,-95.28644562,29.56411743
229,"PECULIAR MO",9,1,1,0,0,1,-94.4588623,38.71911621
229,"PELL CITY AL",9,1,0,0,1,1,-86.28610992,33.58621597
229,"PEMBROKE NC",9,2,1,0,1,2,-79.19446564,34.68062592
229,"PEMBROKE PINES FL",9,6,2,0,4,6,-80.22357941,26.00384903
229,"PENDER NE",9,1,1,0,0,1,-96.70800018,42.1140213
229,"PENDLETON IN",9,1,0,0,1,1,-85.74658203,39.99742126
229,"PENDLETON SC",9,12,2,5,5,12,-82.78354645,34.65194321
229,"PENN HILLS PA",9,1,0,1,0,1,-79.85767365,40.46170044
229,"PENSACOLA FL",9,50,17,12,21,50,-87.21669006,30.42154694
229,"PEORIA AZ",9,13,4,3,6,13,-112.2390747,33.58084106
229,"PEORIA IL",9,19,4,2,13,19,-89.59487152,40.70241928
229,"PERRIS CA",9,3,1,0,2,3,-117.2306519,33.78261948
229,"PERRYSBURG OH",9,12,4,3,5,12,-83.62700653,41.55728531
229,"PERRYVILLE MO",9,9,1,1,7,9,-89.86131287,37.72448349
229,"PERTH AMBOY NJ",9,26,7,4,15,26,-74.26480103,40.5068779
229,"PETALUMA CA",9,3,1,1,1,3,-122.6394272,38.23221207
229,"PETOSKEY MI",9,1,0,0,1,1,-84.95549774,45.37327576
229,"PHENIX CITY AL",9,2,1,0,1,2,-85.00059509,32.4714241
229,"PHILADELPHIA NY",9,1,1,0,0,1,-75.70793915,44.15469742
229,"PHILADELPHIA PA",9,1130,353,244,533,1130,-75.16322327,39.95243835
229,"PHILADELPHIA TN",9,2,0,1,1,2,-84.40354156,35.67960358
229,"PHOENIX AZ",9,375,83,88,204,375,-112.0752716,33.44825363
229,"PHOENIXVILLE PA",9,12,3,2,7,12,-75.51416779,40.13076401
229,"PICAYUNE MS",9,4,2,1,1,4,-89.67980194,30.52602005
229,"PICO RIVERA CA",9,2,1,0,1,2,-118.0985489,33.983284
229,"PIKEVILLE NC",9,2,1,0,1,2,-77.98130035,35.49745941
229,"PINE BLUFF AR",9,5,0,2,3,5,-92.00374603,34.22846222
229,"PINE CITY MN",9,1,0,0,1,1,-92.96896362,45.82616043
229,"PINEHURST NC",9,1,0,0,1,1,-79.46926117,35.19573975
229,"PINELLAS PARK FL",9,1,0,1,0,1,-82.69934845,27.84342194
229,"PINEVILLE LA",9,2,2,0,0,2,-92.43460083,31.32294083
229,"PISCATAWAY NJ",9,5,2,1,2,5,-74.3984375,40.49933243
229,"PISMO BEACH CA",9,15,5,2,8,15,-120.6432953,35.1427269
229,"PITTSBORO NC",9,2,0,0,2,2,-79.17662811,35.72052002
229,"PITTSBURG CA",9,8,3,0,5,8,-121.8871613,38.02787781
229,"PITTSBURG KS",9,2,0,0,2,2,-94.70526123,37.41111374
229,"PITTSBURGH PA",9,427,116,109,202,427,-79.99537659,40.44091415
229,"PITTSFIELD MA",9,6,1,1,4,6,-73.24451447,42.45004272
229,"PLACERVILLE CA",9,35,8,13,14,35,-120.8002701,38.72951508
229,"PLAINFIELD IL",9,5,1,2,2,5,-88.20417786,41.62700653
229,"PLAINFIELD NJ",9,1,0,0,1,1,-74.40673065,40.63404083
229,"PLANO IL",9,2,0,2,0,2,-88.5372467,41.66307449
229,"PLANO TX",9,72,16,22,34,72,-96.69931793,33.01993942
229,"PLANT CITY FL",9,1,1,0,0,1,-82.11231232,28.01914597
229,"PLANTATION FL",9,4,1,1,2,4,-80.23281097,26.12825966
229,"PLAQUEMINE LA",9,5,1,1,3,5,-91.23427582,30.28962708
229,"PLATTE CITY MO",9,1,0,0,1,1,-94.78305054,39.37047958
229,"PLATTSBURGH NY",9,1,0,0,1,1,-73.45239258,44.69951248
229,"PLEASANT HILL CA",9,1,0,0,1,1,-122.0632401,37.94770813
229,"PLEASANTVILLE NJ",9,2,1,0,1,2,-74.52319336,39.3899765
229,"PLUM PA",9,1,0,0,1,1,-79.78238678,40.48848724
229,"PLYMOUTH MA",9,14,2,7,5,14,-70.67458344,41.95769882
229,"PLYMOUTH MN",9,2,0,1,1,2,-93.45163727,45.02838898
229,"POCATELLO ID",9,7,4,1,2,7,-112.4475937,42.87098694
229,"POMONA CA",9,19,4,2,13,19,-117.7534485,34.05541611
229,"POMPANO BEACH FL",9,2,0,0,2,2,-80.12407684,26.23855591
229,"PONTIAC MI",9,6,1,2,3,6,-83.29104614,42.63900757
229,"PONTOON BEACH IL",9,1,0,0,1,1,-90.08075714,38.7317276
229,"PONTOTOC MS",9,1,0,1,0,1,-88.99865723,34.24829102
229,"POOLER GA",9,1,1,0,0,1,-81.24672699,32.11583328
229,"POPLAR BLUFF MO",9,9,5,2,2,9,-90.3928833,36.75717545
229,"PORT ANGELES WA",9,6,4,0,2,6,-123.4329224,48.11795044
229,"PORT ARTHUR TX",9,27,13,1,13,27,-93.93045807,29.90067863
229,"PORT CHESTER NY",9,1,0,1,0,1,-73.66493225,41.00179291
229,"PORT HURON MI",9,4,1,1,2,4,-82.42453766,42.97105026
229,"PORT ORANGE FL",9,5,2,2,1,5,-81.00856781,29.13491631
229,"PORT ORFORD OR",9,12,4,4,4,12,-124.4993668,42.74531555
229,"PORTAGE MI",9,1,1,0,0,1,-85.57974243,42.20133972
229,"PORTAGE WI",9,4,3,1,0,4,-89.46311188,43.53891754
229,"PORTER OK",9,2,0,0,2,2,-95.5231781,35.87133026
229,"PORTERVILLE CA",9,4,1,1,2,4,-119.0190811,36.06521988
229,"PORTLAND IN",9,1,0,0,1,1,-84.97788239,40.43445969
229,"PORTLAND ME",9,30,10,6,14,30,-70.25403595,43.6618576
229,"PORTLAND OR",9,1329,355,371,603,1329,-122.6786423,45.52309418
229,"PORTLAND TX",9,1,1,0,0,1,-97.32419586,27.87795258
229,"PORTSMOUTH NH",9,12,2,7,3,12,-70.76164246,43.07198334
229,"PORTSMOUTH VA",9,8,2,2,4,8,-76.29769135,36.83554077
229,"POTEAU OK",9,1,0,1,0,1,-94.623703,35.05377197
229,"POTSDAM NY",9,1,1,0,0,1,-74.98085785,44.66995239
229,"POTTSTOWN PA",9,1,1,0,0,1,-75.64894867,40.24571609
229,"POTTSVILLE PA",9,2,1,1,0,2,-76.19465637,40.68566513
229,"POUGHKEEPSIE NY",9,10,4,3,3,10,-73.92034149,41.70055771
229,"POULSBO WA",9,1,0,0,1,1,-122.648819,47.73558426
229,"POUND VA",9,1,1,0,0,1,-82.60127258,37.12379837
229,"PRAIRIE VIEW TX",9,1,1,0,0,1,-95.9883194,30.09370232
229,"PRAIRIE VILLAGE KS",9,5,1,2,2,5,-94.63400269,38.99189377
229,"PRESCOTT AZ",9,1,0,0,1,1,-112.4702301,34.54008102
229,"PRINCETON MN",9,1,0,0,1,1,-93.58203888,45.56974411
229,"PRINCETON NJ",9,26,9,6,11,26,-74.65805817,40.34872055
229,"PRINEVILLE OR",9,1,0,0,1,1,-120.8366928,44.29957581
229,"PROSPER TX",9,5,1,0,4,5,-96.80168915,33.23641205
229,"PROVIDENCE RI",9,120,30,23,67,120,-71.40118408,41.82990265
229,"PROVINCETOWN MA",9,210,62,41,107,210,-70.17770386,42.05849075
229,"PROVO UT",9,7,2,2,3,7,-111.6589813,40.23337936
229,"PUEBLO CO",9,51,14,16,21,51,-104.6108551,38.25450516
229,"PULLMAN WA",9,153,43,38,72,153,-117.180481,46.73068619
229,"PUNTA GORDA FL",9,1,0,1,0,1,-82.04517365,26.93050766
229,"PUNXSUTAWNEY PA",9,1,0,1,0,1,-78.97320557,40.94323349
229,"PURCELLVILLE VA",9,1,0,0,1,1,-77.71422577,39.13694763
229,"PUYALLUP WA",9,12,1,1,10,12,-122.2927628,47.19064331
229,"QUAPAW OK",9,3,1,0,2,3,-94.7911377,36.95119095
229,"QUEEN CREEK AZ",9,17,2,7,8,17,-111.6382294,33.25391769
229,"QUINCY IL",9,8,2,0,6,8,-91.41021729,39.9356575
229,"QUINCY MA",9,2,0,1,1,2,-71.00706482,42.24961472
229,"RACINE WI",9,15,7,4,4,15,-87.78296661,42.72628021
229,"RADFORD VA",9,2,0,1,1,2,-80.57588196,37.13208389
229,"RALEIGH NC",9,264,83,65,116,264,-78.63800049,35.77230835
229,"RAMSEY MN",9,2,1,0,1,2,-93.41651154,45.24803162
229,"RANCHO CORDOVA CA",9,11,3,0,8,11,-121.3053742,38.58900452
229,"RANCHO MIRAGE CA",9,2,2,0,0,2,-116.4143066,33.73956299
229,"RANCHO PALOS VERDES CA",9,1,1,0,0,1,-118.388916,33.74456406
229,"RANGER GA",9,1,0,1,0,1,-84.71112823,34.50128555
229,"RAPID CITY SD",9,10,3,2,5,10,-103.2325821,44.08078766
229,"RAVENNA OH",9,1,0,0,1,1,-81.24195099,41.15758896
229,"RAYTOWN MO",9,8,4,0,4,8,-94.46369934,39.00871277
229,"READING PA",9,13,3,4,6,13,-75.9259491,40.33562851
229,"RED LION PA",9,1,0,1,0,1,-76.60523987,39.9010849
229,"RED WING MN",9,1,0,0,1,1,-92.53401184,44.56221771
229,"REDDING CA",9,5,3,1,1,5,-122.3944626,40.58649826
229,"REDLANDS CA",9,5,0,2,3,5,-117.21064,34.0318718
229,"REDMOND WA",9,24,8,4,12,24,-122.1240006,47.67367172
229,"REDONDO BEACH CA",9,34,7,9,18,34,-118.3907471,33.84916687
229,"REDWOOD CITY CA",9,11,2,3,6,11,-122.2364655,37.48601151
229,"REEDLEY CA",9,1,0,1,0,1,-119.4518738,36.59639359
229,"REHOBOTH BEACH DE",9,1,0,0,1,1,-75.0807724,38.71229172
229,"RENO NV",9,146,40,35,71,146,-119.8160934,39.5294838
229,"RENTON WA",9,8,4,1,3,8,-122.2197342,47.48252487
229,"REVERE MA",9,2,1,1,0,2,-71.01091003,42.40863037
229,"REXBURG ID",9,1,0,0,1,1,-111.7915344,43.82584763
229,"RICE LAKE WI",9,1,0,1,0,1,-91.73868561,45.5060463
229,"RICHARDSON TX",9,1,1,0,0,1,-96.73020172,32.94840622
229,"RICHFIELD MN",9,1,0,0,1,1,-93.28303528,44.87028503
229,"RICHLAND MS",9,1,0,0,1,1,-90.16493225,32.22668076
229,"RICHLAND WA",9,1,0,0,1,1,-119.2866592,46.28547287
229,"RICHMOND CA",9,24,6,4,14,24,-122.3500443,37.9354744
229,"RICHMOND HEIGHTS MO",9,14,3,3,8,14,-90.31951904,38.62892532
229,"RICHMOND HEIGHTS OH",9,1,1,0,0,1,-81.50981903,41.55295944
229,"RICHMOND IN",9,3,1,1,1,3,-84.8900528,39.82888412
229,"RICHMOND KY",9,2,0,0,2,2,-84.29437256,37.74818802
229,"RICHMOND TX",9,4,0,0,4,4,-95.76106262,29.58276558
229,"RICHMOND VA",9,207,52,50,105,207,-77.45962524,37.55412674
229,"RICHTON PARK IL",9,1,0,0,1,1,-87.70342255,41.48434448
229,"RIDGEFIELD NJ",9,2,0,1,1,2,-74.00799561,40.8345108
229,"RIDGELAND MS",9,4,0,0,4,4,-90.13221741,32.42857742
229,"RIDGEWOOD NJ",9,2,0,1,1,2,-74.11595917,40.97959518
229,"RINGGOLD GA",9,1,0,0,1,1,-85.10852051,34.9195137
229,"RINGWOOD NJ",9,1,0,1,0,1,-74.24452209,41.11375046
229,"RIO RANCHO NM",9,3,0,1,2,3,-106.6682816,35.23852539
229,"RIPON WI",9,1,0,0,1,1,-88.83634186,43.8422966
229,"RIVER GROVE IL",9,1,0,0,1,1,-87.83586884,41.92609787
229,"RIVERDALE GA",9,1,1,0,0,1,-84.4131012,33.57296371
229,"RIVERHEAD NY",9,1,1,0,0,1,-72.66098785,40.91713333
229,"RIVERSIDE CA",9,97,16,26,55,97,-117.3973999,33.95311737
229,"RIVERTON UT",9,1,0,1,0,1,-111.940033,40.52087402
229,"ROANOKE VA",9,13,3,3,7,13,-79.94111633,37.27119827
229,"ROBINSON IL",9,15,4,3,8,15,-87.73912048,39.00521469
229,"ROBINSON TX",9,2,2,0,0,2,-97.11503601,31.46778679
229,"ROCHESTER MI",9,1,0,0,1,1,-83.13374329,42.68050766
229,"ROCHESTER MN",9,20,4,2,14,20,-92.47042084,44.02156448
229,"ROCHESTER NH",9,5,0,0,5,5,-70.97436523,43.30452728
229,"ROCHESTER NY",9,206,63,46,97,206,-77.61522675,43.15487671
229,"ROCK HILL SC",9,17,8,3,6,17,-81.02463531,34.92498779
229,"ROCK ISLAND IL",9,2,0,0,2,2,-90.5790329,41.50963593
229,"ROCKFORD IL",9,10,2,3,5,10,-89.09428406,42.27135086
229,"ROCKPORT MA",9,3,1,0,2,3,-70.61954498,42.65607071
229,"ROCKVILLE MD",9,3,0,0,3,3,-77.15235901,39.08402252
229,"ROCKWALL TX",9,12,3,2,7,12,-96.46016693,32.93169022
229,"ROCKY HILL CT",9,1,0,1,0,1,-72.64056396,41.66537857
229,"ROCKY MOUNT NC",9,4,0,2,2,4,-77.78997803,35.93837738
229,"ROCKY RIVER OH",9,3,0,2,1,3,-81.83889008,41.4756279
229,"ROGERS AR",9,7,3,0,4,7,-94.11903381,36.33228683
229,"ROLLA MO",9,3,2,1,0,3,-91.77151489,37.95161438
229,"ROMEOVILLE IL",9,5,3,0,2,5,-88.08948517,41.64759064
229,"ROSCOE IL",9,1,0,0,1,1,-89.00959778,42.41326523
229,"ROSE BUD AR",9,1,0,0,1,1,-92.08159637,35.33152771
229,"ROSEBURG OR",9,3,1,1,1,3,-123.3444519,43.21644974
229,"ROSENBERG TX",9,1,0,0,1,1,-95.80905914,29.5575695
229,"ROSEVILLE CA",9,4,1,2,1,4,-121.2899246,38.75195694
229,"ROSEVILLE MN",9,12,4,3,5,12,-93.14508057,45.02290726
229,"ROSSVILLE GA",9,1,0,1,0,1,-85.2930069,34.97555542
229,"ROSWELL GA",9,7,6,1,0,7,-84.36141205,34.02328491
229,"ROUND ROCK TX",9,14,2,6,6,14,-97.67939758,30.50861359
229,"ROXBORO NC",9,1,0,1,0,1,-78.98235321,36.3940506
229,"ROYAL OAK MI",9,1,0,0,1,1,-83.1442337,42.48933792
229,"ROYERSFORD PA",9,1,0,0,1,1,-75.53735352,40.18464279
229,"RUMSON NJ",9,6,1,1,4,6,-73.99851227,40.37051773
229,"RUSSELLVILLE AR",9,5,1,2,2,5,-93.1343689,35.27845383
229,"RUSSELLVILLE KY",9,1,0,0,1,1,-86.88699341,36.84527588
229,"RUSTON LA",9,1,1,0,0,1,-92.63848877,32.52357101
229,"RUTHERFORD NJ",9,1,0,1,0,1,-74.10585022,40.82668304
229,"RUTLAND VT",9,2,1,0,1,2,-72.97142029,43.61096954
229,"RYE CO",9,7,2,3,2,7,-104.9316177,37.92366791
229,"SABETHA KS",9,1,0,0,1,1,-95.80158234,39.90206146
229,"SACKETS HARBOR NY",9,1,0,1,0,1,-76.12520599,43.94608688
229,"SACRAMENTO CA",9,341,77,66,198,341,-121.4959793,38.58154297
229,"SADDLE BROOK NJ",9,3,0,2,1,3,-74.09207153,40.89922333
229,"SAGINAW MI",9,9,3,3,3,9,-83.95076752,43.41968918
229,"SAHUARITA AZ",9,16,4,5,7,16,-110.9567032,31.95795059
229,"SALADO TX",9,1,1,0,0,1,-97.53890228,30.94765282
229,"SALEM IL",9,8,2,4,2,8,-88.94590759,38.62715149
229,"SALEM MA",9,7,0,1,6,7,-70.89565277,42.51993179
229,"SALEM NH",9,4,1,3,0,4,-71.19998169,42.78861618
229,"SALEM OH",9,1,1,0,0,1,-80.85612488,40.90091705
229,"SALEM OR",9,61,14,14,33,61,-123.0377197,44.94248199
229,"SALEM VA",9,1,0,0,1,1,-80.05405426,37.29384232
229,"SALINA KS",9,5,0,2,3,5,-97.61184692,38.84041977
229,"SALINAS CA",9,83,18,23,42,83,-121.6571732,36.67780304
229,"SALISBURY MD",9,13,4,2,7,13,-75.5984726,38.36100388
229,"SALISBURY NC",9,2,0,1,1,2,-80.47377014,35.67113495
229,"SALT LAKE CITY UT",9,91,29,25,37,91,-111.8912659,40.77029037
229,"SAN ANGELO TX",9,2,1,0,1,2,-100.4379044,31.46401215
229,"SAN ANSELMO CA",9,3,0,1,2,3,-122.5641785,37.97429276
229,"SAN ANTONIO TX",9,423,104,112,207,423,-98.49394989,29.42439651
229,"SAN BERNARDINO CA",9,14,3,4,7,14,-117.304596,34.12142563
229,"SAN CARLOS CA",9,1,0,0,1,1,-122.262207,37.50718307
229,"SAN CLEMENTE CA",9,2,0,2,0,2,-117.6134033,33.42698669
229,"SAN DIEGO CA",9,590,158,141,291,590,-117.1587296,32.71524429
229,"SAN DIMAS CA",9,1,0,1,0,1,-117.8088913,34.10668945
229,"SAN FERNANDO CA",9,1,1,0,0,1,-118.4407349,34.28187561
229,"SAN FRANCISCO CA",9,865,249,209,407,865,-122.4213257,37.77465057
229,"SAN GABRIEL CA",9,1,0,0,1,1,-118.107605,34.09612274
229,"SAN JOSE CA",9,148,38,35,75,148,-121.8973846,37.33491516
229,"SAN JUAN CAPISTRANO CA",9,1,0,1,0,1,-117.6644516,33.50197601
229,"SAN LEANDRO CA",9,15,0,15,0,15,-122.155983,37.70180511
229,"SAN LUIS OBISPO CA",9,13,0,6,7,13,-120.6622849,35.28281021
229,"SAN MARCOS CA",9,1,1,0,0,1,-117.1673966,33.14345551
229,"SAN MARCOS TX",9,28,5,8,15,28,-97.94176483,29.88363266
229,"SAN MATEO CA",9,25,3,6,16,25,-122.3270264,37.56283569
229,"SAN PABLO CA",9,1,0,0,1,1,-122.3469696,37.96184921
229,"SAN RAFAEL CA",9,10,1,1,8,10,-122.5331726,37.97325134
229,"SAN RAMON CA",9,3,1,0,2,3,-121.9799347,37.77985764
229,"SANDUSKY OH",9,1,1,0,0,1,-82.7080307,41.44903183
229,"SANDY OR",9,18,6,4,8,18,-122.263649,45.39704132
229,"SANDY SPRINGS GA",9,3,0,1,2,3,-84.37850952,33.92443848
229,"SANFORD FL",9,27,6,6,15,27,-81.27256012,28.80128288
229,"SANGER CA",9,2,1,1,0,2,-119.5580063,36.70794296
229,"SANTA ANA CA",9,8,4,2,2,8,-117.8697281,33.74567413
229,"SANTA BARBARA CA",9,45,11,6,28,45,-119.7056656,34.4233017
229,"SANTA CLARA CA",9,12,4,3,5,12,-121.946434,37.34754181
229,"SANTA CRUZ CA",9,45,13,12,20,45,-122.0333557,36.97389984
229,"SANTA FE NM",9,41,14,10,17,41,-105.9468155,35.68014526
229,"SANTA MARIA CA",9,2,0,1,1,2,-120.437973,34.95292664
229,"SANTA MONICA CA",9,90,20,28,42,90,-118.4925232,34.01921082
229,"SANTA PAULA CA",9,1,0,0,1,1,-119.0609283,34.35404587
229,"SANTA ROSA CA",9,105,28,28,49,105,-122.7165146,38.44017792
229,"SAPULPA OK",9,1,0,0,1,1,-96.11476135,35.99878311
229,"SARASOTA FL",9,29,4,11,14,29,-82.53031158,27.33688736
229,"SARATOGA SPRINGS NY",9,3,1,0,2,3,-73.78382111,43.08345032
229,"SARATOGA WY",9,2,1,0,1,2,-106.807579,41.45475769
229,"SATELLITE BEACH FL",9,1,1,0,0,1,-80.58939362,28.17677498
229,"SATSUMA AL",9,1,1,0,0,1,-88.05622101,30.85362816
229,"SAUK RAPIDS MN",9,2,0,1,1,2,-94.16661835,45.59189987
229,"SAUKVILLE WI",9,1,0,1,0,1,-87.94111633,43.38184738
229,"SAUSALITO CA",9,4,2,1,1,4,-122.4881592,37.85736847
229,"SAVANNAH GA",9,117,23,24,70,117,-81.09463501,32.07280731
229,"SCARSDALE NY",9,5,1,1,3,5,-73.78360748,41.00525665
229,"SCHENECTADY NY",9,5,3,0,2,5,-73.938591,42.81433487
229,"SCHUYLKILL HAVEN PA",9,1,1,0,0,1,-76.17021942,40.63098145
229,"SCOTTSDALE AZ",9,46,19,8,19,46,-111.9002533,33.50918579
229,"SCRANTON PA",9,17,3,4,10,17,-75.66184998,41.40919113
229,"SEAFORD DE",9,1,1,0,0,1,-75.61972809,38.64723206
229,"SEARCY AR",9,2,0,1,1,2,-91.73634338,35.25092697
229,"SEATTLE WA",9,1338,360,332,646,1338,-122.3343964,47.60571289
229,"SEBRING FL",9,3,0,1,2,3,-81.4406662,27.49625397
229,"SECAUCUS NJ",9,1,0,1,0,1,-74.05567169,40.78977585
229,"SEDALIA MO",9,4,2,1,1,4,-93.22884369,38.70438766
229,"SEDONA AZ",9,20,5,4,11,20,-111.7623367,34.86959839
229,"SEGUIN TX",9,4,3,0,1,4,-97.96529388,29.56933594
229,"SELMA AL",9,1,1,0,0,1,-87.02119446,32.40768433
229,"SELMA CA",9,1,0,0,1,1,-119.6140518,36.57050323
229,"SEMINOLE FL",9,1,1,0,0,1,-82.79083252,27.84035683
229,"SENECA MO",9,1,0,0,1,1,-94.61161804,36.8415184
229,"SENECA SC",9,3,0,0,3,3,-82.95318604,34.68600845
229,"SEQUIM WA",9,4,1,2,1,4,-123.1045303,48.07928085
229,"SEVIERVILLE TN",9,1,0,1,0,1,-83.56149292,35.86820984
229,"SHAKER HEIGHTS OH",9,57,14,15,28,57,-81.53669739,41.47419357
229,"SHAKOPEE MN",9,7,0,4,3,7,-93.52770233,44.79788971
229,"SHARON MA",9,1,1,0,0,1,-71.17311096,42.12431335
229,"SHAWNEE KS",9,29,9,5,15,29,-94.7208786,39.0417366
229,"SHAWNEE OK",9,1,0,0,1,1,-96.92608643,35.32754898
229,"SHEBOYGAN WI",9,91,20,31,40,91,-87.71476746,43.75089264
229,"SHELBYVILLE TN",9,1,0,0,1,1,-86.46025848,35.4834137
229,"SHELDON IA",9,20,4,6,10,20,-95.8535614,43.18698502
229,"SHERMAN NY",9,1,0,0,1,1,-79.59461212,42.15943146
229,"SHERMAN TX",9,4,1,1,2,4,-96.60933685,33.63597488
229,"SHERWOOD AR",9,1,0,0,1,1,-92.22438049,34.81515884
229,"SHIPPENSBURG PA",9,1,0,0,1,1,-77.51955414,40.05068207
229,"SHOREVIEW MN",9,1,1,0,0,1,-93.1241684,45.06987762
229,"SHREVEPORT LA",9,60,18,10,32,60,-93.7507019,32.52565002
229,"SIDNEY OH",9,2,1,1,0,2,-84.15549469,40.28426743
229,"SIERRA MADRE CA",9,4,1,0,3,4,-118.0547943,34.16183853
229,"SIERRA VISTA AZ",9,1,0,0,1,1,-110.3048325,31.55449295
229,"SIKESTON MO",9,2,2,0,0,2,-89.5878067,36.87693024
229,"SILAS AL",9,1,0,0,1,1,-88.32923126,31.76582909
229,"SILOAM SPRINGS AR",9,4,2,0,2,4,-94.54097748,36.18841934
229,"SILVERTON OR",9,3,2,0,1,3,-122.7857742,45.00499725
229,"SIMI VALLEY CA",9,3,1,1,1,3,-118.7839508,34.26951981
229,"SIMPSONVILLE SC",9,1,1,0,0,1,-82.25405121,34.73744202
229,"SIMSBORO LA",9,1,1,0,0,1,-92.78874969,32.534729
229,"SIOUX CENTER IA",9,2,1,0,1,2,-96.17614746,43.0798111
229,"SIOUX CITY IA",9,1,0,0,1,1,-96.40085602,42.5001564
229,"SIOUX FALLS SD",9,13,1,2,10,13,-96.73429108,43.54177475
229,"SKOKIE IL",9,3,1,0,2,3,-87.73321533,42.03328705
229,"SLIDELL LA",9,16,3,2,11,16,-89.78143311,30.27558708
229,"SMYRNA GA",9,10,5,1,4,10,-84.51447296,33.88409042
229,"SNOHOMISH WA",9,1,0,0,1,1,-122.1009903,47.91241837
229,"SOCIAL CIRCLE GA",9,6,1,1,4,6,-83.71785736,33.65628433
229,"SOLEDAD CA",9,1,0,1,0,1,-121.3278732,36.42473984
229,"SOLON OH",9,1,0,0,1,1,-81.44110107,41.3899231
229,"SOMERS WI",9,1,1,0,0,1,-87.9103775,42.64015579
229,"SOMERVILLE MA",9,28,13,5,10,28,-71.09860992,42.38757324
229,"SONOMA CA",9,1,0,1,0,1,-122.4600754,38.29153061
229,"SONORA CA",9,19,4,6,9,19,-120.3842011,37.98400497
229,"SOUDERTON PA",9,3,1,2,0,3,-75.32456207,40.31177902
229,"SOUTH BELOIT IL",9,1,0,0,1,1,-89.03701782,42.49333191
229,"SOUTH BEND IN",9,116,33,31,52,116,-86.25171661,41.67295837
229,"SOUTH CHARLESTON WV",9,1,0,0,1,1,-81.69944763,38.36863708
229,"SOUTH LAKE TAHOE CA",9,15,3,3,9,15,-119.972786,38.94574356
229,"SOUTH LYON MI",9,4,1,1,2,4,-83.65129089,42.46051788
229,"SOUTH PLAINFIELD NJ",9,3,1,1,1,3,-74.41103363,40.57961655
229,"SOUTH PORTLAND ME",9,6,4,0,2,6,-70.23975372,43.6415062
229,"SOUTH SAN FRANCISCO CA",9,2,1,1,0,2,-122.4101868,37.65430069
229,"SOUTHAMPTON NY",9,8,1,0,7,8,-72.38861084,40.88444519
229,"SOUTHAVEN MS",9,1,0,0,1,1,-90.02496338,34.99386215
229,"SOUTHFIELD MI",9,1,0,0,1,1,-83.22153473,42.47357559
229,"SOUTHGATE MI",9,1,1,0,0,1,-83.19342804,42.2142067
229,"SOUTHINGTON CT",9,4,0,2,2,4,-72.8768158,41.59680557
229,"SOUTHLAKE TX",9,1,0,0,1,1,-97.13466644,32.94153214
229,"SOUTHWEST PA",9,1,1,0,0,1,-79.52024078,40.19903183
229,"SPARKS NV",9,7,1,3,3,7,-119.7548142,39.53468704
229,"SPARTANBURG SC",9,43,13,8,22,43,-81.93160248,34.94982529
229,"SPEEDWAY IN",9,39,7,6,26,39,-86.2671051,39.80224609
229,"SPENCER OK",9,1,0,0,1,1,-97.3780365,35.52297974
229,"SPIRO OK",9,5,1,1,3,5,-94.62031555,35.24132538
229,"SPOKANE WA",9,43,10,8,25,43,-117.4281387,47.65847015
229,"SPRINGDALE AR",9,2,0,0,2,2,-94.12921143,36.1869278
229,"SPRINGFIELD IL",9,78,19,19,40,78,-89.6439743,39.80184174
229,"SPRINGFIELD KY",9,1,1,0,0,1,-85.22190857,37.68533707
229,"SPRINGFIELD MA",9,10,2,3,5,10,-72.57289124,42.10980606
229,"SPRINGFIELD MO",9,444,131,81,232,444,-93.29862213,37.21548843
229,"SPRINGFIELD OH",9,3,1,1,1,3,-83.80889893,39.92424011
229,"SPRINGFIELD OR",9,1,0,1,0,1,-123.024704,44.04590988
229,"SPRINGFIELD TN",9,2,0,1,1,2,-86.88502502,36.50941086
229,"SPRINGFIELD VT",9,1,0,0,1,1,-72.48161316,43.29873657
229,"ST LOUIS MO",9,7845,2309,1546,3990,7845,-90.19819641,38.62716675
229,"STAMFORD CT",9,2,0,2,0,2,-73.53807068,41.05353165
229,"STAPLES MN",9,1,0,0,1,1,-94.79264069,46.35538483
229,"STARKVILLE MS",9,9,3,3,3,9,-88.81492615,33.46545029
229,"STATE COLLEGE PA",9,7,6,0,1,7,-77.85973358,40.79336929
229,"STATESBORO GA",9,12,3,3,6,12,-81.78266907,32.44914246
229,"STAUNTON VA",9,1,1,0,0,1,-79.07145691,38.14970016
229,"STEAMBOAT SPRINGS CO",9,3,1,0,2,3,-106.8292313,40.48627853
229,"STERLING HEIGHTS MI",9,1,0,0,1,1,-83.03016663,42.58047485
229,"STEVENS POINT WI",9,17,3,3,11,17,-89.57467651,44.52337265
229,"STILLWATER MN",9,8,4,3,1,8,-92.80657959,45.05171967
229,"STILLWATER OK",9,1,0,1,0,1,-97.0588913,36.11580658
229,"STOCKBRIDGE GA",9,2,0,0,2,2,-84.23356628,33.54455185
229,"STOCKTON CA",9,40,16,10,14,40,-121.293457,37.95776749
229,"STONE MOUNTAIN GA",9,7,3,2,2,7,-84.14538574,33.8065033
229,"STONEHAM MA",9,1,0,1,0,1,-71.09869385,42.48027039
229,"STOWE VT",9,1,0,0,1,1,-72.68366241,44.46540451
229,"STRATFORD CT",9,3,0,1,2,3,-73.13223267,41.18459702
229,"STUART FL",9,1,1,0,0,1,-80.25237274,27.19645882
229,"STURGIS KY",9,2,0,1,1,2,-87.98410797,37.54692459
229,"SUFFOLK VA",9,4,0,1,3,4,-76.58317566,36.72846985
229,"SUGAR LAND TX",9,7,2,1,4,7,-95.6352005,29.61997795
229,"SULPHUR LA",9,1,0,1,0,1,-93.37752533,30.23687744
229,"SUMMERVILLE SC",9,6,1,0,5,6,-80.17547607,33.01868439
229,"SUMMIT NJ",9,1,0,1,0,1,-74.3586731,40.74148178
229,"SUMTER SC",9,2,0,1,1,2,-80.34135437,33.92088318
229,"SUN PRAIRIE WI",9,7,2,2,3,7,-89.21392059,43.18373108
229,"SUNNYVALE CA",9,12,3,4,5,12,-122.0380707,37.36878967
229,"SUNRISE FL",9,2,0,0,2,2,-80.2282486,26.14059067
229,"SURF CITY NC",9,2,1,0,1,2,-77.54553986,34.42726898
229,"SURFSIDE BEACH SC",9,1,0,0,1,1,-78.97283173,33.6062355
229,"SURFSIDE FL",9,6,1,4,1,6,-80.12493134,25.87931252
229,"SUSANVILLE CA",9,1,0,0,1,1,-120.6552582,40.41608047
229,"SWANSEA IL",9,1,0,0,1,1,-89.98918152,38.53406143
229,"SWARTHMORE PA",9,1,0,0,1,1,-75.34899139,39.90222549
229,"SWEENY TX",9,4,2,1,1,4,-95.69893646,29.03920364
229,"SYLACAUGA AL",9,1,0,1,0,1,-86.25159454,33.17354202
229,"SYLVANIA OH",9,10,2,2,6,10,-83.71266174,41.71902466
229,"SYRACUSE NY",9,132,36,34,62,132,-76.14653015,43.04846191
229,"TACOMA WA",9,107,31,26,50,107,-122.4466705,47.25242233
229,"TAKOMA PARK MD",9,4,2,0,2,4,-77.00667572,38.97793198
229,"TALLADEGA AL",9,6,3,1,2,6,-86.10553741,33.43610001
229,"TALLAHASSEE FL",9,113,37,22,54,113,-84.27896881,30.44669914
229,"TAMA IA",9,1,1,0,0,1,-92.58396149,41.97137451
229,"TAMARAC FL",9,3,2,0,1,3,-80.22389984,26.19458199
229,"TAMPA FL",9,360,103,101,156,360,-82.4580307,27.94833755
229,"TAMPICO IL",9,1,1,0,0,1,-89.78656006,41.63049698
229,"TAOS NM",9,22,12,3,7,22,-105.5769424,36.40658188
229,"TARBORO NC",9,1,0,1,0,1,-77.5349884,35.89706039
229,"TARPON SPRINGS FL",9,56,17,14,25,56,-82.75656128,28.14682198
229,"TAVARES FL",9,1,0,0,1,1,-81.72516632,28.80491257
229,"TAYLORSVILLE KY",9,2,0,1,1,2,-85.34210968,38.03184128
229,"TAZEWELL VA",9,1,0,1,0,1,-81.51947021,37.11498642
229,"TEA SD",9,3,1,0,2,3,-96.83795166,43.44678497
229,"TEANECK NJ",9,22,8,2,12,22,-74.01485443,40.89759064
229,"TEHACHAPI CA",9,1,0,0,1,1,-118.4508972,35.132164
229,"TEMECULA CA",9,2,1,0,1,2,-117.1428146,33.48790741
229,"TEMPE AZ",9,82,24,13,45,82,-111.9108276,33.41504288
229,"TEMPLE CITY CA",9,3,0,0,3,3,-118.0596924,34.10735321
229,"TEMPLE TX",9,4,2,1,1,4,-97.34354401,31.09850502
229,"TERRE HAUTE IN",9,24,7,5,12,24,-87.41414642,39.46681976
229,"TERRELL TX",9,1,0,0,1,1,-96.27573395,32.73627472
229,"TEWKSBURY MA",9,9,3,1,5,9,-71.23313904,42.61103439
229,"TEXARKANA AR",9,1,0,1,0,1,-94.03818512,33.44210052
229,"TEXARKANA TX",9,3,0,2,1,3,-94.04785156,33.42536545
229,"THIBODAUX LA",9,2,0,1,1,2,-90.82309723,29.79626465
229,"THORNTON CO",9,2,0,1,1,2,-104.9727631,39.86811829
229,"THOUSAND OAKS CA",9,2,1,0,1,2,-118.8398514,34.17078018
229,"THREE OAKS MI",9,1,0,0,1,1,-86.61090088,41.7985611
229,"THREE RIVERS MI",9,20,8,7,5,20,-85.63246918,41.94419861
229,"TIGARD OR",9,11,4,4,3,11,-122.7737198,45.4310112
229,"TILLAMOOK OR",9,1,0,0,1,1,-123.8468399,45.45576096
229,"TIMPSON TX",9,2,1,0,1,2,-94.39550781,31.90409851
229,"TINLEY PARK IL",9,2,1,1,0,2,-87.78465271,41.57352448
229,"TIPP CITY OH",9,1,0,0,1,1,-84.17195892,39.95846939
229,"TIPTON IN",9,2,1,1,0,2,-86.0413208,40.28222275
229,"TITUSVILLE FL",9,1,1,0,0,1,-80.80722809,28.61296272
229,"TOLEDO OH",9,316,89,72,155,316,-83.55497742,41.66411591
229,"TOLLESON AZ",9,1,0,0,1,1,-112.2612381,33.45026016
229,"TOMBALL TX",9,1,0,1,0,1,-95.6162262,30.09776115
229,"TOMBSTONE AZ",9,4,0,0,4,4,-110.0689316,31.71310997
229,"TOMS RIVER NJ",9,2,0,1,1,2,-74.19700623,39.95401382
229,"TONAWANDA NY",9,1,1,0,0,1,-78.88004303,43.02050018
229,"TOOELE UT",9,1,0,0,1,1,-112.3005066,40.53457642
229,"TOPEKA KS",9,36,12,7,17,36,-95.67857361,39.04813766
229,"TOPPENISH WA",9,2,1,0,1,2,-120.3111954,46.37686539
229,"TORONTO KS",9,2,1,1,0,2,-95.94944,37.79908752
229,"TORRANCE CA",9,33,7,14,12,33,-118.3428345,33.8359642
229,"TORRINGTON CT",9,35,4,9,22,35,-73.12056732,41.80105209
229,"TOWNSEND TN",9,1,0,1,0,1,-83.75569153,35.67550278
229,"TRAVELERS REST SC",9,6,1,1,4,6,-82.44297028,34.96780014
229,"TRAVERSE CITY MI",9,5,1,1,3,5,-85.6207962,44.76324844
229,"TREMONT IL",9,2,0,1,1,2,-89.49304199,40.52783585
229,"TRENTON FL",9,1,0,1,0,1,-82.81704712,29.61356735
229,"TRENTON NJ",9,28,8,7,13,28,-74.74206543,40.21709442
229,"TRENTON OH",9,2,1,0,1,2,-84.45779419,39.48095703
229,"TROUP TX",9,1,0,0,1,1,-95.12340546,32.14391708
229,"TROY MI",9,3,3,0,0,3,-83.14983368,42.60589218
229,"TROY MO",9,9,4,1,4,9,-90.98098755,38.979702
229,"TROY OH",9,37,16,9,12,37,-84.20330811,40.03966141
229,"TRUCKEE CA",9,2,1,1,0,2,-120.1852493,39.32775879
229,"TRUTH OR CONSEQUENCES NM",9,1,0,1,0,1,-107.2433853,33.13360596
229,"TUCKAHOE NY",9,1,0,1,0,1,-73.82630157,40.95046616
229,"TUCSON AZ",9,148,47,33,68,148,-110.9277954,32.22209167
229,"TUKWILA WA",9,1,0,1,0,1,-122.26371,47.47369385
229,"TULARE CA",9,2,0,0,2,2,-119.3488922,36.20763016
229,"TULSA OK",9,62,17,15,30,62,-95.98488617,36.1603241
229,"TUMWATER WA",9,2,0,0,2,2,-122.9116669,47.00710678
229,"TUPELO MS",9,1,0,1,0,1,-88.71934509,34.26508713
229,"TURLOCK CA",9,3,1,1,1,3,-120.8488617,37.49431229
229,"TUSCALOOSA AL",9,44,13,8,23,44,-87.56897736,33.21024704
229,"TUSTIN CA",9,1,0,1,0,1,-117.8277283,33.74598312
229,"TUTTLE OK",9,2,0,2,0,2,-97.82015991,35.29173279
229,"TWIN FALLS ID",9,7,3,0,4,7,-114.4627686,42.56301498
229,"TWIN OAKS MO",9,1,1,0,0,1,-90.49687958,38.56483841
229,"TWO RIVERS WI",9,1,0,0,1,1,-87.56972504,44.15388107
229,"TYLER TX",9,19,8,4,7,19,-95.3013916,32.35176468
229,"UHRICHSVILLE OH",9,1,0,0,1,1,-81.34598541,40.3932991
229,"UKIAH CA",9,2,0,1,1,2,-123.2104721,39.15015793
229,"UNION CITY CA",9,1,0,0,1,1,-122.0214462,37.59539032
229,"UNION CITY TN",9,2,1,0,1,2,-89.05702972,36.42431259
229,"UNION ME",9,1,0,0,1,1,-69.27328491,44.21183395
229,"UNION MO",9,1,0,0,1,1,-91.00618744,38.44558716
229,"UNION STAR MO",9,1,0,0,1,1,-94.59474945,39.98047638
229,"UNIONTOWN PA",9,3,2,0,1,3,-79.7276535,39.89894104
229,"UNIVERSAL CITY TX",9,3,0,1,2,3,-98.29141235,29.54836273
229,"UNIVERSITY CITY MO",9,105,28,25,52,105,-90.33391571,38.66000748
229,"UNIVERSITY HEIGHTS OH",9,2,1,0,1,2,-81.5369873,41.49779892
229,"UNIVERSITY PLACE WA",9,1,0,1,0,1,-122.5529404,47.2352562
229,"UPPER DARBY PA",9,4,1,0,3,4,-75.27319336,39.92858124
229,"UPPER MARLBORO MD",9,11,4,3,4,11,-76.74905396,38.81620026
229,"UPPER SADDLE RIVER NJ",9,1,0,0,1,1,-74.09785461,41.05847168
229,"URBANA IL",9,21,10,7,4,21,-88.20746613,40.11079025
229,"URBANA OH",9,1,0,0,1,1,-83.75213623,40.10844803
229,"UTICA NY",9,1,0,0,1,1,-75.23220062,43.10119629
229,"UVALDE TX",9,1,0,0,1,1,-99.78696442,29.20999336
229,"VACAVILLE CA",9,7,5,1,1,7,-121.9900284,38.35633469
229,"VALDOSTA GA",9,24,4,8,12,24,-83.27806854,30.83293533
229,"VALLEJO CA",9,24,5,8,11,24,-122.2594299,38.1039505
229,"VALMEYER IL",9,4,1,2,1,4,-90.315979,38.29438782
229,"VALPARAISO IN",9,1,1,0,0,1,-87.05838013,41.46813583
229,"VAN BUREN AR",9,1,0,1,0,1,-94.34884644,35.43715286
229,"VAN METER IA",9,1,0,1,0,1,-93.95458984,41.53206253
229,"VANCOUVER WA",9,24,10,4,10,24,-122.6816559,45.63534164
229,"VARDAMAN MS",9,1,0,0,1,1,-89.17769623,33.87607956
229,"VARNVILLE SC",9,8,1,6,1,8,-81.07863617,32.85089874
229,"VENICE FL",9,6,1,1,4,6,-82.45388031,27.10065269
229,"VERNON AL",9,1,0,0,1,1,-88.10897064,33.75712967
229,"VERNON CT",9,1,1,0,0,1,-72.47887421,41.81890869
229,"VERO BEACH FL",9,2,0,1,1,2,-80.39705658,27.63908195
229,"VERSAILLES KY",9,1,0,1,0,1,-84.73013306,38.05267715
229,"VIAN OK",9,11,3,4,4,11,-94.9708252,35.498703
229,"VICKSBURG MS",9,1,1,0,0,1,-90.87818909,32.35280991
229,"VICTORIA TX",9,12,4,1,7,12,-97.00409698,28.80560303
229,"VICTORVILLE CA",9,8,2,0,6,8,-117.2928162,34.53612137
229,"VIENNA VA",9,11,4,1,6,11,-77.2645874,38.90164566
229,"VIENNA WV",9,1,0,0,1,1,-81.54671478,39.33840179
229,"VILLA RICA GA",9,10,4,1,5,10,-84.91907501,33.73210907
229,"VINE GROVE KY",9,1,1,0,0,1,-85.98104858,37.81027222
229,"VINELAND NJ",9,1,0,0,1,1,-75.02515411,39.48631668
229,"VIRGINIA BEACH VA",9,247,63,65,119,247,-75.97751617,36.8533783
229,"VISTA CA",9,4,0,2,2,4,-117.2447052,33.2000885
229,"VOORHEESVILLE NY",9,1,1,0,0,1,-73.92787933,42.6541748
229,"WACO TX",9,15,4,5,6,15,-97.14704895,31.54987144
229,"WAGRAM NC",9,1,0,0,1,1,-79.36548615,34.88830948
229,"WAITE PARK MN",9,62,18,12,32,62,-94.224823,45.55731201
229,"WAKE FOREST NC",9,7,2,2,3,7,-78.50919342,35.98039246
229,"WAKEFIELD MA",9,5,0,3,2,5,-71.07489014,42.51018906
229,"WALDOBORO ME",9,1,0,1,0,1,-69.37466431,44.09539795
229,"WALLA WALLA WA",9,3,1,2,0,3,-118.3452072,46.06405258
229,"WALLINGFORD CT",9,1,1,0,0,1,-72.82215118,41.45715332
229,"WALNUT CREEK CA",9,4,0,2,2,4,-122.0670624,37.90636826
229,"WALTHAM MA",9,3,1,0,2,3,-71.2346344,42.37656403
229,"WALTON KY",9,2,0,1,1,2,-84.61334229,38.86997604
229,"WAPAKONETA OH",9,2,1,0,1,2,-84.19355011,40.56769943
229,"WARE MA",9,21,5,5,11,21,-72.24856567,42.26243591
229,"WAREHAM MA",9,1,0,1,0,1,-70.68606567,41.76660156
229,"WARNER ROBINS GA",9,4,1,2,1,4,-83.59963989,32.62118149
229,"WARREN MI",9,261,86,67,108,261,-83.02783203,42.47764969
229,"WARREN OH",9,5,1,2,2,5,-80.81771851,41.23757935
229,"WARRENSBURG MO",9,1,1,0,0,1,-93.73639679,38.76289749
229,"WARRENTON MO",9,1,0,0,1,1,-91.14160919,38.81156921
229,"WARRENTON VA",9,4,2,1,1,4,-77.79475403,38.71380615
229,"WARTRACE TN",9,1,0,0,1,1,-86.33337402,35.5274086
229,"WARWICK RI",9,13,3,4,6,13,-71.37738037,41.69232941
229,"WASHINGTON DC",9,4371,1255,942,2174,4371,-77.01257324,38.88911819
229,"WASHINGTON MO",9,10,1,1,8,10,-91.01213074,38.55807495
229,"WASHINGTON PA",9,1,0,1,0,1,-80.24552155,40.17398453
229,"WASHOUGAL WA",9,2,0,2,0,2,-122.3545303,45.58441925
229,"WASILLA AK",9,19,6,4,9,19,-149.4517059,61.58290482
229,"WATERBURY CT",9,2,1,0,1,2,-73.05029297,41.55849075
229,"WATERFORD WI",9,1,0,0,1,1,-88.21479797,42.76306152
229,"WATERLOO IA",9,5,1,0,4,5,-92.34320831,42.49277496
229,"WATERLOO IL",9,1,0,0,1,1,-90.14981842,38.3361702
229,"WATERTOWN NY",9,2,1,0,1,2,-75.9100647,43.97471619
229,"WATERTOWN WI",9,1,0,0,1,1,-88.72946167,43.19454193
229,"WATSONVILLE CA",9,2,2,0,0,2,-121.7594147,36.90995407
229,"WAUCHULA FL",9,1,1,0,0,1,-81.8108902,27.54789543
229,"WAUKEGAN IL",9,1,1,0,0,1,-87.84466553,42.36366653
229,"WAUKESHA WI",9,19,1,3,15,19,-88.23146057,43.01194382
229,"WAUSAU WI",9,30,18,2,10,30,-89.63059998,44.95904922
229,"WAUWATOSA WI",9,2,0,1,1,2,-88.00754547,43.04960632
229,"WAVERLY KS",9,5,1,1,3,5,-95.603302,38.39393997
229,"WAVERLY NE",9,2,0,2,0,2,-96.52924347,40.9175148
229,"WAXAHACHIE TX",9,11,2,3,6,11,-96.84883118,32.38674545
229,"WAXHAW NC",9,1,1,0,0,1,-80.74282074,34.92486572
229,"WAYNE PA",9,1,0,0,1,1,-75.38678741,40.04436111
229,"WAYNESVILLE MO",9,2,2,0,0,2,-92.20101166,37.8287735
229,"WEATHERFORD TX",9,2,0,1,1,2,-97.79758453,32.7595253
229,"WEBB CITY MO",9,1,0,0,1,1,-94.4631958,37.14646912
229,"WEBSTER GROVES MO",9,1,1,0,0,1,-90.35769653,38.59287262
229,"WEBSTER NY",9,2,0,0,2,2,-77.42967224,43.21234131
229,"WEED CA",9,44,16,13,15,44,-122.388382,41.42225266
229,"WEEHAWKEN NJ",9,2,0,1,1,2,-74.01938629,40.7696991
229,"WELLINGTON OH",9,1,1,0,0,1,-82.21770477,41.16889954
229,"WENATCHEE WA",9,2,1,1,0,2,-120.3128357,47.42322159
229,"WENTZVILLE MO",9,1,0,0,1,1,-90.85335541,38.81171036
229,"WESLACO TX",9,13,2,2,9,13,-97.99131775,26.16018867
229,"WEST CHESTER OH",9,2,1,1,0,2,-84.40789032,39.33029938
229,"WEST CHESTER PA",9,32,8,9,15,32,-75.60475159,39.96074677
229,"WEST CHICAGO IL",9,1,0,0,1,1,-88.20433807,41.88489914
229,"WEST COLUMBIA TX",9,1,0,0,1,1,-95.64544678,29.1445179
229,"WEST DES MOINES IA",9,14,5,3,6,14,-93.71179962,41.57717514
229,"WEST FARGO ND",9,1,0,0,1,1,-96.90450287,46.87138367
229,"WEST HARTFORD CT",9,12,4,2,6,12,-72.74108887,41.76238251
229,"WEST HAVEN CT",9,5,3,1,1,5,-72.94598389,41.27069473
229,"WEST HOLLYWOOD CA",9,71,17,13,41,71,-118.3634567,34.08982468
229,"WEST JORDAN UT",9,1,0,1,0,1,-111.9405594,40.60975647
229,"WEST LAFAYETTE IN",9,11,2,0,9,11,-86.9082489,40.42613983
229,"WEST MONROE LA",9,1,0,1,0,1,-92.14794922,32.5187645
229,"WEST ORANGE NJ",9,3,1,2,0,3,-74.23833466,40.7989006
229,"WEST PALM BEACH FL",9,79,22,19,38,79,-80.05298615,26.71585464
229,"WEST PEORIA IL",9,2,0,0,2,2,-89.6051712,40.7019577
229,"WEST PLAINS MO",9,6,1,2,3,6,-91.85284424,36.72810745
229,"WEST RICHLAND WA",9,2,0,2,0,2,-119.3632965,46.30400085
229,"WEST SACRAMENTO CA",9,1,0,0,1,1,-121.5324554,38.58049393
229,"WEST TX",9,10,2,3,5,10,-97.09226227,31.80267906
229,"WEST VALLEY CITY UT",9,1,0,0,1,1,-111.9695816,40.69639969
229,"WEST WARWICK RI",9,2,0,2,0,2,-71.5218811,41.70644379
229,"WESTERVILLE OH",9,4,0,2,2,4,-82.92906952,40.12620926
229,"WESTFIELD NJ",9,1,0,1,0,1,-74.34671783,40.65938187
229,"WESTLAND MI",9,1,1,0,0,1,-83.39988708,42.32430649
229,"WESTMINSTER CO",9,7,1,2,4,7,-105.0385208,39.83644867
229,"WESTMINSTER MD",9,2,1,0,1,2,-76.99542999,39.57574463
229,"WESTPORT CT",9,1,0,0,1,1,-73.35696411,41.14154053
229,"WESTWEGO LA",9,1,0,0,1,1,-90.14245605,29.90624237
229,"WHEAT RIDGE CO",9,1,0,0,1,1,-105.0783615,39.76603317
229,"WHEATON IL",9,3,1,1,1,3,-88.10729218,41.86618805
229,"WHEELING WV",9,10,2,5,3,10,-80.7192688,40.06991577
229,"WHITE HOUSE TN",9,1,0,0,1,1,-86.65110016,36.47054672
229,"WHITE PLAINS NY",9,10,1,2,7,10,-73.76217651,41.03399658
229,"WHITEHALL PA",9,1,1,0,0,1,-79.99015045,40.36117554
229,"WHITEVILLE NC",9,1,0,0,1,1,-78.70272064,34.3391037
229,"WHITEWATER WI",9,3,1,0,2,3,-88.73226166,42.83348846
229,"WHITTIER CA",9,8,1,0,7,8,-118.0349197,33.9793129
229,"WICHITA FALLS TX",9,36,9,6,21,36,-98.49403381,33.91383743
229,"WICHITA KS",9,82,24,12,46,82,-97.3383255,37.69230652
229,"WIGGINS MS",9,2,0,0,1,1,-89.388908385,31.78047371
229,"WILDOMAR CA",9,1,0,1,0,1,-117.2806625,33.59801483
229,"WILKES-BARRE PA",9,4,3,1,0,4,-75.88058472,41.24601746
229,"WILKINSBURG PA",9,10,3,3,4,10,-79.88179016,40.44174194
229,"WILLACOOCHEE GA",9,1,1,0,0,1,-83.04568481,31.34116745
229,"WILLIAMSBURG KY",9,1,0,0,1,1,-84.15948486,36.74344254
229,"WILLIAMSBURG VA",9,7,4,0,3,7,-76.70659637,37.27114868
229,"WILLIAMSON WV",9,1,1,0,0,1,-82.27328491,37.67479324
229,"WILLIAMSPORT PA",9,1,0,0,1,1,-77.00060272,41.24121475
229,"WILLIAMSTOWN KY",9,4,0,3,1,4,-84.56015778,38.63843536
229,"WILLIAMSTOWN MA",9,3,0,0,3,3,-73.21173859,42.70910263
229,"WILLIAMSVILLE NY",9,1,1,0,0,1,-78.73756409,42.96403885
229,"WILLINGBORO NJ",9,2,0,0,2,2,-74.86815643,40.02816391
229,"WILLISTON ND",9,2,2,0,0,2,-103.6307449,48.14650726
229,"WILLOUGHBY HILLS OH",9,2,0,0,2,2,-81.41830444,41.598526
229,"WILMINGTON DE",9,24,6,9,9,24,-75.54558563,39.74601364
229,"WILMINGTON MA",9,1,1,0,0,1,-71.17237091,42.54682159
229,"WILMINGTON NC",9,35,14,7,14,35,-77.94431305,34.22592926
229,"WINCHESTER KY",9,5,0,3,2,5,-84.17945862,37.99042511
229,"WINCHESTER TN",9,1,0,0,1,1,-86.11190796,35.18607712
229,"WINCHESTER VA",9,14,4,5,5,14,-78.16301727,39.18608475
229,"WINDER GA",9,1,0,0,1,1,-83.71982574,33.99271393
229,"WINDERMERE FL",9,17,4,5,8,17,-81.53463745,28.49615097
229,"WINDHAM OH",9,2,1,0,1,2,-81.04442596,41.23672867
229,"WINDSOR CT",9,2,0,1,1,2,-72.64279175,41.85288239
229,"WINDSOR MO",9,21,8,9,4,21,-93.5224762,38.53234863
229,"WINFIELD IL",9,3,1,0,2,3,-88.16100311,41.861763
229,"WINGATE NC",9,1,0,0,1,1,-80.4487915,34.98449326
229,"WINSTON-SALEM NC",9,34,6,11,17,34,-80.24356842,36.1001091
229,"WINTER HAVEN FL",9,3,0,1,2,3,-81.73223114,28.02276421
229,"WINTER PARK CO",9,1,1,0,0,1,-105.7649307,39.89161301
229,"WINTER PARK FL",9,24,4,9,11,24,-81.33872223,28.6003685
229,"WOBURN MA",9,1,0,0,1,1,-71.15155029,42.47951508
229,"WOODBRIDGE NJ",9,1,0,0,1,1,-74.28398895,40.55769348
229,"WOODBURN OR",9,2,0,2,0,2,-122.8577652,45.14351273
229,"WOODBURY MN",9,6,1,2,3,6,-92.95999908,44.92368698
229,"WOODINVILLE WA",9,3,0,1,2,3,-122.1656876,47.75372314
229,"WOODLAND CA",9,2,1,0,1,2,-121.7751541,38.67827225
229,"WOODRIDGE IL",9,1,1,0,0,1,-88.05056763,41.74704742
229,"WOODSTOCK GA",9,5,1,1,3,5,-84.51925659,34.10178375
229,"WOOSTER OH",9,7,1,1,5,7,-81.93497467,40.80502319
229,"WORCESTER MA",9,31,11,7,13,31,-71.801651,42.26288986
229,"WORLAND WY",9,1,0,1,0,1,-107.9568024,44.01663589
229,"WRIGHT CITY MO",9,1,0,0,1,1,-91.02021027,38.82786942
229,"WYLIE TX",9,1,1,0,0,1,-96.5396347,33.01520157
229,"WYOMING MI",9,3,2,0,1,3,-85.70549011,42.9133873
229,"YELM WA",9,4,1,2,1,4,-122.608902,46.94182968
229,"YONKERS NY",9,14,4,6,4,14,-73.89792633,40.93142319
229,"YORBA LINDA CA",9,1,1,0,0,1,-117.8147278,33.88856888
229,"YORK PA",9,9,3,3,3,9,-76.72687531,39.96264267
229,"YOUNGSTOWN OH",9,431,123,87,221,431,-80.64901733,41.1000061
229,"YPSILANTI MI",9,25,12,3,10,25,-83.61315155,42.24105453
229,"YUCAIPA CA",9,1,0,1,0,1,-117.0447998,34.03347397
229,"YUMA AZ",9,5,0,4,1,5,-114.6262665,32.72531128
229,"YUMA CO",9,1,1,0,0,1,-102.7258301,40.12628937
229,"ZANESVILLE OH",9,5,2,0,3,5,-82.01314545,39.94056702
229,"ZILLAH WA",9,1,0,0,1,1,-120.2643509,46.40153503
230,"ABERDEEN MD",10,1,0,1,0,1,-76.16343689,39.50980759
230,"ABERDEEN NC",10,1,0,0,1,1,-79.42922211,35.13199615
230,"ABERDEEN SD",10,5,0,1,4,5,-98.48273468,45.46180344
230,"ABERDEEN WA",10,30,3,18,9,30,-123.8181381,46.97493744
230,"ABERNATHY TX",10,1,1,0,0,1,-101.8455887,33.829319
230,"ABILENE KS",10,9,2,4,3,9,-97.21461487,38.9171524
230,"ABILENE TX",10,23,3,10,10,23,-99.73384094,32.44894028
230,"ABINGTON MA",10,1,0,0,1,1,-70.94435883,42.1049118
230,"ABINGTON PA",10,3,1,0,2,3,-75.11743164,40.12073898
230,"ABSECON NJ",10,65,16,18,31,65,-74.49462128,39.42850494
230,"ACCIDENT MD",10,1,0,0,1,1,-79.31906891,39.62875366
230,"ACKERMAN MS",10,1,0,1,0,1,-89.17317963,33.31027222
230,"ACTON MA",10,5,1,1,3,5,-71.43197632,42.48540115
230,"ACWORTH GA",10,8,2,2,4,8,-84.67662811,34.06597519
230,"ADA OH",10,2,0,0,2,2,-83.82268524,40.76944351
230,"ADA OK",10,4,1,2,1,4,-96.67899323,34.77481842
230,"ADDISON IL",10,3,0,0,3,3,-87.98938751,41.93162155
230,"ADDISON TX",10,40,8,12,20,40,-96.82976532,32.96215057
230,"ADRIAN MI",10,2,0,1,1,2,-84.03691101,41.89771652
230,"ADRIAN MO",10,2,1,0,1,2,-94.35219574,38.39756775
230,"AIKEN SC",10,10,1,2,7,10,-81.71619415,33.55714417
230,"AIRMONT NY",10,1,0,1,0,1,-74.11543274,41.10093689
230,"AKRON OH",10,302,91,90,121,302,-81.51885223,41.08151627
230,"AKRON PA",10,1,0,0,1,1,-76.20130157,40.15691757
230,"ALAMEDA CA",10,127,35,39,53,127,-122.2444763,37.76513672
230,"ALAMOGORDO NM",10,8,2,1,5,8,-105.9584656,32.90003967
230,"ALAMOSA CO",10,2,0,0,2,2,-105.8724442,37.46229935
230,"ALBANY CA",10,3,0,2,1,3,-122.3003311,37.88674164
230,"ALBANY GA",10,7,2,3,2,7,-84.15510559,31.58296013
230,"ALBANY NY",10,130,41,31,58,130,-73.75520325,42.6529007
230,"ALBANY OR",10,13,4,5,4,13,-123.1083984,44.63620758
230,"ALBERTVILLE AL",10,1,0,0,1,1,-86.20863342,34.26794434
230,"ALBIA IA",10,1,0,0,1,1,-92.80632019,41.0268631
230,"ALBION ME",10,3,0,0,3,3,-69.44180298,44.53230286
230,"ALBUQUERQUE NM",10,576,128,162,286,576,-106.6517639,35.08336639
230,"ALCOA TN",10,1,0,1,0,1,-83.96761322,35.77825165
230,"ALEXANDER CITY AL",10,1,0,0,1,1,-85.95381927,32.94403458
230,"ALEXANDRIA LA",10,18,6,8,4,18,-92.44517517,31.31143761
230,"ALEXANDRIA MN",10,5,1,1,3,5,-95.37786865,45.88516617
230,"ALEXANDRIA VA",10,261,75,67,119,261,-77.04605103,38.80503082
230,"ALFRED NY",10,1,0,0,1,1,-77.78995514,42.25440979
230,"ALHAMBRA CA",10,2,0,0,2,2,-118.1287003,34.0954628
230,"ALICE TX",10,2,0,2,0,2,-98.07035828,27.7528286
230,"ALIQUIPPA PA",10,4,1,1,2,4,-80.23978424,40.63685608
230,"ALLEGAN MI",10,1,0,0,1,1,-85.85546112,42.52919769
230,"ALLEN PARK MI",10,1,0,1,0,1,-83.21057892,42.25782394
230,"ALLEN TX",10,7,1,2,4,7,-96.67116547,33.10336685
230,"ALLENTOWN PA",10,33,7,9,17,33,-75.46569824,40.60851288
230,"ALMA AR",10,1,0,0,1,1,-94.22241974,35.47818375
230,"ALMA MI",10,2,0,0,2,2,-84.65994263,43.37918854
230,"ALPENA MI",10,1,0,0,1,1,-83.43292999,45.06164551
230,"ALPHARETTA GA",10,7,2,0,5,7,-84.29410553,34.07542419
230,"ALTAMONTE SPRINGS FL",10,10,3,3,4,10,-81.39485931,28.66284752
230,"ALTON IL",10,45,13,13,19,45,-90.18429565,38.89074326
230,"ALTON TX",10,1,1,0,0,1,-98.30632782,26.28513527
230,"ALTOONA PA",10,21,5,8,8,21,-78.39411163,40.51860046
230,"ALVA OK",10,4,1,0,3,4,-98.66719055,36.80501556
230,"ALVIN TX",10,4,2,1,1,4,-95.24459076,29.42417526
230,"AMARILLO TX",10,46,9,17,20,46,-101.8324051,35.22210312
230,"AMELIA OH",10,1,0,1,0,1,-84.21751404,39.0284462
230,"AMERICAN FORK UT",10,1,0,0,1,1,-111.8032379,40.34251022
230,"AMERICUS GA",10,6,4,1,1,6,-84.23246002,32.07291031
230,"AMES IA",10,34,8,6,20,34,-93.61370087,42.02269363
230,"AMHERST MA",10,17,5,3,9,17,-72.5192337,42.37371826
230,"AMHERST OH",10,3,0,3,0,3,-82.22229767,41.39805603
230,"AMHERST VA",10,3,1,1,1,3,-79.05090332,37.58533478
230,"AMITYVILLE NY",10,2,0,1,1,2,-73.41622162,40.67899323
230,"AMORY MS",10,2,1,1,0,2,-88.48745728,33.98094559
230,"ANACORTES WA",10,4,0,0,4,4,-122.6148834,48.51247025
230,"ANAHEIM CA",10,57,18,16,23,57,-117.9165115,33.8354454
230,"ANCHORAGE AK",10,97,24,25,48,97,-149.8811951,61.21649933
230,"ANDERSON IN",10,31,6,10,15,31,-85.68051147,40.1053772
230,"ANDERSON SC",10,11,4,4,3,11,-82.65641785,34.50934219
230,"ANDOVER MA",10,5,2,1,2,5,-71.13011169,42.65668869
230,"ANDOVER MN",10,5,2,2,1,5,-93.29158783,45.23327637
230,"ANGOLA IN",10,1,0,0,1,1,-84.99913788,41.63493347
230,"ANKENY IA",10,11,2,4,5,11,-93.60646057,41.72983551
230,"ANN ARBOR MI",10,249,68,77,104,249,-83.74536896,42.28347015
230,"ANNAPOLIS MD",10,67,26,16,25,67,-76.49166107,38.97844696
230,"ANNISTON AL",10,2,1,1,0,2,-85.8313446,33.65997314
230,"ANNVILLE PA",10,2,0,1,1,2,-76.51483917,40.32979584
230,"ANOKA MN",10,2,0,1,1,2,-93.3874588,45.19776535
230,"ANTIGO WI",10,1,0,0,1,1,-89.15254211,45.14036942
230,"ANTIOCH CA",10,14,1,3,10,14,-121.808136,38.0049057
230,"APACHE JUNCTION AZ",10,8,4,2,2,8,-111.5511551,33.41511536
230,"APEX NC",10,4,1,1,2,4,-78.84952545,35.73279572
230,"APOLLO PA",10,3,1,1,1,3,-79.56620789,40.58155441
230,"APOPKA FL",10,2,0,0,2,2,-81.5089798,28.68117523
230,"APPLE VALLEY MN",10,2,1,0,1,2,-93.21794128,44.73189926
230,"APPLETON WI",10,27,6,5,16,27,-88.41551208,44.2618866
230,"ARAB AL",10,6,4,2,0,6,-86.49552917,34.31829453
230,"ARCADIA CA",10,15,2,4,9,15,-118.0368881,34.1397934
230,"ARCHDALE NC",10,1,0,1,0,1,-79.97145844,35.91481018
230,"ARCOLA IL",10,1,0,0,1,1,-88.3065567,39.68466949
230,"ARDEN HILLS MN",10,1,0,0,1,1,-93.15720367,45.05033112
230,"ARDMORE OK",10,5,1,2,2,5,-97.14401245,34.17425156
230,"ARGYLE WI",10,4,1,1,2,4,-89.86712646,42.70111084
230,"ARKADELPHIA AR",10,2,0,1,1,2,-93.05423737,34.12095642
230,"ARLINGTON HEIGHTS IL",10,20,5,6,9,20,-87.98104858,42.08821106
230,"ARLINGTON MA",10,14,6,1,7,14,-71.15559387,42.41545486
230,"ARLINGTON NE",10,1,0,0,1,1,-96.35142517,41.45244598
230,"ARLINGTON TN",10,4,2,2,0,4,-89.66139984,35.29637527
230,"ARLINGTON TX",10,204,51,48,105,204,-97.10882568,32.73590469
230,"ARLINGTON WA",10,2,1,0,1,2,-122.1277237,48.19829941
230,"ARNAUDVILLE LA",10,1,0,0,1,1,-91.93197632,30.39797974
230,"ARNOLD MO",10,8,1,1,6,8,-90.37690735,38.43906784
230,"ARROYO GRANDE CA",10,3,0,1,2,3,-120.5928879,35.11868668
230,"ARTESIA NM",10,1,1,0,0,1,-104.4046478,32.84522247
230,"ARVADA CO",10,6,3,1,2,6,-105.0886612,39.8028183
230,"ASBURY PARK NJ",10,17,3,8,6,17,-74.01100159,40.22047806
230,"ASHEBORO NC",10,3,1,2,0,3,-79.81291199,35.70822525
230,"ASHEVILLE NC",10,236,61,76,99,236,-82.55367279,35.60134888
230,"ASHLAND KY",10,48,13,16,19,48,-82.63764954,38.47874069
230,"ASHLAND MA",10,1,1,0,0,1,-71.46256256,42.26143265
230,"ASHLAND MO",10,13,1,2,10,13,-92.25737762,38.77433395
230,"ASHLAND OH",10,1,0,0,1,1,-82.31797028,40.86874771
230,"ASHLAND OR",10,57,19,16,22,57,-122.7111359,42.19425583
230,"ASHLAND VA",10,39,14,11,14,39,-77.47959137,37.75937653
230,"ASHLAND WI",10,12,4,5,3,12,-90.88419342,46.59241104
230,"ASHTABULA OH",10,15,3,2,10,15,-80.78971863,41.86506653
230,"ASHWAUBENON WI",10,4,1,1,2,4,-88.07009888,44.48205185
230,"ASPEN CO",10,4,0,3,1,4,-106.8185959,39.19105911
230,"ASPERMONT TX",10,1,0,0,1,1,-100.2279816,33.13380051
230,"ASTORIA OR",10,3,0,2,1,3,-123.8339157,46.18756866
230,"ATASCADERO CA",10,3,1,1,1,3,-120.6487961,35.47494888
230,"ATCHISON KS",10,1,0,0,1,1,-95.12229919,39.56309128
230,"ATHENS AL",10,1,0,1,0,1,-86.97190857,34.80292892
230,"ATHENS IL",10,5,1,2,2,5,-89.72410583,39.96085739
230,"ATHENS OH",10,71,20,12,39,71,-82.10113525,39.32934952
230,"ATHENS PA",10,12,2,5,5,12,-76.52072906,41.9661293
230,"ATHENS TX",10,2,0,1,1,2,-95.85599518,32.20513916
230,"ATLANTA GA",10,5307,1370,1537,2400,5307,-84.38757324,33.74927521
230,"ATLANTA IN",10,1,0,0,1,1,-86.02610016,40.21550751
230,"ATLANTIC BEACH FL",10,4,1,0,3,4,-81.39808655,30.33498573
230,"ATLANTIC CITY NJ",10,39,11,11,17,39,-74.42202759,39.36457062
230,"ATLANTIC HIGHLANDS NJ",10,1,0,0,1,1,-74.03326416,40.40827942
230,"ATTICA IN",10,1,1,0,0,1,-87.24867249,40.29444122
230,"ATTLEBORO MA",10,3,0,0,3,3,-71.28439331,41.94469833
230,"ATWATER CA",10,2,1,0,1,2,-120.6140137,37.34663773
230,"AUBURN AL",10,42,7,19,16,42,-85.48087311,32.61021423
230,"AUBURN CA",10,310,85,100,125,310,-121.0794067,38.89623642
230,"AUBURN IL",10,4,0,3,1,4,-89.74681854,39.59179688
230,"AUBURN MA",10,1,1,0,0,1,-71.84958649,42.18192291
230,"AUBURN ME",10,2,0,0,2,2,-70.23028564,44.09794235
230,"AUBURN MI",10,3,1,1,1,3,-84.06974792,43.60359955
230,"AUBURN NY",10,3,1,0,2,3,-76.56542969,42.93203735
230,"AUBURN WA",10,12,4,4,4,12,-122.2304688,47.30677795
230,"AUBURNDALE FL",10,1,0,0,1,1,-81.78826904,28.06580925
230,"AUGUSTA KS",10,1,0,1,0,1,-96.97721863,37.68652725
230,"AUGUSTA ME",10,6,0,1,5,6,-69.7781601,44.31053925
230,"AURORA CO",10,55,13,19,23,55,-104.8693161,39.73983765
230,"AURORA IL",10,32,7,3,22,32,-88.32048798,41.76070023
230,"AUSTELL GA",10,6,2,1,3,6,-84.63414001,33.81290054
230,"AUSTIN MN",10,2,1,1,0,2,-92.97491455,43.6665535
230,"AUSTIN TX",10,3066,760,986,1320,3066,-97.74386597,30.26748466
230,"AUSTINTOWN OH",10,23,5,10,8,23,-80.76424408,41.10162354
230,"AUXVASSE MO",10,1,0,0,1,1,-91.89766693,39.01833725
230,"AVIS PA",10,1,0,1,0,1,-77.31352997,41.1848526
230,"AVON LAKE OH",10,5,3,1,1,5,-82.02809906,41.50548935
230,"AVONDALE AZ",10,7,3,0,4,7,-112.3513947,33.43592072
230,"AZLE TX",10,21,4,8,9,21,-97.54621887,32.89556885
230,"AZUSA CA",10,2,0,1,1,2,-117.9098816,34.13357544
230,"BAINBRIDGE GA",10,1,0,1,0,1,-84.57505798,30.90430069
230,"BAKERSFIELD CA",10,69,13,15,41,69,-119.0206375,35.37326813
230,"BALCH SPRINGS TX",10,1,0,0,1,1,-96.62306213,32.72889328
230,"BALDWIN NY",10,3,0,1,2,3,-73.60838318,40.65660858
230,"BALDWIN PARK CA",10,5,1,2,2,5,-117.9624786,34.08519363
230,"BALDWINSVILLE NY",10,1,0,0,1,1,-76.33219147,43.15886307
230,"BALDWYN MS",10,2,1,0,1,2,-88.63553619,34.5099411
230,"BALLSTON SPA NY",10,3,0,2,1,3,-73.84790039,43.00103378
230,"BALLWIN MO",10,77,22,26,29,77,-90.54669189,38.5951004
230,"BALTIMORE MD",10,1547,382,498,667,1547,-76.6115799,39.29075623
230,"BANDON OR",10,1,0,0,1,1,-124.4105606,43.11890793
230,"BANGOR ME",10,33,11,12,10,33,-68.77653503,44.80109406
230,"BANKS OR",10,1,0,0,1,1,-123.1168671,45.61822128
230,"BAR HARBOR ME",10,6,1,3,2,6,-68.20309448,44.38752747
230,"BARABOO WI",10,1,0,1,0,1,-89.74446869,43.47089767
230,"BARBOURVILLE KY",10,2,1,0,1,2,-83.88861084,36.86665726
230,"BARDSTOWN KY",10,8,0,2,2,4,-85.46318817,37.810512545
230,"BARGERSVILLE IN",10,1,0,1,0,1,-86.16780853,39.52098083
230,"BARLOW KY",10,1,0,1,0,1,-89.04716492,37.05197525
230,"BARNESVILLE GA",10,1,1,0,0,1,-84.15583038,33.05487442
230,"BARRE VT",10,2,0,0,2,2,-72.50119781,44.19706345
230,"BARSTOW CA",10,2,1,0,1,2,-117.0245132,34.89870071
230,"BARTLESVILLE OK",10,1,0,1,0,1,-95.98135376,36.74737549
230,"BARTLETT IL",10,9,2,2,5,9,-88.18564606,41.9950676
230,"BARTLETT TN",10,2,0,0,2,2,-89.87441254,35.20460892
230,"BARTONVILLE IL",10,53,9,21,23,53,-89.65235138,40.6502037
230,"BASTROP LA",10,1,1,0,0,1,-91.91439819,32.77897644
230,"BASTROP TX",10,5,0,1,4,5,-97.31572723,30.11092758
230,"BATAVIA NY",10,2,0,1,1,2,-78.18697357,42.99835587
230,"BATESVILLE MS",10,17,4,7,6,17,-89.94464874,34.31167603
230,"BATON ROUGE LA",10,324,92,89,143,324,-91.15479279,30.45132256
230,"BATTLE CREEK MI",10,4,2,0,2,4,-85.17985535,42.32100677
230,"BAXTER SPRINGS KS",10,4,1,0,3,4,-94.73813629,37.02472305
230,"BAY CITY MI",10,4,1,0,3,4,-83.8886261,43.59466171
230,"BAY LAKE FL",10,1,0,1,0,1,-81.92185974,28.45840073
230,"BAY VILLAGE OH",10,2,0,2,0,2,-81.92155457,41.48464966
230,"BAYONNE NJ",10,10,4,3,3,10,-74.10975647,40.66794968
230,"BAYTOWN TX",10,41,10,13,18,41,-94.97782135,29.73608589
230,"BEACON NY",10,24,4,9,11,24,-73.9688797,41.50502014
230,"BEAUFORT NC",10,7,4,1,2,7,-76.66288757,34.71848679
230,"BEAUFORT SC",10,13,3,4,6,13,-80.68718719,32.44019699
230,"BEAUMONT CA",10,1,0,1,0,1,-116.9783173,33.9292717
230,"BEAUMONT TX",10,50,8,13,29,50,-94.10238647,30.08622551
230,"BEAVER DAM WI",10,1,0,1,0,1,-88.83752441,43.45764542
230,"BEAVER FALLS PA",10,2,1,0,1,2,-80.3188858,40.75218582
230,"BEAVER PA",10,7,1,3,3,7,-80.30450439,40.69532776
230,"BEAVER UT",10,3,1,1,1,3,-112.6483307,38.27668381
230,"BEAVERCREEK OH",10,32,10,10,12,32,-84.06332397,39.70913696
230,"BEAVERTON OR",10,73,24,22,27,73,-122.8055344,45.48670197
230,"BECKLEY WV",10,3,1,0,2,3,-81.18963623,37.77680588
230,"BEDFORD MA",10,1,0,1,0,1,-71.27526855,42.49069214
230,"BEDFORD NY",10,10,4,2,4,10,-73.64318085,41.204319
230,"BEDFORD PA",10,1,0,0,1,1,-78.50319672,40.01898575
230,"BEDFORD TX",10,9,1,1,7,9,-97.14364624,32.8442955
230,"BEDFORD VA",10,3,0,1,2,3,-79.52242279,37.33457184
230,"BEEBE AR",10,2,0,1,1,2,-91.87966156,35.07094574
230,"BEECH GROVE IN",10,5,0,1,4,5,-86.08973694,39.72201157
230,"BEECHER CITY IL",10,1,0,1,0,1,-88.78668976,39.18835068
230,"BEL AIR MD",10,5,0,0,5,5,-76.34788513,39.53611374
230,"BELEN NM",10,1,0,0,1,1,-106.7750244,34.65850067
230,"BELL CA",10,7,0,3,4,7,-118.1889572,33.97753906
230,"BELLAIRE OH",10,1,1,0,0,1,-80.74460602,40.02676773
230,"BELLAIRE TX",10,2,1,0,1,2,-95.4592514,29.70632935
230,"BELLE GLADE FL",10,2,0,0,2,2,-80.66747284,26.68785477
230,"BELLE MO",10,1,1,0,0,1,-91.72072601,38.28581619
230,"BELLEAIR BEACH FL",10,1,0,1,0,1,-82.84260559,27.9237709
230,"BELLEFONTAINE OH",10,3,1,0,2,3,-83.75959015,40.36141205
230,"BELLEFONTE PA",10,1,0,1,0,1,-77.77765656,40.91333389
230,"BELLEVIEW FL",10,1,0,0,1,1,-82.06185913,29.05568314
230,"BELLEVILLE IL",10,126,42,21,63,126,-89.98438263,38.52002716
230,"BELLEVILLE MI",10,6,0,2,4,6,-83.48514557,42.20495987
230,"BELLEVILLE NJ",10,1,0,1,0,1,-74.14912415,40.79369736
230,"BELLEVUE KY",10,2,1,1,0,2,-84.47879791,39.10644531
230,"BELLEVUE NE",10,2,0,0,2,2,-95.89156342,41.13648224
230,"BELLEVUE PA",10,5,0,1,4,5,-80.05105591,40.49424362
230,"BELLEVUE WA",10,28,8,9,11,28,-122.2029648,47.61014557
230,"BELLINGHAM WA",10,87,28,24,35,87,-122.4727402,48.76121521
230,"BELLMAWR NJ",10,11,4,1,6,11,-75.09385681,39.86771774
230,"BELLPORT NY",10,5,1,2,2,5,-72.93808746,40.75737
230,"BELMAR NJ",10,3,0,1,2,3,-74.02155304,40.17336273
230,"BELMONT CA",10,24,11,6,7,24,-122.2783508,37.51996613
230,"BELMONT NC",10,3,0,2,1,3,-81.0369873,35.24316406
230,"BELOIT WI",10,1,1,0,0,1,-89.03194427,42.50856781
230,"BELTON MO",10,2,1,0,1,2,-94.53222656,38.81176376
230,"BELTON TX",10,11,4,3,4,11,-97.46511841,31.05611229
230,"BEMIDJI MN",10,14,6,6,2,14,-94.88105774,47.47352982
230,"BEND OR",10,67,14,22,31,67,-121.3171387,44.0577774
230,"BENICIA CA",10,8,3,3,2,8,-122.1603012,38.04900742
230,"BENLD IL",10,1,0,0,1,1,-89.80440521,39.09303665
230,"BENNINGTON VT",10,2,0,1,1,2,-73.19591522,42.87845612
230,"BENSENVILLE IL",10,1,0,1,0,1,-87.94012451,41.95510483
230,"BENTON AR",10,2,0,1,1,2,-92.58699036,34.56454468
230,"BENTON HARBOR MI",10,5,3,0,2,5,-86.45429993,42.11692429
230,"BENTON LA",10,1,0,0,1,1,-93.74242401,32.69527817
230,"BENTONVILLE AR",10,31,6,10,15,31,-94.20933533,36.3728447
230,"BEREA KY",10,2,0,2,0,2,-84.29612732,37.5687027
230,"BEREA OH",10,6,3,1,2,6,-81.85396576,41.36633301
230,"BERKELEY CA",10,424,109,134,181,424,-122.2752533,37.87145615
230,"BERKELEY HEIGHTS NJ",10,3,0,1,2,3,-74.44181824,40.68349838
230,"BERKELEY MO",10,2,0,0,2,2,-90.33169556,38.75470734
230,"BERKLEY MI",10,1,0,1,0,1,-83.18341827,42.50307083
230,"BERLIN MD",10,1,0,1,0,1,-75.21686554,38.32276917
230,"BERWICK LA",10,1,0,0,1,1,-91.22148895,29.69494629
230,"BERWICK PA",10,1,1,0,0,1,-76.23230743,41.05486679
230,"BESSEMER AL",10,4,0,2,2,4,-86.95465851,33.40222549
230,"BETHALTO IL",10,1,0,0,1,1,-90.04077911,38.90911865
230,"BETHEL PARK PA",10,2,0,2,0,2,-80.01592255,40.33843613
230,"BETHLEHEM PA",10,25,6,8,11,25,-75.36949921,40.62598801
230,"BETTENDORF IA",10,10,3,3,4,10,-90.51612854,41.52465439
230,"BEVERLY HILLS CA",10,90,24,23,43,90,-118.4019775,34.07383347
230,"BEVERLY MA",10,2,1,0,1,2,-70.87913513,42.55848312
230,"BIG RAPIDS MI",10,2,0,1,1,2,-85.48376465,43.69808578
230,"BIG SANDY TX",10,4,1,3,0,4,-95.10948181,32.58401871
230,"BIG SPRING TX",10,6,1,3,2,6,-101.4811173,32.25181198
230,"BIGFORK MN",10,2,2,0,0,2,-93.65458679,47.74435425
230,"BIGGS CA",10,1,0,0,1,1,-121.7154388,39.41196823
230,"BILLERICA MA",10,1,0,0,1,1,-71.26820374,42.55883408
230,"BILLINGS MT",10,12,2,6,4,12,-108.504631,45.7833786
230,"BILOXI MS",10,10,2,5,3,10,-88.89369202,30.40021133
230,"BINGHAMTON NY",10,29,9,7,13,29,-75.91755676,42.0986557
230,"BIRDSBORO PA",10,10,3,2,5,10,-75.80335236,40.26465225
230,"BIRMINGHAM AL",10,454,111,133,210,454,-86.80226898,33.52098846
230,"BIRMINGHAM MI",10,14,1,5,8,14,-83.21121216,42.54697418
230,"BISBEE AZ",10,27,8,7,12,27,-109.9298477,31.44821548
230,"BISHOPVILLE SC",10,1,0,0,1,1,-80.24495697,34.21529007
230,"BISMARCK ND",10,7,3,1,3,7,-100.7789612,46.80673981
230,"BIXBY OK",10,12,3,4,5,12,-95.88382721,35.94215775
230,"BLACK MOUNTAIN NC",10,15,4,4,7,15,-82.32103729,35.61796188
230,"BLACKFOOT ID",10,11,4,3,4,11,-112.3463059,43.1905098
230,"BLACKSBURG SC",10,1,0,1,0,1,-81.51545715,35.12131882
230,"BLACKSBURG VA",10,48,13,16,19,48,-80.41369629,37.22999573
230,"BLAIR NE",10,4,0,2,2,4,-96.12560272,41.544384
230,"BLOOMFIELD NJ",10,3,1,1,1,3,-74.18488312,40.8069458
230,"BLOOMINGDALE NJ",10,1,0,1,0,1,-74.32588959,41.002285
230,"BLOOMINGTON IL",10,27,7,8,12,27,-88.99375916,40.48418045
230,"BLOOMINGTON IN",10,123,36,42,45,123,-86.53382874,39.16920471
230,"BLOOMINGTON MN",10,11,5,3,3,11,-93.29154205,44.82648849
230,"BLOOMSBURG PA",10,3,2,0,1,3,-76.45426178,41.00380325
230,"BLOSSBURG PA",10,2,0,0,2,2,-77.06325531,41.67986679
230,"BLUE EARTH MN",10,3,1,0,2,3,-94.1026535,43.63752365
230,"BLUE ISLAND IL",10,3,1,0,2,3,-87.67993927,41.657444
230,"BLUE SPRINGS MO",10,7,1,2,4,7,-94.2820816,39.01689148
230,"BLUEFIELD VA",10,1,0,1,0,1,-81.27105713,37.25265121
230,"BLUFF CITY TN",10,2,1,1,0,2,-82.26051331,36.47451019
230,"BLUFFTON SC",10,2,1,0,1,2,-80.86026001,32.23733902
230,"BOARDMAN OH",10,4,1,3,0,4,-80.66256714,41.02441788
230,"BOCA RATON FL",10,63,18,21,24,63,-80.08280182,26.35960197
230,"BOERNE TX",10,1,1,0,0,1,-98.73278046,29.79491997
230,"BOILING SPRINGS NC",10,4,1,0,3,4,-81.66678619,35.25450516
230,"BOLINGBROOK IL",10,39,4,24,11,39,-88.06878662,41.69866562
230,"BONHAM TX",10,4,0,2,2,4,-96.17896271,33.57743454
230,"BONIFAY FL",10,2,1,0,1,2,-85.67938995,30.79223824
230,"BONNEY LAKE WA",10,6,2,1,3,6,-122.1883698,47.17679596
230,"BOONE IA",10,2,1,0,1,2,-93.88450623,42.06530762
230,"BOONE NC",10,21,4,9,8,21,-81.67436218,36.21696472
230,"BOONES MILL VA",10,3,1,0,2,3,-79.9546051,37.11700821
230,"BOONEVILLE AR",10,1,0,1,0,1,-93.92186737,35.14023209
230,"BOONTON NJ",10,2,0,1,1,2,-74.4063797,40.90301514
230,"BOOTHBAY HARBOR ME",10,2,0,1,1,2,-69.62703705,43.85256958
230,"BORDENTOWN NJ",10,10,5,3,2,10,-74.7159729,40.15003586
230,"BOSSIER CITY LA",10,6,2,1,3,6,-93.73249817,32.51643753
230,"BOSTON MA",10,2610,653,805,1152,2610,-71.05905151,42.35883713
230,"BOTHELL WA",10,8,3,2,3,8,-122.2075424,47.75966263
230,"BOULDER CO",10,277,73,85,119,277,-105.2715302,40.01483917
230,"BOWIE MD",10,81,23,27,31,81,-76.77848816,39.00718689
230,"BOWLING GREEN KY",10,65,16,24,25,65,-86.4437027,36.99057388
230,"BOWLING GREEN OH",10,23,6,5,12,23,-83.65102386,41.37505341
230,"BOWMAN SC",10,2,1,0,1,2,-80.68243408,33.34929657
230,"BOYNTON BEACH FL",10,33,8,8,17,33,-80.066185,26.52592087
230,"BOYS TOWN NE",10,3,1,1,1,3,-96.13262177,41.26118088
230,"BOZEMAN MT",10,25,7,8,10,25,-111.0471649,45.6803093
230,"BRADENTON FL",10,14,2,6,6,14,-82.57459259,27.49969101
230,"BRADFORD PA",10,1,1,0,0,1,-78.64337921,41.95611572
230,"BRAINERD MN",10,1,0,0,1,1,-94.20135498,46.35787582
230,"BRANDON MS",10,18,5,4,9,18,-89.98616028,32.27327728
230,"BRANSON MO",10,8,2,4,2,8,-93.21912384,36.64381409
230,"BRANTLEY AL",10,2,0,0,2,2,-86.25697327,31.5824852
230,"BRATTLEBORO VT",10,1,0,0,1,1,-72.55673981,42.85120392
230,"BRAZORIA TX",10,2,1,0,1,2,-95.56978607,29.04499435
230,"BREA CA",10,1,1,0,0,1,-117.9015732,33.91663361
230,"BREAUX BRIDGE LA",10,3,0,1,2,3,-91.89958954,30.27367973
230,"BRECKENRIDGE CO",10,1,0,0,1,1,-106.0398636,39.48156357
230,"BREESE IL",10,1,0,1,0,1,-89.52734375,38.61071396
230,"BREMEN GA",10,1,1,0,0,1,-85.1452179,33.72130585
230,"BREMERTON WA",10,13,1,7,5,13,-122.6345291,47.56690598
230,"BRENHAM TX",10,2,0,1,1,2,-96.39807129,30.16748047
230,"BRENTWOOD CA",10,7,0,3,4,7,-121.6984329,37.93167496
230,"BRENTWOOD MO",10,1,0,0,1,1,-90.34931183,38.61766052
230,"BRENTWOOD TN",10,4,1,1,2,4,-86.78275299,36.03345108
230,"BREVARD NC",10,13,6,3,4,13,-82.73400116,35.23363113
230,"BREWTON AL",10,1,0,1,0,1,-87.07205963,31.10564423
230,"BRIARCLIFF MANOR NY",10,2,0,1,1,2,-73.82289886,41.14598846
230,"BRIDGE CITY TX",10,1,0,0,1,1,-93.84603882,30.02119064
230,"BRIDGEPORT CT",10,24,1,8,15,24,-73.2040863,41.16743088
230,"BRIDGETON MO",10,2,1,1,0,2,-90.41161346,38.76696396
230,"BRIDGETON NJ",10,9,6,2,1,9,-75.23321533,39.42769623
230,"BRIGHAM CITY UT",10,1,0,0,1,1,-112.0170517,41.50990677
230,"BRIGHTON CO",10,3,0,1,2,3,-104.8175278,39.97783661
230,"BRIGHTON IL",10,1,0,0,1,1,-90.14067841,39.03963089
230,"BRIGHTON MI",10,1,0,0,1,1,-83.78043365,42.52965546
230,"BRIGHTON NY",10,4,0,2,2,4,-77.57167816,43.12691116
230,"BRIGHTON TN",10,1,0,0,1,1,-89.72525787,35.48423386
230,"BRINSON GA",10,1,0,0,1,1,-84.73757935,30.9772625
230,"BRISTOL CT",10,33,12,9,12,33,-72.94853973,41.67193222
230,"BRISTOL RI",10,1,0,0,1,1,-71.26984406,41.67538452
230,"BRISTOL TN",10,33,4,8,21,33,-82.17338562,36.58886719
230,"BRISTOL VA",10,3,0,1,2,3,-82.18840027,36.59663391
230,"BROADVIEW HEIGHTS OH",10,1,0,1,0,1,-81.68503571,41.31410217
230,"BROADVIEW IL",10,3,0,3,0,3,-87.85337067,41.86410522
230,"BROADWAY VA",10,1,0,0,1,1,-78.7984314,38.61343002
230,"BROCK NE",10,6,0,3,3,6,-95.9602356,40.47987747
230,"BROCKPORT NY",10,5,2,2,1,5,-77.93889618,43.213871
230,"BROCKTON MA",10,14,3,4,7,14,-71.01748657,42.08340454
230,"BROKEN ARROW OK",10,20,6,6,8,20,-95.79160309,36.05273056
230,"BRONXVILLE NY",10,3,2,1,0,3,-73.83145905,40.93828583
230,"BROOK PARK OH",10,1,0,0,1,1,-81.80407715,41.39829636
230,"BROOKFIELD IL",10,7,1,2,4,7,-87.85184479,41.82412338
230,"BROOKFIELD WI",10,2,1,1,0,2,-88.10640717,43.06070328
230,"BROOKHAVEN MS",10,1,0,1,0,1,-90.44090271,31.57933807
230,"BROOKHAVEN PA",10,2,0,0,2,2,-75.38172913,39.8696785
230,"BROOKINGS OR",10,4,3,1,0,4,-124.2865219,42.05229187
230,"BROOKINGS SD",10,5,3,0,2,5,-96.79450989,44.3097229
230,"BROOKLINE MA",10,6,1,2,3,6,-71.12002563,42.33176804
230,"BROOKLYN PARK MN",10,16,5,3,8,16,-93.35662079,45.09407043
230,"BROOKNEAL VA",10,1,0,1,0,1,-78.94335937,37.05040741
230,"BROOKSIDE VILLAGE TX",10,5,0,3,2,5,-95.32555389,29.58737183
230,"BROOKSVILLE FL",10,7,2,2,3,7,-82.38734436,28.55600739
230,"BROOMFIELD CO",10,21,1,8,12,21,-105.0877686,39.92069244
230,"BROWN DEER WI",10,3,1,0,2,3,-87.96490479,43.16327667
230,"BROWNSTOWN IN",10,1,0,0,1,1,-86.04185486,38.87921143
230,"BROWNSVILLE OR",10,3,2,1,0,3,-122.9877396,44.39308929
230,"BROWNSVILLE PA",10,1,0,0,1,1,-79.88352966,40.02396393
230,"BROWNSVILLE TX",10,15,3,7,5,15,-97.4977951,25.90228081
230,"BROWNWOOD TX",10,1,0,1,0,1,-98.99180603,31.70943642
230,"BRUNSWICK GA",10,6,2,2,2,6,-81.49102783,31.1502285
230,"BRUNSWICK ME",10,6,0,4,2,6,-69.96412659,43.91474533
230,"BRUNSWICK OH",10,10,1,3,6,10,-81.84169769,41.23830795
230,"BRYAN OH",10,1,0,0,1,1,-84.54946899,41.47367859
230,"BRYAN TX",10,11,1,3,7,11,-96.3704071,30.67456818
230,"BRYANT AR",10,2,0,2,0,2,-92.48953247,34.59588242
230,"BUCHANAN MI",10,2,0,0,2,2,-86.3614502,41.82715225
230,"BUCKEYE AZ",10,4,0,2,2,4,-112.5852661,33.37036896
230,"BUCKHANNON WV",10,11,0,5,6,11,-80.22968292,38.99204254
230,"BUCYRUS OH",10,1,0,1,0,1,-82.97511292,40.80856323
230,"BUDA TX",10,5,1,1,3,5,-97.84067535,30.08543968
230,"BUENA PARK CA",10,12,1,6,5,12,-117.999939,33.86748123
230,"BUFFALO MN",10,1,0,0,1,1,-93.87721252,45.17856216
230,"BUFFALO NY",10,575,149,172,254,575,-78.87787628,42.8867836
230,"BUFORD GA",10,4,1,1,2,4,-84.00788879,34.11735535
230,"BULLHEAD CITY AZ",10,2,0,0,2,2,-114.5695648,35.1478157
230,"BUNKIE LA",10,1,0,0,1,1,-92.18289185,30.95348549
230,"BURBANK CA",10,72,19,12,41,72,-118.3104782,34.18065262
230,"BURIEN WA",10,4,2,1,1,4,-122.3500137,47.47027206
230,"BURLESON TX",10,3,1,1,1,3,-97.32151794,32.54247665
230,"BURLINGAME CA",10,3,0,1,2,3,-122.3685074,37.58408737
230,"BURLINGTON IA",10,2,1,0,1,2,-91.11296082,40.80773544
230,"BURLINGTON MA",10,3,2,0,1,3,-71.19434357,42.50506973
230,"BURLINGTON NC",10,1,0,0,1,1,-79.43729401,36.09585953
230,"BURLINGTON NJ",10,4,0,1,3,4,-74.86417389,40.07125092
230,"BURLINGTON VT",10,90,26,26,38,90,-73.20542908,44.47687531
230,"BURNS OR",10,2,2,0,0,2,-119.056221,43.58610153
230,"BURNSVILLE MN",10,4,1,0,3,4,-93.27822113,44.76760483
230,"BURTON MI",10,1,0,0,1,1,-83.59590912,43.02775955
230,"BUTLER IN",10,1,0,0,1,1,-84.8711853,41.42999649
230,"BUTLER PA",10,10,0,4,6,10,-79.89468384,40.86117172
230,"CACHE OK",10,2,1,0,1,2,-98.62905884,34.62960434
230,"CADILLAC MI",10,1,0,1,0,1,-85.401474,44.25179291
230,"CAHOKIA IL",10,4,0,1,3,4,-90.19016266,38.57118225
230,"CAIRO GA",10,15,5,4,6,15,-84.20102692,30.87791824
230,"CALABASAS CA",10,9,2,3,4,9,-118.6473236,34.1558876
230,"CALDWELL ID",10,2,0,1,1,2,-116.6891098,43.66285324
230,"CALDWELL KS",10,1,0,0,1,1,-97.60746002,37.03227997
230,"CALDWELL NJ",10,1,0,0,1,1,-74.27587128,40.83979797
230,"CALEDONIA MI",10,1,0,0,1,1,-85.51702118,42.78935623
230,"CALEDONIA NY",10,3,1,2,0,3,-77.85209656,42.97341919
230,"CALEDONIA WI",10,1,1,0,0,1,-87.92467499,42.80763245
230,"CALERA AL",10,7,1,2,4,7,-86.75354004,33.10300064
230,"CALEXICO CA",10,1,1,0,0,1,-115.500412,32.67900085
230,"CALHOUN GA",10,1,1,0,0,1,-84.95102692,34.50297165
230,"CALIFORNIA PA",10,1,0,1,0,1,-79.89154053,40.06599426
230,"CALIMESA CA",10,1,1,0,0,1,-117.0634689,34.00385666
230,"CALLAHAN FL",10,3,2,1,0,3,-81.83045959,30.56256294
230,"CALUMET CITY IL",10,5,1,3,1,5,-87.5293045,41.61571884
230,"CAMARILLO CA",10,55,19,14,22,55,-119.0400391,34.21628952
230,"CAMBRIDGE MA",10,299,75,101,123,299,-71.10369873,42.36532593
230,"CAMBRIDGE OH",10,54,31,7,16,54,-81.58615875,40.02525711
230,"CAMDEN AR",10,4,1,2,1,4,-92.83481598,33.58491898
230,"CAMDEN NJ",10,25,6,9,10,25,-75.118927,39.92608261
230,"CAMDEN SC",10,2,0,1,1,2,-80.60647583,34.24704742
230,"CAMDENTON MO",10,1,0,0,1,1,-92.74469757,38.00836182
230,"CAMP HILL PA",10,2,0,1,1,2,-76.9335022,40.24120331
230,"CAMPBELL CA",10,18,3,4,11,18,-121.951973,37.287117
230,"CAMPBELLSVILLE KY",10,1,1,0,0,1,-85.34185791,37.34331131
230,"CANAL FULTON OH",10,1,0,0,1,1,-81.59751129,40.88972473
230,"CANAL WINCHESTER OH",10,1,0,1,0,1,-82.80456543,39.84274673
230,"CANANDAIGUA NY",10,8,0,5,3,8,-77.28107452,42.88830948
230,"CANASTOTA NY",10,1,0,0,1,1,-75.75039673,43.07939529
230,"CANNON FALLS MN",10,1,0,1,0,1,-92.90566254,44.50691605
230,"CANONSBURG PA",10,1,0,1,0,1,-80.1868515,40.26278687
230,"CANTON GA",10,7,4,2,1,7,-84.48571014,34.23356628
230,"CANTON MS",10,1,0,0,1,1,-90.03672028,32.61313248
230,"CANTON NY",10,20,4,7,9,20,-75.16870117,44.59575272
230,"CANTON OH",10,62,14,23,25,62,-81.37824249,40.79906845
230,"CANTON TX",10,2,0,1,1,2,-95.86379242,32.55702591
230,"CAPE CANAVERAL FL",10,1,0,1,0,1,-80.60503387,28.4044838
230,"CAPE CORAL FL",10,15,1,2,12,15,-81.9491806,26.56343079
230,"CAPE ELIZABETH ME",10,2,0,2,0,2,-70.20044708,43.56402206
230,"CAPE GIRARDEAU MO",10,79,25,21,33,79,-89.51838684,37.30613327
230,"CAPE MAY NJ",10,11,4,2,5,11,-74.90522766,38.93513107
230,"CAPITOL HEIGHTS MD",10,9,1,2,6,9,-76.91506195,38.88552475
230,"CARBONDALE CO",10,1,0,1,0,1,-107.2127838,39.4022522
230,"CARBONDALE IL",10,30,12,6,12,30,-89.2168808,37.7274704
230,"CARBONDALE KS",10,2,1,0,1,2,-95.68982697,38.81850815
230,"CARENCRO LA",10,3,1,0,2,3,-92.04903412,30.31741714
230,"CARLISLE PA",10,14,2,5,7,14,-77.18848419,40.20173264
230,"CARLSBAD CA",10,20,11,4,5,20,-117.3528137,33.1580162
230,"CARLSBAD NM",10,3,0,1,2,3,-104.2350617,32.41680527
230,"CARMEL IN",10,2,0,1,1,2,-86.12607574,39.97961426
230,"CARMEL NY",10,2,0,1,1,2,-73.67949677,41.43042755
230,"CARO MI",10,1,0,1,0,1,-83.39698792,43.49111176
230,"CAROL STREAM IL",10,2,0,1,1,2,-88.13473511,41.91279221
230,"CARPENTERSVILLE IL",10,1,0,1,0,1,-88.25814056,42.12114716
230,"CARPINTERIA CA",10,1,0,1,0,1,-119.5201263,34.39894485
230,"CARRBORO NC",10,30,8,11,11,30,-79.07286835,35.91213989
230,"CARRIER MILLS IL",10,3,0,2,1,3,-88.63308716,37.68437576
230,"CARRIZO SPRINGS TX",10,5,1,1,3,5,-99.86119843,28.52256584
230,"CARROLLTON GA",10,5,0,2,3,5,-85.07631683,33.58019638
230,"CARROLLTON TX",10,13,2,7,4,13,-96.89080811,32.95380783
230,"CARSON CA",10,39,12,13,14,39,-118.2837448,33.8312645
230,"CARSON CITY NV",10,24,2,13,9,24,-119.7687988,39.16352844
230,"CARTERET NJ",10,5,0,2,3,5,-74.2276535,40.57754135
230,"CARTERSVILLE GA",10,7,2,1,4,7,-84.79982758,34.1654892
230,"CARTHAGE NY",10,1,1,0,0,1,-75.60883331,43.97806549
230,"CARTHAGE TX",10,2,1,0,1,2,-94.33757019,32.15785217
230,"CARY IL",10,1,1,0,0,1,-88.23856354,42.21179962
230,"CARY NC",10,45,22,13,10,45,-78.78055573,35.79200745
230,"CASA GRANDE AZ",10,15,1,8,6,15,-111.7590179,32.87965393
230,"CASCADE LOCKS OR",10,6,0,3,3,6,-121.8928452,45.66971588
230,"CASHION OK",10,1,1,0,0,1,-97.67902374,35.79806137
230,"CASPER WY",10,3,0,1,2,3,-106.3147507,42.86667633
230,"CASSVILLE MO",10,1,1,0,0,1,-93.86898804,36.67718124
230,"CASTLE ROCK CO",10,5,1,1,3,5,-104.857811,39.37207031
230,"CASTLE SHANNON PA",10,3,0,3,0,3,-80.021698,40.3650856
230,"CATHEDRAL CITY CA",10,6,2,3,1,6,-116.4663467,33.77960205
230,"CATLETTSBURG KY",10,1,0,0,1,1,-82.59997559,38.40486908
230,"CATOOSA OK",10,2,1,1,0,2,-95.74643707,36.18903351
230,"CATSKILL NY",10,2,0,2,0,2,-73.86399841,42.21760178
230,"CAVE CREEK AZ",10,8,3,2,3,8,-111.9523544,33.83345795
230,"CAZENOVIA NY",10,1,0,0,1,1,-75.85186005,42.93000031
230,"CEDAR CITY UT",10,2,0,1,1,2,-113.0635757,37.67730713
230,"CEDAR FALLS IA",10,3,0,1,2,3,-92.44594574,42.52773285
230,"CEDAR HILL TX",10,12,1,1,4,6,-99.08098985,33.36628723
230,"CEDAR RAPIDS IA",10,94,22,34,38,94,-91.66259766,41.98337555
230,"CEDARVILLE OH",10,1,0,0,1,1,-83.80859375,39.74424362
230,"CENTER LINE MI",10,5,1,2,2,5,-83.02747345,42.48490524
230,"CENTER POINT AL",10,1,0,1,0,1,-86.68362427,33.64584732
230,"CENTERVILLE IA",10,6,0,3,3,6,-92.87467957,40.73418045
230,"CENTERVILLE IN",10,1,0,0,1,1,-84.99629211,39.81794739
230,"CENTERVILLE OH",10,2,0,1,1,2,-84.15953064,39.6285553
230,"CENTRAL POINT OR",10,2,1,0,1,2,-122.918747,42.37548828
230,"CENTRAL SC",10,2,0,1,1,2,-82.78075409,34.72467041
230,"CENTRALIA IL",10,3,1,0,2,3,-89.13375092,38.52496719
230,"CENTRALIA WA",10,5,1,3,1,5,-122.9679337,46.71740723
230,"CENTRE AL",10,1,0,0,1,1,-85.67890167,34.15224838
230,"CENTREVILLE IL",10,1,1,0,0,1,-90.12549591,38.58330154
230,"CERES CA",10,8,2,2,4,8,-120.9599075,37.59457016
230,"CERRITOS CA",10,2,1,0,1,2,-118.0665054,33.85832214
230,"CHADRON NE",10,3,0,2,1,3,-102.9998169,42.83535004
230,"CHAMBERSBURG PA",10,3,0,2,1,3,-77.66046906,39.93768692
230,"CHAMPAIGN IL",10,135,33,43,59,135,-88.24346161,40.11659622
230,"CHAMPLIN MN",10,1,0,1,0,1,-93.39782715,45.18864059
230,"CHANDLER AZ",10,78,21,21,36,78,-111.8428345,33.3062439
230,"CHANDLER OK",10,1,1,0,0,1,-96.88135529,35.70169067
230,"CHANHASSEN MN",10,1,0,0,1,1,-93.53160858,44.86223221
230,"CHANUTE KS",10,2,2,0,0,2,-95.45789337,37.67946243
230,"CHAPEL HILL NC",10,124,35,36,53,124,-79.05697632,35.91110611
230,"CHARLES TOWN WV",10,1,1,0,0,1,-77.86264038,39.29033279
230,"CHARLESTON IL",10,2,0,2,0,2,-88.17610931,39.49612045
230,"CHARLESTON SC",10,413,98,130,185,413,-79.93032074,32.77671814
230,"CHARLESTON WV",10,177,36,49,92,177,-81.63149261,38.34872055
230,"CHARLOTTE NC",10,1362,319,428,615,1362,-80.84257507,35.22746277
230,"CHARLOTTE TX",10,1,0,0,1,1,-98.70683289,28.86248016
230,"CHARLOTTESVILLE VA",10,164,42,53,69,164,-78.49123383,38.03798676
230,"CHASKA MN",10,2,1,0,1,2,-93.60231781,44.78918457
230,"CHATHAM IL",10,2,2,0,0,2,-89.70467377,39.67619324
230,"CHATHAM NY",10,2,0,0,2,2,-73.59416199,42.3643074
230,"CHATSWORTH GA",10,2,1,1,0,2,-84.76963043,34.76615524
230,"CHATTANOOGA TN",10,159,33,51,75,159,-85.30583954,35.04058456
230,"CHECOTAH OK",10,3,1,1,1,3,-95.52338409,35.47038651
230,"CHEEKTOWAGA NY",10,6,2,2,2,6,-78.75413513,42.90357208
230,"CHELSEA AL",10,6,1,3,2,6,-86.63014984,33.34026718
230,"CHELSEA MA",10,1,0,0,1,1,-71.03151703,42.39189529
230,"CHELTENHAM PA",10,1,1,0,0,1,-75.09356689,40.06132126
230,"CHENEY WA",10,5,2,1,2,5,-117.5782547,47.48730087
230,"CHEROKEE AL",10,1,0,1,0,1,-87.97318268,34.75738144
230,"CHERRY HILL NJ",10,40,14,10,16,40,-75.03024292,39.93510437
230,"CHERRYFIELD ME",10,1,0,1,0,1,-67.92087555,44.60442734
230,"CHESAPEAKE VA",10,129,32,37,60,129,-76.27422333,36.81948853
230,"CHESTER NJ",10,2,2,0,0,2,-74.69606018,40.78449631
230,"CHESTER PA",10,6,1,1,4,6,-75.35475159,39.84973145
230,"CHESTER SC",10,9,4,2,3,9,-81.2141037,34.7049675
230,"CHESTERFIELD MO",10,32,8,7,17,32,-90.5772934,38.6631279
230,"CHESTERTOWN MD",10,5,2,0,3,5,-76.0662384,39.20907593
230,"CHEVERLY MD",10,1,0,0,1,1,-76.91530609,38.92858505
230,"CHEVY CHASE MD",10,14,4,4,6,14,-77.07595825,38.97138977
230,"CHEWELAH WA",10,5,2,2,1,5,-117.7169418,48.27609634
230,"CHEYENNE WY",10,17,2,7,8,17,-104.8183899,41.13345718
230,"CHICAGO IL",10,6127,1569,1826,2732,6127,-87.6503067,41.85000992
230,"CHICAGO RIDGE IL",10,4,1,1,2,4,-87.77906036,41.70148849
230,"CHICKAMAUGA GA",10,1,1,0,0,1,-85.29045105,34.87113571
230,"CHICO CA",10,94,22,37,35,94,-121.839447,39.72846222
230,"CHICOPEE MA",10,1,1,0,0,1,-72.60691071,42.14902496
230,"CHILLICOTHE MO",10,3,2,1,0,3,-93.55298615,39.79542542
230,"CHILLICOTHE OH",10,3,1,1,1,3,-82.98206329,39.33310699
230,"CHINA GROVE NC",10,4,1,0,3,4,-80.58115387,35.56945801
230,"CHINO CA",10,11,3,4,4,11,-117.6906662,34.0121727
230,"CHRISTIANSBURG VA",10,3,0,1,2,3,-80.40843201,37.1302948
230,"CHRISTOPHER IL",10,1,0,0,1,1,-89.05361938,37.97265244
230,"CHULA VISTA CA",10,123,26,43,54,123,-117.0857468,32.64037704
230,"CINCINNATI OH",10,588,160,151,277,588,-84.51939392,39.10413742
230,"CINNAMINSON NJ",10,1,0,1,0,1,-74.99165344,39.9969101
230,"CITRUS HEIGHTS CA",10,6,2,2,2,6,-121.2829208,38.70672607
230,"CLAREMONT CA",10,17,7,3,7,17,-117.7214508,34.09675217
230,"CLAREMONT NH",10,3,1,0,2,3,-72.33439636,43.37068939
230,"CLAREMORE OK",10,2,0,0,2,2,-95.61654663,36.31294632
230,"CLARION PA",10,3,0,1,2,3,-79.38504028,41.215065
230,"CLARKS SUMMIT PA",10,3,0,2,1,3,-75.70759583,41.48881531
230,"CLARKSBURG WV",10,4,1,2,1,4,-80.34414673,39.28092575
230,"CLARKSTON WA",10,1,0,1,0,1,-117.0472336,46.41588593
230,"CLARKSVILLE IN",10,1,0,0,1,1,-85.75987244,38.29683304
230,"CLARKSVILLE TN",10,27,9,5,13,27,-87.35944366,36.52993011
230,"CLAYTON CA",10,2,0,1,1,2,-121.938057,37.94074249
230,"CLAYTON MI",10,1,0,0,1,1,-84.23601532,41.86322021
230,"CLAYTON MO",10,2,0,2,0,2,-90.32382965,38.64260101
230,"CLAYTON NC",10,6,1,3,2,6,-78.45562744,35.6511879
230,"CLEAR LAKE SHORES TX",10,283,66,95,122,283,-95.03226471,29.54773712
230,"CLEARWATER FL",10,49,8,20,21,49,-82.79984283,27.9665451
230,"CLEBURNE TX",10,3,0,2,1,3,-97.38722992,32.34804535
230,"CLEMMONS NC",10,1,1,0,0,1,-80.38154602,36.02172089
230,"CLEMSON SC",10,9,3,1,5,9,-82.83683014,34.68382645
230,"CLEVELAND GA",10,1,0,0,1,1,-83.76287842,34.59722519
230,"CLEVELAND HEIGHTS OH",10,22,6,7,9,22,-81.55568695,41.52017975
230,"CLEVELAND OH",10,1894,485,576,833,1894,-81.69516754,41.49978256
230,"CLEVELAND TN",10,17,3,3,11,17,-84.87675476,35.15940094
230,"CLEVELAND TX",10,3,0,2,1,3,-95.08600616,30.34188652
230,"CLEWISTON FL",10,1,0,0,1,1,-80.93336487,26.75513649
230,"CLIFFSIDE PARK NJ",10,3,0,1,2,3,-73.98683167,40.82172394
230,"CLIFTON NJ",10,3,0,1,2,3,-74.16278076,40.85860062
230,"CLIFTON PARK NY",10,17,4,5,8,17,-73.76983643,42.8658638
230,"CLINTON IA",10,2,0,0,2,2,-90.19799042,41.84345627
230,"CLINTON IN",10,1,0,0,1,1,-87.39801025,39.65688324
230,"CLINTON MS",10,1,0,0,1,1,-90.33226776,32.34069061
230,"CLINTON NC",10,1,0,0,1,1,-78.32278442,34.99841309
230,"CLINTON OH",10,1,1,0,0,1,-81.62986755,40.92760849
230,"CLINTON SC",10,1,0,1,0,1,-81.88014984,34.47286224
230,"CLOQUET MN",10,1,1,0,0,1,-92.4598465,46.72146988
230,"CLOVER SC",10,1,0,0,1,1,-81.22589874,35.11135864
230,"CLOVIS CA",10,5,1,3,1,5,-119.7047043,36.82522583
230,"CLOVIS NM",10,5,0,0,5,5,-103.2067108,34.40181732
230,"COACHELLA CA",10,3,1,0,2,3,-116.1753616,33.68059158
230,"COATESVILLE PA",10,5,0,1,4,5,-75.82329559,39.98334885
230,"COCOA BEACH FL",10,18,4,3,11,18,-80.6068573,28.3203907
230,"COCOA FL",10,2,0,2,0,2,-80.74181366,28.38667297
230,"COEUR D'ALENE ID",10,9,1,5,3,9,-116.781929,47.67768478
230,"COHOES NY",10,1,1,0,0,1,-73.6990509,42.77442169
230,"COLDWATER OH",10,2,0,0,2,2,-84.6279068,40.47993851
230,"COLFAX CA",10,1,0,0,1,1,-120.9551468,39.10037994
230,"COLLEGE PARK GA",10,33,9,11,13,33,-84.44933319,33.65347672
230,"COLLEGE PARK MD",10,388,107,98,183,388,-76.93619537,38.98080444
230,"COLLEGE STATION TX",10,62,16,19,27,62,-96.33758545,30.62316895
230,"COLLEGEDALE TN",10,1,0,0,1,1,-85.05016327,35.0533371
230,"COLLEGEVILLE PA",10,1,0,0,1,1,-75.4506073,40.18598557
230,"COLLEYVILLE TX",10,1,1,0,0,1,-97.15543365,32.88101959
230,"COLLIERVILLE TN",10,4,0,2,2,4,-89.66448212,35.0423317
230,"COLLINGSWOOD NJ",10,2,0,0,2,2,-75.07028961,39.9186058
230,"COLLINSTON LA",10,1,0,0,1,1,-91.87198639,32.69124222
230,"COLLINSVILLE AL",10,3,2,0,1,3,-85.86063385,34.26427078
230,"COLLINSVILLE IL",10,51,12,12,27,51,-89.98478699,38.67050171
230,"COLMA CA",10,10,3,4,3,10,-122.4610977,37.67665482
230,"COLOMA MI",10,1,0,0,1,1,-86.30813599,42.18628693
230,"COLONIAL BEACH VA",10,1,0,1,0,1,-76.96711731,38.25397491
230,"COLONIE NY",10,6,3,2,1,6,-73.83889771,42.72444534
230,"COLORADO SPRINGS CO",10,212,54,68,90,212,-104.8225174,38.83369446
230,"COLTON CA",10,1,0,0,1,1,-117.3153687,34.0738945
230,"COLUMBIA HEIGHTS MN",10,2,1,0,1,2,-93.24828339,45.04322815
230,"COLUMBIA IL",10,11,2,3,6,11,-90.20130157,38.44375992
230,"COLUMBIA MO",10,343,89,101,153,343,-92.33429718,38.95169067
230,"COLUMBIA SC",10,434,123,117,194,434,-81.04045105,34.00138855
230,"COLUMBIA TN",10,10,3,5,2,10,-87.03533173,35.61502457
230,"COLUMBIAVILLE MI",10,2,0,2,0,2,-83.41014862,43.15683746
230,"COLUMBUS GA",10,132,26,39,67,132,-84.98313141,32.46828842
230,"COLUMBUS IN",10,11,3,2,6,11,-85.92284393,39.20959473
230,"COLUMBUS MS",10,17,1,6,10,17,-88.42742157,33.49581909
230,"COLUMBUS NC",10,1,1,0,0,1,-82.19678497,35.25350189
230,"COLUMBUS NE",10,4,1,1,2,4,-97.36936188,41.42973709
230,"COLUMBUS OH",10,1330,351,396,583,1330,-82.99890137,39.96136475
230,"COMBES TX",10,1,1,0,0,1,-97.73451233,26.24924469
230,"COMO MS",10,1,0,1,0,1,-89.94004822,34.51066208
230,"COMPTON CA",10,69,14,21,34,69,-118.2218704,33.89606857
230,"CONCORD CA",10,17,7,4,6,17,-122.0333328,37.97780228
230,"CONCORD NC",10,41,12,12,17,41,-80.57880402,35.4092598
230,"CONCORD NH",10,9,2,2,5,9,-71.53688812,43.20820999
230,"CONCORDIA MO",10,7,5,1,1,7,-93.56906128,38.98339462
230,"CONNEAUT OH",10,3,0,1,2,3,-80.55375671,41.94755936
230,"CONNELL WA",10,2,1,0,1,2,-118.863533,46.66334534
230,"CONNELLSVILLE PA",10,1,0,1,0,1,-79.58900452,40.01786041
230,"CONNERSVILLE IN",10,1,0,1,0,1,-85.13545227,39.64817047
230,"CONOVER NC",10,10,5,2,3,10,-81.21835327,35.70663834
230,"CONRAD IA",10,1,0,0,1,1,-92.87491608,42.22472
230,"CONROE TX",10,2,0,1,1,2,-95.45646667,30.31249237
230,"CONSHOHOCKEN PA",10,1,0,0,1,1,-75.30096436,40.07962418
230,"CONWAY AR",10,23,6,9,8,23,-92.4426651,35.08877563
230,"CONWAY SC",10,5,2,1,2,5,-79.04202271,33.83802795
230,"CONYERS GA",10,12,1,3,8,12,-84.0175705,33.66764832
230,"COOKEVILLE TN",10,15,2,6,7,15,-85.50189972,36.16290665
230,"COOLIDGE AZ",10,1,1,0,0,1,-111.5191727,32.9781456
230,"COON RAPIDS MN",10,6,2,3,1,6,-93.32348633,45.16527176
230,"COOPERSTOWN NY",10,2,0,1,1,2,-74.9236908,42.70100784
230,"COOS BAY OR",10,2,2,0,0,2,-124.219841,43.36757278
230,"COPPELL TX",10,2,0,1,1,2,-97.01548004,32.95487213
230,"COPPERAS COVE TX",10,4,1,2,1,4,-97.90343475,31.12462616
230,"CORAL GABLES FL",10,10,4,1,5,10,-80.26779938,25.72242165
230,"CORALVILLE IA",10,2,0,0,2,2,-91.58083344,41.6765976
230,"CORCORAN CA",10,1,0,0,1,1,-119.5620728,36.09794235
230,"CORDOVA AL",10,2,0,1,1,2,-87.18320465,33.75994492
230,"CORINTH MS",10,5,1,3,1,5,-88.52302551,34.93960571
230,"CORINTH TX",10,1,0,1,0,1,-99.87008667,32.85448456
230,"CORNELIUS NC",10,2,1,1,0,2,-80.85160828,35.48339462
230,"CORNERSVILLE TN",10,1,0,1,0,1,-86.83959198,35.36151505
230,"CORNING NY",10,6,3,1,2,6,-77.05406189,42.14312744
230,"CORONA CA",10,41,10,11,20,41,-117.5688171,33.87516785
230,"CORONADO CA",10,21,8,4,9,21,-117.1846619,32.6861763
230,"CORPUS CHRISTI TX",10,39,8,10,21,39,-97.42076874,27.77859879
230,"CORRALES NM",10,3,1,1,1,3,-106.6080399,35.23794174
230,"CORSICANA TX",10,3,1,1,1,3,-96.46954346,32.09554291
230,"CORTLAND NY",10,7,1,0,6,7,-76.17972565,42.60138702
230,"CORTLAND OH",10,2,2,0,0,2,-80.72497559,41.3302803
230,"CORVALLIS OR",10,36,9,10,17,36,-123.2646637,44.56417084
230,"COSTA MESA CA",10,12,0,2,10,12,-117.9204407,33.64131927
230,"COTATI CA",10,12,2,2,8,12,-122.7091904,38.32655334
230,"COTTAGE GROVE MN",10,4,1,2,1,4,-92.88017273,44.842556
230,"COTTONWOOD FALLS KS",10,1,0,0,1,1,-96.54312897,38.37212372
230,"COUNCIL BLUFFS IA",10,7,1,5,1,7,-95.86154938,41.26196289
230,"COUNCIL GROVE KS",10,5,1,0,4,5,-96.49236298,38.66096115
230,"COVINA CA",10,4,1,0,3,4,-117.8919067,34.09014511
230,"COVINGTON GA",10,9,0,3,6,9,-83.86009216,33.59708405
230,"COVINGTON KY",10,12,1,3,8,12,-84.50816345,39.08356476
230,"COVINGTON LA",10,3,0,2,1,3,-90.10121918,30.475914
230,"COVINGTON OK",10,1,1,0,0,1,-97.58732605,36.30782318
230,"COWARD SC",10,1,0,0,1,1,-79.74658966,33.97372055
230,"COWETA OK",10,3,0,0,3,3,-95.65141296,35.95218658
230,"COXSACKIE NY",10,1,0,1,0,1,-73.80188751,42.35128403
230,"CRANFORD NJ",10,1,1,0,0,1,-74.29885101,40.65885925
230,"CRANSTON RI",10,13,3,3,7,13,-71.43634033,41.77997971
230,"CRAWFORDSVILLE IN",10,2,0,0,2,2,-86.89406586,40.04439926
230,"CRESCENT CITY CA",10,1,0,0,1,1,-124.2048645,41.75559235
230,"CREST HILL IL",10,2,0,2,0,2,-88.09871674,41.55462646
230,"CRESTED BUTTE CO",10,1,1,0,0,1,-106.9887772,38.86982346
230,"CRESTLINE OH",10,1,1,0,0,1,-82.73641205,40.78746033
230,"CRESTON IA",10,3,1,0,2,3,-94.3616333,41.05845642
230,"CRESTVIEW FL",10,2,1,0,1,2,-86.57064819,30.76231766
230,"CRESTVIEW KY",10,7,2,4,1,7,-84.41716003,39.02523804
230,"CRESTWOOD KY",10,2,1,0,1,2,-85.47231293,38.32429123
230,"CRETE NE",10,1,0,0,1,1,-96.96214294,40.62769318
230,"CREVE COEUR MO",10,5,0,3,2,5,-90.42288971,38.66108322
230,"CROSS ROADS TX",10,1,1,0,0,1,-95.9679184,32.04952621
230,"CROSSVILLE TN",10,7,3,1,3,7,-85.0270462,35.9490509
230,"CROTON-ON-HUDSON NY",10,90,18,23,49,90,-73.89041901,41.2085762
230,"CROWLEY LA",10,1,1,0,0,1,-92.37494659,30.21465874
230,"CROWLEY TX",10,1,0,1,0,1,-97.36329651,32.57945633
230,"CROWN POINT IN",10,4,0,0,4,4,-87.36541748,41.41695023
230,"CRYSTAL LAKE IL",10,10,3,3,4,10,-88.3161087,42.2411499
230,"CRYSTAL MN",10,3,2,1,0,3,-93.36638641,45.05664063
230,"CRYSTAL RIVER FL",10,2,0,2,0,2,-82.59243011,28.90281487
230,"CUBA MO",10,1,0,0,1,1,-91.40387726,38.06311035
230,"CUERO TX",10,9,3,2,4,9,-97.28947449,29.09457397
230,"CULLMAN AL",10,3,1,1,1,3,-86.84370422,34.17510605
230,"CULPEPER VA",10,6,2,2,2,6,-77.99610901,38.47347641
230,"CUMBERLAND MD",10,2,1,0,1,2,-78.76217651,39.65284729
230,"CUMMING GA",10,4,1,1,2,4,-84.1401825,34.2074852
230,"CUPERTINO CA",10,27,7,10,10,27,-122.0342026,37.32306671
230,"CURRIE MN",10,1,1,0,0,1,-95.66686249,44.06391525
230,"CUSHING OK",10,3,1,1,1,3,-96.76766968,35.98506546
230,"CUT AND SHOOT TX",10,3,1,1,1,3,-95.35832214,30.33357811
230,"CUYAHOGA FALLS OH",10,92,21,30,41,92,-81.48397064,41.1338768
230,"CYPRESS CA",10,1,1,0,0,1,-118.0384903,33.81704712
230,"DACULA GA",10,5,1,2,2,5,-83.89762878,33.9887352
230,"DAHLONEGA GA",10,3,0,0,3,3,-83.98484802,34.53287125
230,"DALLAS GA",10,5,3,1,1,5,-84.84075165,33.92391586
230,"DALLAS PA",10,2,1,0,1,2,-75.96231842,41.33643723
230,"DALLAS TX",10,2538,618,741,1179,2538,-96.80088043,32.78369904
230,"DALTON GA",10,19,1,13,5,19,-84.97008514,34.76976776
230,"DALY CITY CA",10,26,7,7,12,26,-122.4645081,37.70376968
230,"DANBURY CT",10,4,0,3,1,4,-73.45310974,41.39499664
230,"DANFORTH ME",10,5,1,0,4,5,-67.86733246,45.66029358
230,"DANVILLE CA",10,4,1,1,2,4,-122.0023193,37.82156754
230,"DANVILLE IL",10,6,1,1,4,6,-87.62978363,40.12442398
230,"DANVILLE VA",10,21,6,6,9,21,-79.39437866,36.58641434
230,"DAPHNE AL",10,3,2,1,0,3,-87.90383148,30.60381317
230,"DARBY PA",10,1,1,0,0,1,-75.25850677,39.91879654
230,"DARLINGTON SC",10,2,1,0,1,2,-79.86645508,34.30082321
230,"DAVENPORT IA",10,33,8,11,14,33,-90.57814026,41.52380753
230,"DAVIDSON NC",10,3,2,0,1,3,-80.8433075,35.49843216
230,"DAVIE FL",10,19,4,7,8,19,-80.23148346,26.0657177
230,"DAVIS CA",10,28,9,4,15,28,-121.7421722,38.54467773
230,"DAVISON MI",10,1,0,0,1,1,-83.51786804,43.0346489
230,"DAWSONVILLE GA",10,1,1,0,0,1,-84.11881256,34.42126083
230,"DAYTON KY",10,13,4,2,7,13,-84.47278595,39.11274338
230,"DAYTON OH",10,326,76,105,145,326,-84.19126892,39.75915146
230,"DAYTON TN",10,1,1,0,0,1,-85.01251221,35.49424744
230,"DAYTON VA",10,19,0,11,8,19,-78.93834686,38.41519165
230,"DAYTONA BEACH FL",10,65,21,18,26,65,-81.02253723,29.21147537
230,"DE PERE WI",10,4,0,2,2,4,-88.06053925,44.4486618
230,"DE SOTO KS",10,5,0,2,3,5,-94.96877289,38.97918701
230,"DEARBORN HEIGHTS MI",10,5,0,1,4,5,-83.27328491,42.33712769
230,"DEARBORN MI",10,19,2,10,7,19,-83.1758728,42.32239914
230,"DECATUR AL",10,13,2,5,6,13,-86.98355103,34.60622406
230,"DECATUR AR",10,1,1,0,0,1,-94.46137238,36.33617401
230,"DECATUR GA",10,95,26,29,40,95,-84.29631805,33.77489471
230,"DECATUR IL",10,15,7,1,7,15,-88.95516968,39.84060287
230,"DECATUR IN",10,1,0,1,0,1,-84.93001556,40.82580566
230,"DEDHAM MA",10,8,1,3,4,8,-71.16512299,42.24193954
230,"DEEPHAVEN MN",10,1,0,1,0,1,-93.51553345,44.9361763
230,"DEER CREEK OK",10,3,1,2,0,3,-97.51993561,36.80317307
230,"DEER PARK TX",10,3,0,1,2,3,-95.1242981,29.70559502
230,"DEER PARK WA",10,3,0,2,1,3,-117.4789734,47.95389938
230,"DEERFIELD BEACH FL",10,10,1,6,3,10,-80.09928131,26.31905365
230,"DEERFIELD IL",10,5,0,4,1,5,-87.84490204,42.17103577
230,"DEL CITY OK",10,1,0,1,0,1,-97.44128418,35.44212723
230,"DEL MAR CA",10,11,2,3,6,11,-117.2663345,32.95969391
230,"DEL RIO TX",10,2,0,1,1,2,-100.8970642,29.36329842
230,"DELAVAN IL",10,3,0,1,2,3,-89.54736328,40.37273788
230,"DELAWARE OH",10,2,0,1,1,2,-83.06757355,40.29886627
230,"DELLWOOD MO",10,4,1,1,2,4,-90.28582001,38.74936295
230,"DELPHI IN",10,1,0,0,1,1,-86.67494202,40.58768845
230,"DELPHOS OH",10,1,0,1,0,1,-84.34170532,40.84327698
230,"DELRAY BEACH FL",10,11,4,2,5,11,-80.07209778,26.46233368
230,"DELTA CO",10,3,0,2,1,3,-108.0698395,38.74222946
230,"DELTONA FL",10,3,1,1,1,3,-81.25521088,28.90277863
230,"DEMING NM",10,7,0,1,6,7,-107.7599793,32.26507187
230,"DENMARK SC",10,1,1,0,0,1,-81.14172363,33.32278824
230,"DENTON NC",10,1,1,0,0,1,-80.1153183,35.63389587
230,"DENTON TX",10,142,31,42,69,142,-97.13349915,33.21514893
230,"DENVER CO",10,1730,454,545,731,1730,-104.9853745,39.73901749
230,"DEPEW NY",10,2,1,1,0,2,-78.69154358,42.90420532
230,"DERBY KS",10,4,1,0,3,4,-97.26980591,37.54567719
230,"DERRY NH",10,4,2,0,2,4,-71.32653809,42.88068008
230,"DES MOINES IA",10,217,63,65,89,217,-93.6210022,41.59817123
230,"DES MOINES WA",10,17,4,8,5,17,-122.3266525,47.40114594
230,"DES PERES MO",10,1,1,0,0,1,-90.43345642,38.60096741
230,"DES PLAINES IL",10,13,5,3,5,13,-87.8833847,42.03343964
230,"DESTIN FL",10,20,2,6,12,20,-86.49551392,30.39405632
230,"DETROIT MI",10,985,233,284,468,985,-83.04567719,42.33172226
230,"DETROIT TX",10,2,0,0,2,2,-95.26699829,33.66192245
230,"DEXTER MO",10,6,1,3,2,6,-89.95834351,36.79595947
230,"DIAMOND BAR CA",10,1,1,0,0,1,-117.8404999,33.97759247
230,"DIBBLE OK",10,1,0,0,1,1,-97.63038635,35.03363037
230,"DICKINSON ND",10,4,1,1,2,4,-102.7891007,46.87979889
230,"DICKINSON TX",10,1,1,0,0,1,-95.05158234,29.46142769
230,"DILLON MT",10,1,1,0,0,1,-112.6397934,45.21606064
230,"DILLON SC",10,6,1,4,1,6,-79.37909698,34.41096115
230,"DISTRICT HEIGHTS MD",10,5,3,2,0,5,-76.88869476,38.85776138
230,"DIXON CA",10,1,0,1,0,1,-121.8243713,38.44569778
230,"DOBBS FERRY NY",10,7,2,2,3,7,-73.87168121,41.01457977
230,"DOLTON IL",10,1,0,1,0,1,-87.6072998,41.63914108
230,"DONIPHAN MO",10,54,15,11,28,54,-90.82394409,36.62110138
230,"DONORA PA",10,2,0,2,0,2,-79.85721588,40.17367935
230,"DORAVILLE GA",10,1,0,0,1,1,-84.28286743,33.89825821
230,"DOTHAN AL",10,12,4,3,5,12,-85.39019775,31.22351265
230,"DOUGLAS GA",10,29,5,9,15,29,-82.84980011,31.50903511
230,"DOUGLASVILLE GA",10,22,6,6,10,22,-84.74777222,33.75165939
230,"DOUSMAN WI",10,1,0,0,1,1,-88.4726944,43.01404572
230,"DOVER DE",10,19,2,4,13,19,-75.52090454,39.15853882
230,"DOVER OH",10,1,0,0,1,1,-81.4782486,40.51688766
230,"DOYLESTOWN PA",10,34,8,12,14,34,-75.1292038,40.31054688
230,"DRAPER UT",10,1,0,0,1,1,-111.8741074,40.5280838
230,"DREW MS",10,2,1,1,0,2,-90.53083038,33.81049728
230,"DRIPPING SPRINGS TX",10,5,3,0,2,5,-98.08734131,30.19070816
230,"DU QUOIN IL",10,1,1,0,0,1,-89.2414856,38.01353455
230,"DUARTE CA",10,1,1,0,0,1,-117.9786072,34.13949966
230,"DUBLIN CA",10,45,13,11,21,45,-121.9383392,37.70181274
230,"DUBLIN GA",10,2,0,1,1,2,-82.90332794,32.540802
230,"DUBLIN VA",10,1,1,0,0,1,-80.68517303,37.10611343
230,"DUBUQUE IA",10,16,5,5,6,16,-90.67155457,42.51130295
230,"DULUTH MN",10,23,3,10,10,23,-92.10697174,46.78300858
230,"DUNBAR PA",10,6,2,0,4,6,-79.61539459,39.97570801
230,"DUNBAR WV",10,1,1,0,0,1,-81.73683167,38.36086655
230,"DUNCAN OK",10,1,1,0,0,1,-97.95820618,34.50245667
230,"DUNCANVILLE TX",10,7,4,2,1,7,-96.9091568,32.65229034
230,"DUNEDIN FL",10,7,3,3,1,7,-82.77127838,28.02050591
230,"DUNMORE PA",10,2,0,1,1,2,-75.63155365,41.42010117
230,"DUNN NC",10,1,0,0,1,1,-78.60855103,35.30678558
230,"DUNWOODY GA",10,1,1,0,0,1,-84.33460236,33.94631958
230,"DURANGO CO",10,21,3,8,10,21,-107.8810043,37.27463913
230,"DURANT OK",10,2,0,1,1,2,-96.37478638,33.99116135
230,"DURHAM NC",10,708,178,198,332,708,-78.89787292,35.99412918
230,"DURHAM NH",10,3,0,1,2,3,-70.92732239,43.13511276
230,"DUXBURY MA",10,1,0,1,0,1,-70.66990662,42.04032516
230,"EAGAN MN",10,24,8,8,8,24,-93.16746521,44.80387878
230,"EAGLE ID",10,3,2,0,1,3,-116.3559189,43.69528198
230,"EAGLE PASS TX",10,1,0,0,1,1,-100.5002899,28.70978737
230,"EAGLE RIVER WI",10,1,0,1,0,1,-89.24466705,45.91718674
230,"EAGLE WI",10,1,0,1,0,1,-88.4746933,42.87947083
230,"EARLE AR",10,4,0,2,2,4,-90.4671402,35.27531052
230,"EASLEY SC",10,2,0,0,2,2,-82.60394287,34.82990646
230,"EAST CHICAGO IN",10,4,0,2,2,4,-87.44509125,41.64970398
230,"EAST DUBLIN GA",10,3,1,0,2,3,-82.86959839,32.54988098
230,"EAST GREENWICH RI",10,11,3,5,3,11,-71.45487976,41.66058731
230,"EAST HAMPTON NY",10,2,0,1,1,2,-72.18353271,40.96551895
230,"EAST HARTFORD CT",10,4,0,0,4,4,-72.64693451,41.77160263
230,"EAST JORDAN MI",10,1,0,0,1,1,-85.1240921,45.15808868
230,"EAST LANSING MI",10,99,21,35,43,99,-84.48403931,42.73703384
230,"EAST LIVERPOOL OH",10,6,1,2,3,6,-80.57673645,40.61891556
230,"EAST MCKEESPORT PA",10,8,1,1,6,8,-79.80618286,40.38326645
230,"EAST MOLINE IL",10,2,0,0,2,2,-90.44459534,41.50070953
230,"EAST ORANGE NJ",10,65,20,21,24,65,-74.21418762,40.76618958
230,"EAST PALO ALTO CA",10,6,3,0,3,6,-122.143013,37.46857452
230,"EAST PEORIA IL",10,2,1,1,0,2,-89.58027649,40.66614151
230,"EAST POINT GA",10,35,7,6,22,35,-84.43933868,33.67996979
230,"EAST PROVIDENCE RI",10,3,2,0,1,3,-71.36916351,41.81398392
230,"EAST ROCHESTER NY",10,4,0,2,2,4,-77.48701477,43.1086731
230,"EAST TROY WI",10,1,0,1,0,1,-88.40551758,42.78525925
230,"EASTLAKE OH",10,2,0,1,1,2,-81.45001984,41.65415955
230,"EASTMAN GA",10,1,0,0,1,1,-83.17722321,32.19805527
230,"EASTON MD",10,2,1,1,0,2,-76.07592773,38.77448654
230,"EASTON PA",10,24,2,8,14,24,-75.21966553,40.68871689
230,"EATONTON GA",10,1,0,0,1,1,-83.38854218,33.32721329
230,"EAU CLAIRE WI",10,12,4,3,5,12,-91.49876404,44.81137466
230,"EDCOUCH TX",10,3,0,1,2,3,-97.96096802,26.29463768
230,"EDEN NC",10,1,1,0,0,1,-79.76634216,36.48883438
230,"EDEN PRAIRIE MN",10,13,4,4,5,13,-93.48716736,44.85310745
230,"EDGAR SPRINGS MO",10,1,0,0,1,1,-91.86699677,37.70466232
230,"EDINA MN",10,3,1,1,1,3,-93.34928131,44.91236496
230,"EDINA MO",10,8,2,2,4,8,-92.1732254,40.16763306
230,"EDINBORO PA",10,26,5,7,14,26,-80.13100433,41.87437439
230,"EDINBURG TX",10,9,2,1,6,9,-98.16417694,26.30259705
230,"EDMOND OK",10,45,11,17,17,45,-97.48453522,35.65326309
230,"EDMONDS WA",10,23,4,9,10,23,-122.3799057,47.81037521
230,"EDNA TX",10,5,2,2,1,5,-96.64674377,28.97920609
230,"EDWARDSVILLE IL",10,111,30,28,53,111,-89.95322418,38.8115654
230,"EFFINGHAM IL",10,6,2,2,2,6,-88.54359436,39.12008667
230,"EL CAJON CA",10,3,1,2,0,3,-116.9467392,32.83002472
230,"EL CENTRO CA",10,5,2,1,2,5,-115.5646057,32.79199982
230,"EL CERRITO CA",10,49,14,13,22,49,-122.3142548,37.91544342
230,"EL DORADO AR",10,2,0,1,1,2,-92.66680908,33.20800018
230,"EL DORADO KS",10,1,1,0,0,1,-96.86262512,37.81741714
230,"EL LAGO TX",10,23,7,9,7,23,-95.04547119,29.56394196
230,"EL MIRAGE AZ",10,2,1,0,1,2,-112.3263016,33.61337662
230,"EL MONTE CA",10,7,2,1,4,7,-118.0298996,34.06880569
230,"EL PASO TX",10,211,53,49,109,211,-106.4620514,31.78388405
230,"EL RENO OK",10,1,1,0,0,1,-97.95549011,35.53218842
230,"EL SEGUNDO CA",10,8,4,2,2,8,-118.4185257,33.91943741
230,"ELBA AL",10,1,0,0,1,1,-86.06761169,31.41489601
230,"ELDON MO",10,1,0,1,0,1,-92.58213806,38.34849548
230,"ELGIN IL",10,12,5,3,4,12,-88.28123474,42.03733444
230,"ELGIN SC",10,13,4,5,4,13,-80.79399872,34.17118073
230,"ELGIN TX",10,2,0,0,2,2,-97.37094879,30.34980202
230,"ELIOT ME",10,1,0,1,0,1,-70.79924774,43.15354538
230,"ELIZABETH CITY NC",10,7,2,5,0,7,-76.22274017,36.3025322
230,"ELIZABETH NJ",10,9,3,2,4,9,-74.21881866,40.66823578
230,"ELIZABETHTOWN KY",10,1,0,1,0,1,-85.85932159,37.69418716
230,"ELIZABETHTOWN NC",10,1,0,0,1,1,-78.60453796,34.629673
230,"ELIZABETHTOWN PA",10,2,0,0,2,2,-76.60209656,40.15314865
230,"ELK GROVE CA",10,340,100,110,130,340,-121.3743591,38.40848923
230,"ELK POINT SD",10,1,0,0,1,1,-96.68419647,42.68325424
230,"ELKINS WV",10,1,0,0,1,1,-79.85980225,38.92602921
230,"ELKO NV",10,6,2,1,3,6,-115.7643967,40.83226395
230,"ELKTON VA",10,1,0,1,0,1,-78.6230011,38.40836716
230,"ELLAVILLE GA",10,1,0,0,1,1,-84.30872345,32.23843384
230,"ELLENSBURG WA",10,11,1,4,6,11,-120.5507507,46.99611664
230,"ELLETTSVILLE IN",10,1,1,0,0,1,-86.62473297,39.23396301
230,"ELLIJAY GA",10,1,0,0,1,1,-84.48228455,34.69475937
230,"ELM GROVE WI",10,1,1,0,0,1,-88.07917786,43.04312515
230,"ELMHURST IL",10,1,1,0,0,1,-87.9407196,41.89970398
230,"ELMIRA NY",10,7,2,3,2,7,-76.80737305,42.08998108
230,"ELMWOOD IL",10,1,1,0,0,1,-89.96702576,40.77780151
230,"ELMWOOD PARK NJ",10,3,1,0,2,3,-74.1175766,40.90429306
230,"ELSBERRY MO",10,2,0,2,0,2,-90.78118896,39.16703796
230,"ELYRIA OH",10,30,5,11,14,30,-82.10734558,41.36825562
230,"EMERYVILLE CA",10,3,0,2,1,3,-122.2871475,37.83127975
230,"EMMAUS PA",10,11,3,7,1,11,-75.49610138,40.53958893
230,"EMPORIA KS",10,2,1,0,1,2,-96.18218994,38.40393448
230,"ENCINITAS CA",10,6,1,2,3,6,-117.2937012,33.0371666
230,"ENDICOTT NY",10,1,0,0,1,1,-76.04867554,42.09862137
230,"ENGLAND AR",10,2,0,0,2,2,-91.96916962,34.54467392
230,"ENGLEWOOD CO",10,3,0,0,3,3,-104.9884491,39.6479187
230,"ENGLEWOOD NJ",10,8,2,2,4,8,-73.97172546,40.8928833
230,"ENUMCLAW WA",10,1,0,0,1,1,-121.9936066,47.20384598
230,"EPHRAIM WI",10,1,0,0,1,1,-87.16837311,45.15630341
230,"EPHRATA PA",10,1,0,1,0,1,-76.17801666,40.17980194
230,"ERIE PA",10,60,19,16,25,60,-80.08492279,42.12926483
230,"ERLANGER KY",10,1,1,0,0,1,-84.60089111,39.01673508
230,"ERWIN TN",10,1,0,0,1,1,-82.41162109,36.15189362
230,"ESCANABA MI",10,5,1,2,2,5,-87.06468964,45.74517822
230,"ESCONDIDO CA",10,11,2,5,4,11,-117.0886231,33.11952591
230,"ESSEX JUNCTION VT",10,3,3,0,0,3,-73.11017609,44.49057007
230,"ESTERO FL",10,3,2,0,1,3,-81.80654144,26.43899536
230,"ESTES PARK CO",10,1,1,0,0,1,-105.5249558,40.37337112
230,"ESTILL SPRINGS TN",10,1,0,1,0,1,-86.12779999,35.27093887
230,"EUCLID OH",10,1,0,1,0,1,-81.52645111,41.59303284
230,"EUGENE OR",10,364,84,124,156,364,-123.0898361,44.05194855
230,"EULESS TX",10,26,4,8,14,26,-97.08273315,32.83728409
230,"EUREKA CA",10,2,0,2,0,2,-124.1653366,40.80156708
230,"EUREKA MO",10,9,0,4,5,9,-90.62799835,38.50252533
230,"EUTAW AL",10,1,1,0,0,1,-87.88775635,32.84085083
230,"EVANS CO",10,2,2,0,0,2,-104.6938095,40.37656403
230,"EVANSTON IL",10,56,12,18,26,56,-87.69037628,42.04132843
230,"EVANSTON WY",10,11,5,3,3,11,-110.9652634,41.26803589
230,"EVANSVILLE IN",10,38,13,10,15,38,-87.56850433,37.97795486
230,"EVERETT MA",10,19,3,9,7,19,-71.05252075,42.40878296
230,"EVERETT WA",10,58,12,23,23,58,-122.2045441,47.97843552
230,"EVERTON MO",10,1,1,0,0,1,-93.70294189,37.34272385
230,"EXETER CA",10,3,0,3,0,3,-119.1437607,36.29608917
230,"EXETER NH",10,4,1,2,1,4,-70.95800781,42.98471451
230,"FAIR GROVE MO",10,1,0,0,1,1,-93.15155792,37.38409424
230,"FAIR HAVEN NJ",10,9,5,2,2,9,-74.03659821,40.35977936
230,"FAIRBANKS AK",10,21,6,6,9,21,-147.7185669,64.83367157
230,"FAIRBORN OH",10,7,2,4,1,7,-84.01902771,39.82121658
230,"FAIRBURN GA",10,2,0,0,2,2,-84.58108521,33.56713867
230,"FAIRFAX VA",10,83,21,25,37,83,-77.30588531,38.84661865
230,"FAIRFIELD CA",10,20,6,7,7,20,-122.0420914,38.24917603
230,"FAIRFIELD CT",10,2,1,1,0,2,-73.26300049,41.14122772
230,"FAIRFIELD IA",10,1,0,1,0,1,-91.96311188,41.00863266
230,"FAIRFIELD OH",10,4,1,1,2,4,-84.56064606,39.34600449
230,"FAIRHAVEN MA",10,1,0,0,1,1,-70.902565,41.63794327
230,"FAIRMONT CITY IL",10,7,4,2,1,7,-90.09365845,38.65008545
230,"FAIRMONT WV",10,2,0,0,2,2,-80.14244843,39.48347473
230,"FAIRMOUNT GA",10,3,1,1,1,3,-84.69966888,34.43648911
230,"FAIRVIEW PA",10,4,0,2,2,4,-80.25499725,42.03170013
230,"FAIRVIEW PARK OH",10,2,0,1,1,2,-81.86431885,41.44171524
230,"FAIRVIEW TN",10,1,0,0,1,1,-87.12164307,35.98221207
230,"FALFURRIAS TX",10,1,0,0,1,1,-98.14491272,27.2275238
230,"FALL CREEK WI",10,1,0,1,0,1,-91.27741241,44.76337814
230,"FALL RIVER MA",10,5,0,3,2,5,-71.15414429,41.70151138
230,"FALLON NV",10,4,2,1,1,4,-118.7788696,39.47320557
230,"FALLS CHURCH VA",10,22,8,5,9,22,-77.17056274,38.88268661
230,"FARGO ND",10,101,21,37,43,101,-96.79805756,46.87498474
230,"FARIBAULT MN",10,1,0,0,1,1,-93.26953125,44.29466248
230,"FARMERS BRANCH TX",10,7,1,2,4,7,-96.89679718,32.92665482
230,"FARMINGDALE NY",10,2,1,0,1,2,-73.44436646,40.73298645
230,"FARMINGTON HILLS MI",10,29,10,11,8,29,-83.3771286,42.48558807
230,"FARMINGTON MI",10,5,1,2,2,5,-83.37620544,42.46465302
230,"FARMINGTON MN",10,5,1,2,2,5,-93.14386749,44.64002991
230,"FARMINGTON MO",10,4,1,1,2,4,-90.4220047,37.78110504
230,"FARMINGTON NH",10,2,0,1,1,2,-71.07139587,43.38951111
230,"FARMINGTON NM",10,5,0,1,4,5,-108.2051544,36.73355865
230,"FAYETTE MO",10,2,0,0,2,2,-92.68386078,39.14609146
230,"FAYETTE MS",10,1,1,0,0,1,-91.06066895,31.71204758
230,"FAYETTEVILLE AR",10,63,17,19,27,63,-94.15759277,36.06256104
230,"FAYETTEVILLE GA",10,3,0,2,1,3,-84.45489502,33.44916916
230,"FAYETTEVILLE NC",10,82,24,14,44,82,-78.87771606,35.05313873
230,"FAYETTEVILLE NY",10,1,0,1,0,1,-76.0059433,43.02997971
230,"FAYETTEVILLE TN",10,9,1,2,6,9,-86.57073212,35.15206146
230,"FAYETTEVILLE TX",10,1,0,0,1,1,-96.67340851,29.90643501
230,"FEDERAL WAY WA",10,35,9,11,15,35,-122.314415,47.32177734
230,"FEDERALSBURG MD",10,1,0,0,1,1,-75.77262115,38.69446945
230,"FELLSMERE FL",10,1,1,0,0,1,-80.59937286,27.77430344
230,"FENTON MI",10,6,1,1,4,6,-83.70490265,42.79768372
230,"FENTON MO",10,78,19,22,37,78,-90.43593597,38.51305771
230,"FERGUSON MO",10,220,54,70,96,220,-90.306633,38.74429321
230,"FERNDALE MI",10,33,5,9,19,33,-83.13441467,42.46089172
230,"FERNDALE WA",10,2,0,1,1,2,-122.5937119,48.84636688
230,"FERRIDAY LA",10,1,0,0,1,1,-91.55467224,31.63029099
230,"FESTUS MO",10,10,5,2,3,10,-90.39609528,38.22088623
230,"FILLMORE CA",10,1,0,0,1,1,-118.919754,34.39930344
230,"FINDLAY OH",10,1,0,1,0,1,-83.64990997,41.04424286
230,"FIREBAUGH CA",10,1,0,0,1,1,-120.4577408,36.85879517
230,"FISHERS IN",10,21,7,7,7,21,-86.0140152,39.95565414
230,"FITCHBURG MA",10,9,1,4,4,9,-71.79621124,42.58549881
230,"FITCHBURG WI",10,4,2,1,1,4,-89.47031403,42.96075439
230,"FITZGERALD GA",10,1,1,0,0,1,-83.25261688,31.71505928
230,"FLAGLER BEACH FL",10,7,2,2,3,7,-81.12680054,29.47527695
230,"FLAGSTAFF AZ",10,54,15,16,23,54,-111.6533051,35.19802475
230,"FLATWOODS KY",10,2,0,1,1,2,-82.71713257,38.52272797
230,"FLATWOODS WV",10,4,1,2,1,4,-80.64941406,38.7231369
230,"FLEMINGTON NJ",10,2,0,1,1,2,-74.85857391,40.51246643
230,"FLINT MI",10,128,30,34,64,128,-83.68744659,43.01246643
230,"FLORENCE AL",10,34,7,8,19,34,-87.67726898,34.7997818
230,"FLORENCE CO",10,21,6,4,11,21,-105.119751,38.39019012
230,"FLORENCE NJ",10,2,0,0,2,2,-74.80489349,40.11992264
230,"FLORENCE OR",10,1,1,0,0,1,-124.1027145,43.98227692
230,"FLORENCE SC",10,13,2,6,5,13,-79.76351166,34.19935226
230,"FLORESVILLE TX",10,2,2,0,0,2,-98.15641022,29.13393784
230,"FLORIDA CITY FL",10,1,0,1,0,1,-80.47893524,25.44846153
230,"FLORISSANT MO",10,109,27,30,52,109,-90.32299042,38.78946304
230,"FLOSSMOOR IL",10,4,1,1,2,4,-87.68474579,41.54309845
230,"FLOYD VA",10,2,2,0,0,2,-80.31944275,36.91149902
230,"FOND DU LAC WI",10,49,13,10,26,49,-88.44734955,43.77285004
230,"FONTANA CA",10,6,1,3,2,6,-117.4363785,34.09202576
230,"FOREST GROVE OR",10,1,0,0,1,1,-123.1123581,45.51952362
230,"FOREST PARK GA",10,1,0,0,1,1,-84.36103058,33.62044144
230,"FOREST PARK IL",10,1,0,0,1,1,-87.81355286,41.87948608
230,"FOREST PARK OH",10,2,0,2,0,2,-84.50376892,39.2902565
230,"FORKS WA",10,1,1,0,0,1,-124.3879929,47.94977951
230,"FORNEY TX",10,4,0,3,1,4,-96.47270966,32.74848175
230,"FORT ATKINSON WI",10,2,0,0,2,2,-88.83695984,42.92907715
230,"FORT COLLINS CO",10,162,43,37,82,162,-105.0858688,40.58546066
230,"FORT DODGE IA",10,1,1,0,0,1,-94.18049622,42.50019073
230,"FORT GIBSON OK",10,1,1,0,0,1,-95.25126648,35.79767609
230,"FORT LAUDERDALE FL",10,213,54,59,100,213,-80.14283752,26.12309074
230,"FORT LEE NJ",10,1,0,0,1,1,-73.96900177,40.85113907
230,"FORT LUPTON CO",10,8,4,3,1,8,-104.8086929,40.07614517
230,"FORT MILL SC",10,13,8,3,2,13,-80.94496155,35.00762558
230,"FORT MITCHELL KY",10,2,1,0,1,2,-84.54763031,39.05939865
230,"FORT MORGAN CO",10,1,0,1,0,1,-103.8019714,40.24989319
230,"FORT MYERS FL",10,33,7,14,12,33,-81.87184143,26.64133644
230,"FORT PIERCE FL",10,1,0,1,0,1,-80.32531738,27.44716644
230,"FORT SMITH AR",10,15,3,6,6,15,-94.39919281,35.3862114
230,"FORT STOCKTON TX",10,1,0,0,1,1,-102.8801041,30.89455986
230,"FORT VALLEY GA",10,1,0,1,0,1,-83.88742828,32.5541687
230,"FORT WALTON BEACH FL",10,5,1,1,3,5,-86.61834717,30.40767479
230,"FORT WAYNE IN",10,92,28,25,39,92,-85.13967896,41.07278061
230,"FORT WORTH TX",10,451,117,153,181,451,-97.32135773,32.72562027
230,"FOSTER CITY CA",10,1,0,0,1,1,-122.2733917,37.55817413
230,"FOUNTAIN INN SC",10,1,0,1,0,1,-82.20529175,34.69663239
230,"FRAMINGHAM MA",10,4,2,1,1,4,-71.41543579,42.27958298
230,"FRANKFORT IL",10,1,1,0,0,1,-87.8484726,41.49582291
230,"FRANKFORT KY",10,18,3,6,9,18,-84.87322235,38.20124054
230,"FRANKLIN IN",10,1,0,1,0,1,-86.05474854,39.48073578
230,"FRANKLIN LA",10,3,1,0,2,3,-91.50192261,29.79652786
230,"FRANKLIN NC",10,3,1,1,1,3,-83.38106537,35.17907715
230,"FRANKLIN NH",10,1,0,1,0,1,-71.64609528,43.44426346
230,"FRANKLIN TN",10,21,5,7,9,21,-86.87760162,35.92164993
230,"FREDERICK MD",10,40,11,12,17,40,-77.40981293,39.41444397
230,"FREDERICKSBURG VA",10,9,2,2,5,9,-77.45996094,38.30348969
230,"FREDONIA NY",10,2,1,1,0,2,-79.33128357,42.4403038
230,"FREDONIA WI",10,1,0,1,0,1,-87.95108032,43.47070694
230,"FREEBURG IL",10,1,1,0,0,1,-89.91384888,38.42782593
230,"FREEHOLD NJ",10,5,0,1,4,5,-74.27283478,40.26020432
230,"FREEPORT IL",10,21,3,8,10,21,-89.62126923,42.29691696
230,"FREEPORT NY",10,11,2,4,5,11,-73.58229065,40.65803146
230,"FREEPORT TX",10,2,0,0,2,2,-95.35985565,28.95484543
230,"FREMONT CA",10,106,33,13,60,106,-121.9740372,37.55101776
230,"FREMONT NE",10,2,1,1,0,2,-96.49893188,41.43340683
230,"FREMONT OH",10,5,1,4,0,5,-83.12195587,41.35057831
230,"FRESNO CA",10,224,37,86,101,224,-119.7739868,36.74755478
230,"FRIDLEY MN",10,10,3,3,4,10,-93.2636261,45.08617401
230,"FRIENDSWOOD TX",10,5,0,1,4,5,-95.20127106,29.53010368
230,"FRISCO CO",10,2,0,2,0,2,-106.0990143,39.57444763
230,"FRISCO TX",10,40,14,10,16,40,-96.82434082,33.15098572
230,"FRITCH TX",10,1,1,0,0,1,-101.6041031,35.63983154
230,"FRONT ROYAL VA",10,9,4,3,2,9,-78.19395447,38.91853714
230,"FROSTBURG MD",10,1,1,0,0,1,-78.92780304,39.65832138
230,"FULLERTON CA",10,37,4,18,15,37,-117.9268646,33.87014771
230,"FULTON MO",10,2,0,1,1,2,-91.94814301,38.84679031
230,"GADSDEN AL",10,8,1,3,4,8,-86.00675201,34.01457596
230,"GAFFNEY SC",10,1,1,0,0,1,-81.64937592,35.07206345
230,"GAHANNA OH",10,1,0,1,0,1,-82.87860107,40.02072525
230,"GAINESVILLE FL",10,139,29,43,67,139,-82.32462311,29.65203285
230,"GAINESVILLE GA",10,15,2,4,9,15,-83.82389832,34.29787827
230,"GAITHERSBURG MD",10,35,8,13,14,35,-77.20072174,39.14352417
230,"GALESBURG IL",10,20,5,1,14,20,-90.37152863,40.9480629
230,"GALLATIN TN",10,1,0,0,1,1,-86.44691467,36.38848495
230,"GALVESTON IN",10,1,1,0,0,1,-86.19012451,40.57881165
230,"GALVESTON TX",10,52,10,17,25,52,-94.79576111,29.30070114
230,"GARDEN CITY ID",10,6,2,2,2,6,-116.2400971,43.62173462
230,"GARDEN CITY KS",10,2,0,1,1,2,-100.8735352,37.97177505
230,"GARDEN GROVE CA",10,15,4,5,6,15,-117.943718,33.77397156
230,"GARDENA CA",10,12,1,7,4,12,-118.3105164,33.88837814
230,"GARDENDALE AL",10,1,0,0,1,1,-86.81273651,33.66012192
230,"GARDINER ME",10,3,0,2,1,3,-69.77404785,44.23034286
230,"GARDNER KS",10,11,3,4,4,11,-94.92789459,38.81066132
230,"GARFIELD NJ",10,2,1,0,1,2,-74.11222839,40.88159561
230,"GARLAND TX",10,19,6,5,8,19,-96.63926697,32.91297531
230,"GARNER NC",10,10,1,5,4,10,-78.61359406,35.71166992
230,"GARRETT IN",10,12,1,3,8,12,-85.13555908,41.3495636
230,"GARY IN",10,30,9,11,10,30,-87.33873749,41.59325409
230,"GAS CITY IN",10,2,0,0,2,2,-85.61326599,40.48720932
230,"GASTON OR",10,1,1,0,0,1,-123.141571,45.43574142
230,"GASTONIA NC",10,42,15,6,21,42,-81.18706512,35.26216507
230,"GATESVILLE TX",10,1,0,0,1,1,-97.74459839,31.43569565
230,"GATLINBURG TN",10,1,0,0,1,1,-83.50972748,35.71463394
230,"GAYLORD MI",10,8,0,5,3,8,-84.67483521,45.02762222
230,"GENESEO NY",10,3,0,1,2,3,-77.81667328,42.79621887
230,"GENEVA IL",10,6,4,0,2,6,-88.30541992,41.8876915
230,"GENEVA NY",10,5,2,0,3,5,-76.97723389,42.86890793
230,"GENEVA OH",10,1,0,0,1,1,-80.94763184,41.80530167
230,"GENOA CITY WI",10,6,4,0,2,6,-88.32978821,42.49824905
230,"GEORGETOWN KY",10,8,1,1,6,8,-84.55860138,38.21012115
230,"GEORGETOWN OH",10,1,0,0,1,1,-83.90393066,38.86468124
230,"GEORGETOWN TX",10,14,3,8,3,14,-97.67801666,30.6329689
230,"GERMANTOWN OH",10,1,0,0,1,1,-84.36915588,39.62649536
230,"GERMANTOWN TN",10,4,0,1,3,4,-89.80731201,35.08958817
230,"GERMANTOWN WI",10,8,2,3,3,8,-88.1105423,43.22859573
230,"GETTYSBURG PA",10,8,2,3,3,8,-77.23023224,39.83097076
230,"GIG HARBOR WA",10,13,1,4,8,13,-122.590683,47.32983398
230,"GILBERT AZ",10,43,8,12,23,43,-111.7899933,33.35302353
230,"GILROY CA",10,3,1,0,2,3,-121.570343,37.00583267
230,"GIRARD IL",10,1,0,0,1,1,-89.78087616,39.44666672
230,"GLADSTONE MO",10,8,3,2,3,8,-94.55509186,39.20398331
230,"GLASGOW KY",10,21,4,9,8,21,-85.91189575,36.99584961
230,"GLASSBORO NJ",10,22,6,5,11,22,-75.11103058,39.70306778
230,"GLEASON TN",10,1,0,1,0,1,-88.61263275,36.21385193
230,"GLEN ELLYN IL",10,2,1,1,0,2,-88.06699371,41.87755585
230,"GLENCOE IL",10,1,0,0,1,1,-87.75849152,42.13492203
230,"GLENCOE MN",10,7,2,3,2,7,-94.15203094,44.76893234
230,"GLENDALE AZ",10,14,4,5,5,14,-112.1871796,33.5386467
230,"GLENDALE CA",10,117,32,24,61,117,-118.2566681,34.1423645
230,"GLENDALE HEIGHTS IL",10,1,1,0,0,1,-88.07187653,41.91030502
230,"GLENDIVE MT",10,1,0,1,0,1,-104.7115021,47.11004257
230,"GLENDORA CA",10,2,0,0,2,2,-117.8665314,34.13615417
230,"GLENOLDEN PA",10,1,0,0,1,1,-75.28848267,39.90028
230,"GLENVIEW IL",10,2,0,1,1,2,-87.78792572,42.06991196
230,"GLENWOOD MN",10,1,0,0,1,1,-95.39015961,45.65030289
230,"GLENWOOD SPRINGS CO",10,1,0,0,1,1,-107.3256455,39.55069733
230,"GLOBE AZ",10,2,0,1,1,2,-110.7881393,33.3945961
230,"GLOUCESTER CITY NJ",10,9,2,2,5,9,-75.11563873,39.89209747
230,"GLOUCESTER MA",10,1,0,1,0,1,-70.66117096,42.61589432
230,"GODFREY IL",10,6,1,3,2,6,-90.18669891,38.95780182
230,"GOLDEN CO",10,3,2,1,0,3,-105.2226791,39.75567627
230,"GOLDEN VALLEY MN",10,12,5,4,3,12,-93.33234406,44.98583603
230,"GOLDENDALE WA",10,2,0,2,0,2,-120.8248444,45.82035828
230,"GOLDFIELD IA",10,1,0,0,1,1,-93.92066193,42.73672485
230,"GOLDSBORO NC",10,7,2,2,3,7,-77.99216461,35.38506317
230,"GOLETA CA",10,1,0,0,1,1,-119.8299332,34.43574142
230,"GOODLAND KS",10,2,1,0,1,2,-101.7115326,39.35073471
230,"GOODRICH TX",10,11,2,4,5,11,-94.9467926,30.60574341
230,"GORDONSVILLE TN",10,1,1,0,0,1,-85.92985535,36.17253113
230,"GORHAM NH",10,2,1,0,1,2,-71.17190552,44.38262939
230,"GOSHEN IN",10,7,2,3,2,7,-85.8345871,41.58250046
230,"GRAFTON IL",10,2,1,1,0,2,-90.43186188,38.97026443
230,"GRAMBLING LA",10,3,1,1,1,3,-92.71523285,32.52869415
230,"GRANBURY TX",10,2,1,0,1,2,-97.79492187,32.44239044
230,"GRAND BLANC MI",10,6,1,2,3,6,-83.62955475,42.92750168
230,"GRAND FORKS ND",10,20,3,8,9,20,-97.03855133,47.92044067
230,"GRAND HAVEN MI",10,2,0,2,0,2,-86.22866058,43.06328964
230,"GRAND ISLAND NE",10,3,0,2,1,3,-98.34256744,40.92502213
230,"GRAND JUNCTION CO",10,15,3,6,6,15,-108.5520706,39.06374741
230,"GRAND MARAIS MN",10,1,0,1,0,1,-90.33486176,47.75009918
230,"GRAND PRAIRIE TX",10,56,17,17,22,56,-96.99823761,32.74625015
230,"GRAND RAPIDS MI",10,267,63,92,112,267,-85.66797638,42.96317291
230,"GRANDVIEW MO",10,7,5,1,1,7,-94.53369904,38.88563538
230,"GRANDVILLE MI",10,1,0,1,0,1,-85.76309204,42.90962982
230,"GRANGER WA",10,1,0,0,1,1,-120.1894989,46.34181976
230,"GRANITE CITY IL",10,108,23,32,53,108,-90.14891815,38.70147705
230,"GRANTS PASS OR",10,13,1,6,6,13,-123.3306351,42.43851471
230,"GRANVILLE IL",10,1,0,0,1,1,-89.2277298,41.26108932
230,"GRAPEVINE TX",10,40,8,11,21,40,-97.07859802,32.93464279
230,"GRASS VALLEY CA",10,3,0,1,2,3,-121.0632553,39.21873856
230,"GRAY COURT SC",10,1,1,0,0,1,-82.11286926,34.60851669
230,"GRAY GA",10,20,3,8,9,20,-83.53361511,33.00989532
230,"GRAYSLAKE IL",10,3,0,1,2,3,-88.04187775,42.34467697
230,"GREAT BARRINGTON MA",10,2,1,1,0,2,-73.36142731,42.19623566
230,"GREAT BEND KS",10,6,0,0,6,6,-98.76521301,38.36428452
230,"GREAT FALLS MT",10,2,0,1,1,2,-111.2823257,47.50692368
230,"GREAT NECK NY",10,2,0,1,1,2,-73.72780609,40.80078125
230,"GREECE NY",10,8,4,1,3,8,-77.69234467,43.21003342
230,"GREELEY CO",10,14,3,4,7,14,-104.7104645,40.42345047
230,"GREEN BAY WI",10,58,22,16,20,58,-88.01370239,44.51335907
230,"GREEN FOREST AR",10,1,0,1,0,1,-93.43527985,36.3351593
230,"GREENBELT MD",10,43,14,13,16,43,-76.87561035,39.00544357
230,"GREENDALE WI",10,1,0,0,1,1,-87.99612427,42.94078827
230,"GREENEVILLE TN",10,15,3,0,12,15,-82.83133698,36.16376495
230,"GREENFIELD IN",10,3,1,1,1,3,-85.76914978,39.78491974
230,"GREENFIELD OH",10,1,1,0,0,1,-83.38262939,39.35222244
230,"GREENFIELD WI",10,1,1,0,0,1,-88.01258087,42.96144104
230,"GREENSBORO NC",10,247,64,68,115,247,-79.79152679,36.0729599
230,"GREENSBURG IN",10,2,0,1,1,2,-85.48336792,39.33731842
230,"GREENSBURG PA",10,11,1,3,7,11,-79.53821564,40.30168915
230,"GREENVILLE IL",10,2,0,0,2,2,-89.41333008,38.89213562
230,"GREENVILLE MS",10,3,2,0,1,3,-91.05704498,33.40253448
230,"GREENVILLE NC",10,36,11,5,20,36,-77.37215424,35.61170959
230,"GREENVILLE OH",10,2,1,0,1,2,-84.63294983,40.10294342
230,"GREENVILLE PA",10,4,0,3,1,4,-80.39095306,41.40464401
230,"GREENVILLE SC",10,267,65,81,121,267,-82.39870453,34.84753418
230,"GREENVILLE TX",10,4,1,2,1,4,-96.11412811,33.13861084
230,"GREENWICH CT",10,24,3,6,15,24,-73.62783051,41.02645111
230,"GREENWOOD IN",10,21,3,8,10,21,-86.10647583,39.61371994
230,"GREENWOOD MS",10,2,0,1,1,2,-90.17974091,33.51645279
230,"GREENWOOD SC",10,10,2,2,6,10,-82.16146088,34.19546509
230,"GREENWOOD VILLAGE CO",10,1,0,0,1,1,-104.9518585,39.61724091
230,"GREER SC",10,2,0,1,1,2,-82.22647095,34.9389267
230,"GRENADA MS",10,2,1,1,0,2,-89.80857849,33.76926804
230,"GRESHAM OR",10,22,7,10,5,22,-122.4333954,45.4980278
230,"GRETNA LA",10,4,0,2,2,4,-90.05435181,29.91518021
230,"GRETNA NE",10,2,0,1,1,2,-96.24054718,41.14088058
230,"GRETNA VA",10,1,0,1,0,1,-79.35816193,36.95412445
230,"GRIDLEY IL",10,1,0,0,1,1,-88.88149261,40.74357605
230,"GRIFFIN GA",10,2,2,0,0,2,-84.26403046,33.24713135
230,"GRINNELL IA",10,4,1,3,0,4,-92.72964478,41.7466507
230,"GROSSE POINTE PARK MI",10,1,1,0,0,1,-82.93411255,42.37599182
230,"GROSSE POINTE WOODS MI",10,4,2,0,2,4,-82.90637207,42.4438858
230,"GROTON CT",10,25,11,7,7,25,-72.07763672,41.3502121
230,"GROTON MA",10,1,1,0,0,1,-71.55770874,42.60856247
230,"GROTON NY",10,2,0,1,1,2,-76.36643982,42.58802032
230,"GROVE CITY OH",10,1,1,0,0,1,-83.09304047,39.88161087
230,"GROVEPORT OH",10,1,0,1,0,1,-82.88549805,39.8524971
230,"GUADALUPE CA",10,1,0,0,1,1,-120.5658035,34.94911575
230,"GULF BREEZE FL",10,3,0,1,2,3,-87.16386414,30.35763931
230,"GULF SHORES AL",10,4,2,1,1,4,-87.70103455,30.24625969
230,"GULFPORT FL",10,36,11,6,19,36,-82.70953369,27.74733734
230,"GULFPORT MS",10,27,4,9,14,27,-89.09369659,30.37276649
230,"GUNTERSVILLE AL",10,8,2,2,4,8,-86.29457855,34.3585434
230,"GUNTOWN MS",10,1,0,0,1,1,-88.66011047,34.44345093
230,"GURNEE IL",10,2,0,1,1,2,-87.90226746,42.37029648
230,"GUSTINE CA",10,2,1,1,0,2,-121.001297,37.25769043
230,"GUTHRIE OK",10,3,2,0,1,3,-97.42609406,35.87893677
230,"GUYTON GA",10,1,0,0,1,1,-81.3910675,32.3367691
230,"GYPSUM CO",10,8,0,1,7,8,-106.9528198,39.64703369
230,"HACKENSACK NJ",10,15,2,10,3,15,-74.04291534,40.88635254
230,"HADDON HEIGHTS NJ",10,1,0,0,1,1,-75.06397247,39.87737656
230,"HADDONFIELD NJ",10,42,9,12,21,42,-75.03710937,39.89155197
230,"HAGERSTOWN MD",10,5,2,1,2,5,-77.71956635,39.641819
230,"HAINES CITY FL",10,9,2,3,4,9,-81.61740875,28.1145668
230,"HALF MOON BAY CA",10,5,0,0,5,5,-122.4299774,37.46336365
230,"HALLSTEAD PA",10,9,1,4,4,9,-75.74239349,41.96153259
230,"HALLSVILLE MO",10,3,1,0,2,3,-92.22124481,39.11693573
230,"HALLSVILLE TX",10,1,1,0,0,1,-94.57429504,32.50448608
230,"HALSTEAD KS",10,1,0,0,1,1,-97.50925446,38.00158691
230,"HAMBURG NY",10,1,0,1,0,1,-78.82896423,42.71609879
230,"HAMDEN CT",10,11,1,7,3,11,-72.89596558,41.39611816
230,"HAMILTON NJ",10,2,0,1,1,2,-74.0803299,40.20712662
230,"HAMILTON NY",10,1,0,1,0,1,-75.54386902,42.82725906
230,"HAMILTON OH",10,2,0,0,2,2,-84.56098175,39.39949799
230,"HAMMOND IN",10,3,0,2,1,3,-87.50006104,41.58346558
230,"HAMMOND LA",10,10,3,1,6,10,-90.46140289,30.50458908
230,"HAMPSHIRE IL",10,1,0,1,0,1,-88.53064728,42.09803772
230,"HAMPSTEAD MD",10,1,0,1,0,1,-76.84955597,39.60499191
230,"HAMPTON IA",10,1,0,0,1,1,-93.20288849,42.74206924
230,"HAMPTON NH",10,2,1,1,0,2,-70.83818054,42.93779373
230,"HAMPTON VA",10,71,26,19,26,71,-76.34473419,37.03002548
230,"HAMTRAMCK MI",10,1,0,0,1,1,-83.04947662,42.39274597
230,"HANNIBAL MO",10,1,0,0,1,1,-91.35847473,39.70859146
230,"HANOVER NH",10,6,4,1,1,6,-72.28845215,43.70233917
230,"HANOVER PARK IL",10,8,0,2,6,8,-88.14541626,41.99964905
230,"HAPEVILLE GA",10,1,0,1,0,1,-84.41027069,33.66032791
230,"HARBOR SPRINGS MI",10,6,3,0,3,6,-84.99181366,45.43172455
230,"HARKER HEIGHTS TX",10,6,1,3,2,6,-97.66394806,31.08788109
230,"HARLAN KY",10,2,1,1,0,2,-83.32141113,36.84322739
230,"HARLINGEN TX",10,29,10,11,8,29,-97.69669342,26.19152069
230,"HARPERS FERRY WV",10,1,0,0,1,1,-77.7372818,39.32528687
230,"HARRAH OK",10,2,1,0,1,2,-97.1640625,35.48944855
230,"HARRISBURG PA",10,95,24,32,39,95,-76.88382721,40.27407455
230,"HARRISBURG SD",10,1,0,0,1,1,-96.69753265,43.4300499
230,"HARRISON OH",10,1,0,0,1,1,-84.81867981,39.26198959
230,"HARRISONBURG VA",10,82,19,27,36,82,-78.86815643,38.44975281
230,"HARRISTOWN IL",10,1,0,1,0,1,-89.08389282,39.85378647
230,"HARRODSBURG KY",10,1,0,1,0,1,-84.84320068,37.76233673
230,"HARROGATE TN",10,1,0,1,0,1,-83.65833282,36.57839203
230,"HARTFORD CITY IN",10,1,0,0,1,1,-85.36962128,40.45125198
230,"HARTFORD CT",10,110,33,29,48,110,-72.68445587,41.76383591
230,"HARTFORD KY",10,1,1,0,0,1,-86.90929413,37.45124435
230,"HARTSVILLE SC",10,40,9,12,19,40,-80.07303619,34.37445068
230,"HARTVILLE OH",10,4,2,0,2,4,-81.33060455,40.96377563
230,"HARVEY IL",10,3,1,0,2,3,-87.64677429,41.61020279
230,"HASTINGS-ON-HUDSON NY",10,1,0,1,0,1,-73.87804413,41.00286102
230,"HASTINGS FL",10,1,0,0,1,1,-81.5078125,29.71843338
230,"HASTINGS MN",10,8,3,1,4,8,-92.85280609,44.7434082
230,"HASTINGS NE",10,5,3,0,2,5,-98.38917542,40.58628845
230,"HATTIESBURG MS",10,52,12,11,29,52,-89.29040527,31.32738686
230,"HAVELOCK NC",10,1,0,1,0,1,-76.90039825,34.87951279
230,"HAVERHILL MA",10,1,1,0,0,1,-71.07640076,42.77653122
230,"HAVRE DE GRACE MD",10,1,0,1,0,1,-76.09111023,39.54937363
230,"HAWTHORNE CA",10,24,3,7,14,24,-118.3549194,33.91656113
230,"HAWTHORNE NJ",10,4,2,0,2,4,-74.15322876,40.94930649
230,"HAYMARKET VA",10,2,1,1,0,2,-77.63591766,38.81214142
230,"HAYS KS",10,3,0,1,2,3,-99.32746887,38.87940598
230,"HAYWARD CA",10,35,9,12,14,35,-122.0832672,37.66890335
230,"HAZEL PARK MI",10,1,0,0,1,1,-83.10384369,42.46282196
230,"HAZELWOOD MO",10,1,0,0,1,1,-90.37133789,38.77171707
230,"HEALDSBURG CA",10,2,1,1,0,2,-122.8713226,38.6101799
230,"HEARNE TX",10,2,1,0,1,2,-96.59375763,30.87876701
230,"HEBER SPRINGS AR",10,1,0,0,1,1,-92.03152466,35.49176788
230,"HEBRON IN",10,5,2,2,1,5,-87.20029449,41.31857681
230,"HEDGESVILLE WV",10,1,0,0,1,1,-77.99388123,39.55364609
230,"HELENA AL",10,1,0,0,1,1,-86.84368134,33.29661179
230,"HELENA MT",10,30,9,9,12,30,-112.0374527,46.59269333
230,"HELOTES TX",10,9,3,3,3,9,-98.69043732,29.57864761
230,"HEMET CA",10,3,1,1,1,3,-116.9736557,33.74770737
230,"HEMPSTEAD NY",10,9,4,3,2,9,-73.61798096,40.70619965
230,"HENDERSON KY",10,1,0,0,1,1,-87.58986664,37.8363266
230,"HENDERSON NC",10,1,0,0,1,1,-78.39831543,36.3300705
230,"HENDERSON NV",10,117,26,38,53,117,-114.9741058,36.03540421
230,"HENDERSONVILLE NC",10,27,5,10,12,27,-82.46079254,35.31912994
230,"HENDERSONVILLE TN",10,1,0,0,1,1,-86.61997986,36.30472565
230,"HERCULANEUM MO",10,17,4,3,10,17,-90.38007355,38.26866531
230,"HERCULES CA",10,2,1,0,1,2,-122.2900772,38.01711655
230,"HERKIMER NY",10,1,1,0,0,1,-74.98493195,43.02587128
230,"HERMANTOWN MN",10,1,0,0,1,1,-92.23839569,46.8067627
230,"HERMISTON OR",10,1,0,0,1,1,-119.2915268,45.84025192
230,"HERMOSA BEACH CA",10,3,1,0,2,3,-118.401619,33.86245728
230,"HERNANDO MS",10,9,6,1,2,9,-89.99411774,34.82405853
230,"HERNDON VA",10,5,0,2,3,5,-77.38563538,38.96995544
230,"HERRIN IL",10,4,1,1,2,4,-89.02784729,37.80303574
230,"HESPERIA CA",10,9,2,3,4,9,-117.3026352,34.42634964
230,"HIALEAH FL",10,31,9,9,13,31,-80.27757263,25.85853386
230,"HICKORY NC",10,3,0,1,2,3,-81.34054565,35.72800827
230,"HICKSVILLE OH",10,1,0,1,0,1,-84.76192474,41.29306412
230,"HIGH POINT NC",10,4,1,1,2,4,-80.00497437,35.95609665
230,"HIGHLAND CA",10,6,2,1,3,6,-117.2105789,34.12824631
230,"HIGHLAND HEIGHTS KY",10,1,1,0,0,1,-84.45198822,39.03324509
230,"HIGHLAND IN",10,1,1,0,0,1,-87.45178223,41.55387115
230,"HIGHLAND PARK IL",10,7,0,4,3,7,-87.80068207,42.18181992
230,"HIGHLAND PARK NJ",10,5,1,1,3,5,-74.4232254,40.49617386
230,"HIGHLAND PARK TX",10,2,2,0,0,2,-96.80493164,32.8320961
230,"HIGHLANDVILLE MO",10,1,0,0,1,1,-93.28062439,36.93317032
230,"HIGHWOOD IL",10,3,2,1,0,3,-87.80953979,42.19964218
230,"HILLIARD OH",10,9,2,3,4,9,-83.15856171,40.03361511
230,"HILLSBORO IL",10,5,1,1,3,5,-89.4937439,39.16139603
230,"HILLSBORO OH",10,4,0,3,1,4,-83.61119843,39.20261765
230,"HILLSBORO OR",10,80,24,20,36,80,-122.9927826,45.52270508
230,"HILLSBOROUGH NC",10,2,0,2,0,2,-79.09932709,36.07565308
230,"HILLSDALE MI",10,1,1,0,0,1,-84.63027191,41.91994095
230,"HILLSDALE NJ",10,3,0,3,0,3,-74.039711,41.00293732
230,"HILTON HEAD ISLAND SC",10,1,0,0,1,1,-80.75251007,32.21665573
230,"HINESVILLE GA",10,2,0,2,0,2,-81.59757996,31.85308266
230,"HINSDALE NH",10,1,0,1,0,1,-72.48535156,42.78657913
230,"HIRAM OH",10,9,2,4,3,9,-81.14317322,41.31268311
230,"HITCHCOCK TX",10,1,0,0,1,1,-95.01639557,29.34873009
230,"HOBART IN",10,17,7,4,6,17,-87.24478912,41.53391266
230,"HOBBS NM",10,1,0,1,0,1,-103.1330643,32.70048141
230,"HOBOKEN NJ",10,42,6,15,21,42,-74.0316925,40.7443428
230,"HOFFMAN ESTATES IL",10,5,2,0,3,5,-88.07968903,42.04299927
230,"HOGANSVILLE GA",10,1,1,0,0,1,-84.91479492,33.17349243
230,"HOLBROOK MA",10,1,1,0,0,1,-71.00770569,42.15513229
230,"HOLCOMB KS",10,5,2,0,3,5,-100.9902344,37.98623276
230,"HOLDEN MA",10,1,0,0,1,1,-71.86223602,42.35177994
230,"HOLLAND MI",10,19,4,9,6,19,-86.10916138,42.78744507
230,"HOLLAND OH",10,2,0,1,1,2,-83.71160126,41.62187576
230,"HOLLIDAY TX",10,1,0,0,1,1,-98.69548798,33.81625748
230,"HOLLISTER CA",10,5,0,3,2,5,-121.4038849,36.85258865
230,"HOLLY HILL FL",10,1,0,0,1,1,-81.03705597,29.24398613
230,"HOLLY SPRINGS MS",10,1,0,1,0,1,-89.44177246,34.77593994
230,"HOLLY SPRINGS NC",10,7,2,2,3,7,-78.83320618,35.65140915
230,"HOLLYWOOD FL",10,74,7,33,34,74,-80.14926147,26.01175499
230,"HOLMDEL NJ",10,2,1,0,1,2,-74.18328857,40.34526443
230,"HOLYOKE MA",10,15,0,8,7,15,-72.61522675,42.20437241
230,"HOMER AK",10,1,0,0,1,1,-151.544632,59.64481735
230,"HOMER NY",10,1,0,0,1,1,-76.1782074,42.6373024
230,"HOMESTEAD FL",10,7,1,5,1,7,-80.47710419,25.46927071
230,"HOMEWOOD AL",10,2,1,0,1,2,-86.80097961,33.47186661
230,"HOMEWOOD IL",10,1,0,0,1,1,-87.66596222,41.55735779
230,"HOOD RIVER OR",10,1,0,1,0,1,-121.5108719,45.70785141
230,"HOPE MILLS NC",10,3,1,0,2,3,-78.94456482,34.97066498
230,"HOPKINSVILLE KY",10,1,0,1,0,1,-87.48854828,36.86588287
230,"HORSEHEADS NY",10,1,1,0,0,1,-76.81996155,42.16708755
230,"HORSHAM PA",10,2,0,1,1,2,-75.12754822,40.17853165
230,"HOT SPRINGS AR",10,28,7,12,9,28,-93.05556488,34.5039978
230,"HOUGHTON MI",10,11,5,3,3,11,-88.56951141,47.12665558
230,"HOUMA LA",10,3,0,1,2,3,-90.71982574,29.59630585
230,"HOUSTON MS",10,2,0,2,0,2,-88.99927521,33.89876556
230,"HOUSTON TX",10,4079,1003,1212,1864,4079,-95.36399841,29.76376343
230,"HOWELL MI",10,2,0,1,1,2,-83.92946625,42.6072464
230,"HUDSON MA",10,3,0,2,1,3,-71.57429504,42.39633942
230,"HUDSON NY",10,1,1,0,0,1,-73.7900238,42.25299454
230,"HUDSON OH",10,1,0,0,1,1,-81.44026947,41.2401619
230,"HUGHSON CA",10,1,1,0,0,1,-120.8681412,37.59653854
230,"HUMBLE TX",10,11,1,5,5,11,-95.26166534,29.99774551
230,"HUNTERSVILLE NC",10,9,4,3,2,9,-80.83785248,35.41359711
230,"HUNTINGDON PA",10,1,0,1,0,1,-78.00988007,40.48491669
230,"HUNTINGTON BEACH CA",10,31,8,5,18,31,-118.0006027,33.66012955
230,"HUNTINGTON NY",10,3,1,0,2,3,-73.42463684,40.86833191
230,"HUNTINGTON PARK CA",10,3,0,0,3,3,-118.2265549,33.98159409
230,"HUNTINGTON WOODS MI",10,1,0,1,0,1,-83.16641998,42.48081207
230,"HUNTINGTON WV",10,68,15,23,30,68,-82.44620514,38.4181366
230,"HUNTLEY IL",10,1,0,0,1,1,-88.42815399,42.16807938
230,"HUNTSVILLE AL",10,279,74,76,129,279,-86.58609772,34.73073959
230,"HUNTSVILLE TX",10,4,2,0,2,4,-95.55122375,30.72374153
230,"HURON OH",10,1,0,1,0,1,-82.55414581,41.37385178
230,"HURRICANE UT",10,1,0,1,0,1,-113.2914887,37.17508316
230,"HURST TX",10,10,6,0,4,10,-97.17115021,32.82357407
230,"HUTCHINSON KS",10,6,0,2,4,6,-97.93050385,38.06093216
230,"HUTCHINSON MN",10,1,0,1,0,1,-94.37024689,44.88771439
230,"HUTTO TX",10,3,0,1,2,3,-97.54733276,30.54326057
230,"HYATTSVILLE MD",10,70,16,24,30,70,-76.94467163,38.95636749
230,"HYDE PARK NY",10,2,2,0,0,2,-73.93060303,41.79148865
230,"IDAHO FALLS ID",10,12,3,4,5,12,-112.035408,43.46630478
230,"IDAHO SPRINGS CO",10,5,3,0,2,5,-105.5237274,39.7417717
230,"IMPERIAL CA",10,13,3,5,5,13,-115.5716705,32.84782791
230,"INDEPENDENCE KY",10,11,2,4,5,11,-84.54380035,38.94332886
230,"INDEPENDENCE MO",10,22,6,9,7,22,-94.41611481,39.09104538
230,"INDIAN ROCKS BEACH FL",10,3,0,3,0,3,-82.85096741,27.87600517
230,"INDIAN TRAIL NC",10,1,0,1,0,1,-80.66901398,35.07696915
230,"INDIANA PA",10,1,0,1,0,1,-79.15187073,40.6216507
230,"INDIANAPOLIS IN",10,937,235,265,437,937,-86.15828705,39.76844788
230,"INDIANOLA MS",10,2,0,1,1,2,-90.65548706,33.45103073
230,"INDIO CA",10,25,5,6,14,25,-116.2173004,33.72047043
230,"INGLEWOOD CA",10,81,22,18,41,81,-118.354805,33.96157074
230,"INKSTER MI",10,1,0,0,1,1,-83.31001282,42.29439926
230,"INMAN SC",10,1,0,0,1,1,-82.09005737,35.04743958
230,"INVER GROVE HEIGHTS MN",10,1,0,0,1,1,-93.02364349,44.85364151
230,"INVERNESS MS",10,1,1,0,0,1,-90.59259033,33.35402679
230,"IOWA CITY IA",10,126,29,48,49,126,-91.53023529,41.66130066
230,"IPSWICH MA",10,2,0,1,1,2,-70.84001923,42.67964554
230,"IRMO SC",10,3,2,1,0,3,-81.18247223,34.08623123
230,"IRONTON OH",10,3,0,1,2,3,-82.68261719,38.53668976
230,"IRVINE CA",10,77,24,15,38,77,-117.8243942,33.66952515
230,"IRVINE KY",10,1,0,1,0,1,-83.97343445,37.700634
230,"IRVING TX",10,45,13,12,20,45,-96.94924927,32.81419754
230,"IRVINGTON NY",10,5,2,2,1,5,-73.86441803,41.03897858
230,"ISLE OF PALMS SC",10,2,2,0,0,2,-79.79431152,32.78720093
230,"ISLIP NY",10,1,0,0,1,1,-73.20967102,40.7298851
230,"ISSAQUAH WA",10,8,1,1,6,8,-122.0345993,47.52977753
230,"ITHACA NY",10,202,41,62,99,202,-76.49575043,42.44075775
230,"JACKSON LA",10,2,0,0,2,2,-91.2175827,30.83776855
230,"JACKSON MI",10,15,7,5,3,15,-84.40149689,42.24575043
230,"JACKSON MS",10,258,55,85,118,258,-90.19654846,32.298172
230,"JACKSON OH",10,1,0,0,1,1,-82.63652039,39.05205917
230,"JACKSON TN",10,96,24,28,44,96,-88.81397247,35.61472321
230,"JACKSON WY",10,8,1,5,2,8,-110.7644806,43.4798851
230,"JACKSONVILLE AL",10,3,1,0,2,3,-85.76148987,33.81370163
230,"JACKSONVILLE BEACH FL",10,56,17,26,13,56,-81.39300537,30.29505539
230,"JACKSONVILLE FL",10,408,118,111,179,408,-81.65545654,30.33253288
230,"JACKSONVILLE NC",10,14,7,1,6,14,-77.42939758,34.75283813
230,"JACKSONVILLE TX",10,2,1,1,0,2,-95.27114868,31.96398926
230,"JAMESBURG NJ",10,1,0,0,1,1,-74.43906403,40.35289001
230,"JAMESTOWN NC",10,1,1,0,0,1,-79.93502045,35.99464417
230,"JAMESTOWN NY",10,20,6,5,9,20,-79.23510742,42.09712601
230,"JANESVILLE WI",10,22,7,7,8,22,-89.01893616,42.68303299
230,"JANSEN NE",10,1,1,0,0,1,-97.08450317,40.18547821
230,"JASPER AL",10,1,0,0,1,1,-87.27728271,33.83164597
230,"JASPER IN",10,1,0,0,1,1,-86.93096161,38.39162445
230,"JAY FL",10,4,0,3,1,4,-87.15126801,30.95347977
230,"JAY OK",10,1,0,0,1,1,-94.79729462,36.42128372
230,"JEFFERSON CITY MO",10,56,24,8,24,56,-92.17385864,38.57698441
230,"JEFFERSON CITY TN",10,4,3,1,0,4,-83.48968506,36.11675644
230,"JEFFERSON GA",10,3,0,2,1,3,-83.57225037,34.11717606
230,"JEFFERSONVILLE IN",10,6,1,2,3,6,-85.73719788,38.27765656
230,"JENKINTOWN PA",10,1,1,0,0,1,-75.12425995,40.09637451
230,"JENNINGS MO",10,30,5,12,13,30,-90.26077271,38.71944046
230,"JEROME AZ",10,2,0,0,2,2,-112.1151428,34.74900055
230,"JERSEY CITY NJ",10,261,72,68,121,261,-74.07667542,40.72816849
230,"JERSEY VILLAGE TX",10,2,1,0,1,2,-95.56360626,29.88805389
230,"JERSEYVILLE IL",10,1,0,1,0,1,-90.32881165,39.12010956
230,"JIM THORPE PA",10,10,2,3,5,10,-75.73157501,40.87605667
230,"JOHNSON CITY TN",10,53,10,23,20,53,-82.35308075,36.31352615
230,"JOHNSTOWN PA",10,4,1,1,2,4,-78.92127228,40.326931
230,"JOLIET IL",10,53,14,14,25,53,-88.08213043,41.52493668
230,"JONES OK",10,2,1,0,1,2,-97.28777313,35.56618881
230,"JONESBORO AR",10,17,5,4,8,17,-90.70430756,35.84226608
230,"JONESBORO GA",10,7,1,1,5,7,-84.35381317,33.52181625
230,"JONESBORO IL",10,4,0,3,1,4,-89.26836395,37.45198059
230,"JONESBORO LA",10,2,0,0,2,2,-92.71629333,32.24162292
230,"JONESVILLE SC",10,1,1,0,0,1,-81.68328094,34.83895111
230,"JOPLIN MO",10,32,11,11,10,32,-94.5140686,37.08442688
230,"JUNCTION CITY KS",10,7,3,2,2,7,-96.8317337,39.02863693
230,"JUPITER FL",10,19,6,6,7,19,-80.09382629,26.9349556
230,"JUSTIN TX",10,1,0,0,1,1,-97.29656219,33.08527374
230,"KALAMAZOO MI",10,350,91,94,165,350,-85.58725739,42.29179764
230,"KALISPELL MT",10,4,2,1,1,4,-114.3166199,48.20161438
230,"KANKAKEE IL",10,3,1,2,0,3,-87.86149597,41.12018204
230,"KANNAPOLIS NC",10,4,2,0,2,4,-80.62119293,35.48755264
230,"KANSAS CITY KS",10,17,5,3,9,17,-94.62808228,39.1141777
230,"KANSAS CITY MO",10,1553,376,421,756,1553,-94.57884979,39.09976578
230,"KATY TX",10,34,10,14,10,34,-95.82484436,29.78606224
230,"KAUKAUNA WI",10,1,0,1,0,1,-88.27227783,44.27797699
230,"KEARNEY MO",10,2,0,1,1,2,-94.36273956,39.36795044
230,"KEARNEY NE",10,10,4,4,2,10,-99.08208466,40.69932938
230,"KEARNY NJ",10,6,1,2,3,6,-74.14439392,40.76873398
230,"KEIZER OR",10,2,1,1,0,2,-123.0285339,44.98967743
230,"KELLER TX",10,2,0,0,2,2,-97.25247192,32.93486786
230,"KEMAH TX",10,3,0,1,2,3,-95.01854706,29.54022026
230,"KENAI AK",10,1,1,0,0,1,-151.2597809,60.55926895
230,"KENDALL WI",10,5,1,2,2,5,-90.36859894,43.79189682
230,"KENDALLVILLE IN",10,8,2,2,4,8,-85.27036285,41.44488525
230,"KENMORE NY",10,5,0,3,2,5,-78.86985779,42.96615982
230,"KENMORE WA",10,3,0,1,2,3,-122.2464905,47.7568779
230,"KENNEDALE TX",10,1,1,0,0,1,-97.22646332,32.64726639
230,"KENNER LA",10,2,0,0,2,2,-90.24167633,29.99442101
230,"KENNESAW GA",10,13,5,4,4,13,-84.61528015,34.02365875
230,"KENNETT SQUARE PA",10,1,0,0,1,1,-75.71079254,39.84713364
230,"KENNEWICK WA",10,14,6,1,7,14,-119.1395264,46.2107811
230,"KENOSHA WI",10,13,1,5,7,13,-87.82134247,42.58494949
230,"KENSINGTON MD",10,1,1,0,0,1,-77.07564545,39.02577972
230,"KENT OH",10,41,9,14,18,41,-81.35736084,41.15368271
230,"KENT WA",10,168,38,52,78,168,-122.2377701,47.38068008
230,"KENTON TN",10,2,0,2,0,2,-89.01268005,36.20218658
230,"KENTWOOD MI",10,3,0,1,2,3,-85.64472198,42.86936569
230,"KERENS TX",10,1,0,0,1,1,-96.22852325,32.13335419
230,"KERMAN CA",10,1,1,0,0,1,-120.0621414,36.723423
230,"KERNERSVILLE NC",10,1,0,0,1,1,-80.07332611,36.12029266
230,"KERRVILLE TX",10,4,1,1,2,4,-99.14083099,30.04796982
230,"KETCHIKAN AK",10,4,2,1,1,4,-131.6417084,55.34326935
230,"KETTERING OH",10,8,3,3,2,8,-84.1687088,39.68964005
230,"KEY WEST FL",10,71,12,33,26,71,-81.78218079,24.556427
230,"KEYSTONE HEIGHTS FL",10,2,0,2,0,2,-82.03114319,29.78640366
230,"KILL DEVIL HILLS NC",10,3,0,1,2,3,-75.6541214,36.01398468
230,"KILLEEN TX",10,23,4,2,17,23,-97.72832489,31.11753464
230,"KING NC",10,1,0,1,0,1,-80.35888672,36.28079987
230,"KINGFISHER OK",10,1,0,0,1,1,-97.93222809,35.8614006
230,"KINGMAN AZ",10,1,0,1,0,1,-114.0542908,35.18925858
230,"KINGMAN KS",10,8,0,2,6,8,-98.11450958,37.64601517
230,"KINGS MOUNTAIN NC",10,1,0,1,0,1,-81.34108734,35.24551773
230,"KINGSLAND GA",10,1,0,0,1,1,-81.68964386,30.80049896
230,"KINGSPORT TN",10,104,19,25,60,104,-82.56182861,36.54841232
230,"KINGSTON MA",10,6,0,2,4,6,-70.72354889,41.99478531
230,"KINGSTON NY",10,6,0,1,5,6,-73.99665833,41.92714691
230,"KINGSTON PA",10,10,2,2,6,10,-75.89610291,41.26209641
230,"KINGSVILLE TX",10,1,0,0,1,1,-97.86582184,27.51676559
230,"KINSTON NC",10,1,1,0,0,1,-77.58128357,35.26295471
230,"KIRKLAND WA",10,90,20,40,30,90,-122.2108688,47.6813736
230,"KIRKSVILLE MO",10,2,0,1,1,2,-92.58364105,40.19476318
230,"KIRKWOOD MO",10,29,6,12,11,29,-90.40686798,38.5832901
230,"KISSIMMEE FL",10,30,10,7,13,30,-81.40729523,28.29271317
230,"KLAMATH FALLS OR",10,12,2,5,5,12,-121.7844772,42.2244873
230,"KNOX PA",10,1,0,0,1,1,-79.53708649,41.23451996
230,"KNOXVILLE TN",10,230,53,77,100,230,-83.92067719,35.96077728
230,"KODIAK AK",10,14,4,4,6,14,-152.3966675,57.7966423
230,"KOKOMO IN",10,14,0,10,4,14,-86.12706757,40.48566818
230,"KOUNTZE TX",10,18,7,6,5,18,-94.31259918,30.3719101
230,"KURE BEACH NC",10,1,0,0,1,1,-77.90657043,33.99703979
230,"KUTZTOWN PA",10,3,0,1,2,3,-75.77677917,40.51739502
230,"KYLE TX",10,3,0,2,1,3,-97.87797546,29.9895649
230,"LA CROSSE WI",10,25,4,11,10,25,-91.23967743,43.80151367
230,"LA GRANDE OR",10,6,4,1,1,6,-118.090126,45.32435989
230,"LA GRANGE TX",10,1,0,1,0,1,-96.87730408,29.90603638
230,"LA HABRA CA",10,5,2,1,2,5,-117.9494629,33.93001556
230,"LA MARQUE TX",10,3,2,1,0,3,-94.97169495,29.37788391
230,"LA MESA CA",10,12,2,0,10,12,-117.0447464,32.76841354
230,"LA MIRADA CA",10,3,1,1,1,3,-118.0295639,33.85194778
230,"LA VERGNE TN",10,1,0,0,1,1,-86.58178711,36.01600266
230,"LA VERNE CA",10,2,0,2,0,2,-117.7696304,34.1006546
230,"LACEY WA",10,6,1,1,4,6,-122.8096161,47.03732681
230,"LACONIA NH",10,22,2,2,7,11,-71.46888733,43.52740097
230,"LADY LAKE FL",10,2,0,1,1,2,-81.92842865,28.92837715
230,"LAFAYETTE CA",10,5,1,3,1,5,-122.1200104,37.88574982
230,"LAFAYETTE CO",10,19,6,4,9,19,-105.0904388,39.99370956
230,"LAFAYETTE IN",10,24,7,8,9,24,-86.88406372,40.42077255
230,"LAFAYETTE LA",10,85,16,17,52,85,-92.01987457,30.22468185
230,"LAFAYETTE TN",10,1,0,0,1,1,-86.02629089,36.52130127
230,"LAGUNA BEACH CA",10,17,4,4,9,17,-117.7847061,33.54205322
230,"LAKE BLUFF IL",10,2,0,1,1,2,-87.83427429,42.2790184
230,"LAKE CHARLES LA",10,16,3,5,8,16,-93.21766663,30.22713852
230,"LAKE CITY MI",10,1,0,0,1,1,-85.21483612,44.3353653
230,"LAKE FOREST IL",10,1,0,0,1,1,-87.84095764,42.25865555
230,"LAKE GENEVA WI",10,4,1,2,1,4,-88.43348694,42.59184265
230,"LAKE HAVASU CITY AZ",10,1,0,1,0,1,-114.3244324,34.48379517
230,"LAKE JACKSON TX",10,3,0,1,2,3,-95.43475342,29.03430176
230,"LAKE MARY FL",10,1,0,0,1,1,-81.31755829,28.75924492
230,"LAKE MS",10,1,0,1,0,1,-89.32857513,32.34328842
230,"LAKE OSWEGO OR",10,4,2,1,1,4,-122.6727066,45.42033005
230,"LAKE PLACID FL",10,2,2,0,0,2,-81.36245728,27.29381371
230,"LAKE PLACID NY",10,1,0,1,0,1,-73.97898865,44.27967072
230,"LAKE STEVENS WA",10,1,0,1,0,1,-122.0684662,48.01782227
230,"LAKE WORTH FL",10,11,2,6,3,11,-80.05649567,26.61662102
230,"LAKELAND FL",10,28,7,7,14,28,-81.95620728,28.04432487
230,"LAKEVIEW OH",10,1,0,0,1,1,-83.9243927,40.48482895
230,"LAKEVILLE MN",10,3,1,0,2,3,-93.24331665,44.64937973
230,"LAKEWOOD CA",10,7,1,1,5,7,-118.1357193,33.85370636
230,"LAKEWOOD CO",10,15,4,3,8,15,-105.0827332,39.70486069
230,"LAKEWOOD NJ",10,5,0,3,2,5,-74.21684265,40.09822845
230,"LAKEWOOD OH",10,56,10,19,27,56,-81.79773712,41.48223114
230,"LAKEWOOD WA",10,18,2,2,5,9,-122.3653679,47.661533355
230,"LAMAR CO",10,3,1,1,1,3,-102.6111527,38.08679581
230,"LAMBERTVILLE NJ",10,2,1,1,0,2,-74.94231415,40.36618423
230,"LANCASTER CA",10,27,8,7,12,27,-118.1386871,34.69804001
230,"LANCASTER KS",10,2,1,1,0,2,-95.30338287,39.57285309
230,"LANCASTER NY",10,2,0,0,2,2,-78.67009735,42.90063477
230,"LANCASTER OH",10,4,1,1,2,4,-82.59890747,39.71387482
230,"LANCASTER PA",10,121,35,37,49,121,-76.30498505,40.03824234
230,"LANCASTER SC",10,2,0,0,2,2,-80.76622772,34.71495819
230,"LANCASTER TX",10,2,0,0,2,2,-96.75682831,32.59244156
230,"LANDOVER HILLS MD",10,2,0,0,2,2,-76.89152527,38.94342804
230,"LANGLEY WA",10,2,0,1,1,2,-122.4162674,48.03789139
230,"LANSDALE PA",10,1,0,0,1,1,-75.28330994,40.24167633
230,"LANSDOWNE PA",10,45,10,14,21,45,-75.27108765,39.93852234
230,"LANSING IL",10,8,3,2,3,8,-87.5393219,41.56502151
230,"LANSING MI",10,135,30,49,56,135,-84.55532074,42.73265839
230,"LAPEER MI",10,19,3,6,10,19,-83.31890869,43.05135345
230,"LARAMIE WY",10,16,4,7,5,16,-105.592804,41.3115387
230,"LAREDO TX",10,54,9,23,22,54,-99.50824738,27.50720978
230,"LARGO FL",10,47,8,18,21,47,-82.78675079,27.91026115
230,"LARKSPUR CA",10,1,0,1,0,1,-122.5373993,37.93414688
230,"LARKSPUR CO",10,1,0,0,1,1,-104.8885803,39.22866058
230,"LAS CRUCES NM",10,43,11,12,20,43,-106.7798538,32.31209564
230,"LAS VEGAS NM",10,4,0,2,2,4,-105.2182999,35.6000061
230,"LAS VEGAS NV",10,1781,439,536,806,1781,-115.1382141,36.17488098
230,"LATHROP CA",10,5,1,1,3,5,-121.2790833,37.82243729
230,"LATHRUP VILLAGE MI",10,1,1,0,0,1,-83.22232819,42.49633026
230,"LAUDERDALE LAKES FL",10,15,5,3,7,15,-80.20793915,26.1671524
230,"LAUDERDALE MN",10,1,1,0,0,1,-93.20005798,44.99473572
230,"LAUDERHILL FL",10,1,0,0,1,1,-80.21311188,26.14096451
230,"LAUREL MS",10,6,1,1,4,6,-89.13054657,31.69452286
230,"LAUREL MT",10,1,0,0,1,1,-108.7678986,45.67721939
230,"LAURENS SC",10,1,0,0,1,1,-82.01370239,34.4994812
230,"LAURINBURG NC",10,1,0,0,1,1,-79.46212769,34.77434921
230,"LAVONIA GA",10,2,1,0,1,2,-83.10657501,34.4361496
230,"LAWNDALE CA",10,2,1,0,1,2,-118.3547897,33.88746262
230,"LAWRENCE IN",10,2,0,0,2,2,-86.02498627,39.83873749
230,"LAWRENCE KS",10,336,84,112,140,336,-95.23565674,38.97153091
230,"LAWRENCE MA",10,5,1,0,4,5,-71.15792084,42.70630646
230,"LAWRENCEBURG KY",10,4,0,2,2,4,-84.89624023,38.03728867
230,"LAWRENCEBURG TN",10,6,0,4,2,6,-87.33492279,35.24256897
230,"LAWRENCEVILLE GA",10,31,2,14,15,31,-83.98753357,33.95662308
230,"LAWTON OK",10,34,11,12,11,34,-98.39124298,34.60861969
230,"LAYTON UT",10,6,1,2,3,6,-111.9724808,41.06021118
230,"LEACHVILLE AR",10,1,1,0,0,1,-90.2583313,35.93592834
230,"LEADVILLE CO",10,2,0,0,2,2,-106.2934418,39.2509613
230,"LEAGUE CITY TX",10,18,5,7,6,18,-95.09550476,29.50793457
230,"LEANDER TX",10,10,2,5,3,10,-97.85368347,30.57936287
230,"LEAVENWORTH KS",10,9,2,3,4,9,-94.92282867,39.31124115
230,"LEAWOOD KS",10,11,2,2,7,11,-94.61756897,38.96688461
230,"LEBANON MO",10,3,0,0,3,3,-92.66392517,37.68081284
230,"LEBANON NH",10,1,0,0,1,1,-72.251091,43.64245987
230,"LEBANON OH",10,1,0,1,0,1,-84.20275879,39.43528748
230,"LEBANON OR",10,1,1,0,0,1,-122.9096909,44.53636551
230,"LEBANON PA",10,3,0,2,1,3,-76.41091156,40.34118652
230,"LEBANON TN",10,16,5,5,6,16,-86.29133606,36.20846939
230,"LEBANON VA",10,1,0,1,0,1,-82.07959747,36.90112305
230,"LEEDS AL",10,1,1,0,0,1,-86.54457092,33.54820251
230,"LEESBURG FL",10,16,6,3,7,16,-81.87727356,28.81123161
230,"LEESBURG VA",10,9,4,2,3,9,-77.56890869,39.11256027
230,"LEHI UT",10,4,3,1,0,4,-111.8519974,40.39155197
230,"LEITCHFIELD KY",10,1,0,1,0,1,-86.29386139,37.47995377
230,"LEMON GROVE CA",10,4,2,1,1,4,-117.0335465,32.74267197
230,"LEMOORE CA",10,1,0,0,1,1,-119.7849197,36.30083084
230,"LENEXA KS",10,8,5,0,3,8,-94.73374176,38.95368576
230,"LENGBY MN",10,1,0,0,1,1,-95.63667297,47.51546478
230,"LENOIR NC",10,3,1,1,1,3,-81.53869629,35.91436386
230,"LESLIE MO",10,3,0,1,2,3,-91.23233795,38.41774368
230,"LEWES DE",10,5,1,0,4,5,-75.1359024,38.77365494
230,"LEWISTON ID",10,4,2,1,1,4,-117.0198975,46.41637421
230,"LEWISTON ME",10,1,1,0,0,1,-70.21377563,44.10037231
230,"LEWISVILLE TX",10,22,5,4,13,22,-96.99449921,33.04630661
230,"LEXINGTON MA",10,4,1,1,2,4,-71.22381592,42.44742584
230,"LEXINGTON NC",10,4,2,1,1,4,-80.25289154,35.8242569
230,"LEXINGTON SC",10,19,8,6,5,19,-81.23597717,33.98204041
230,"LEXINGTON TN",10,2,1,0,1,2,-88.39100647,35.64579391
230,"LEXINGTON VA",10,9,5,2,2,9,-79.4422226,37.78420639
230,"LIBBY MT",10,4,1,0,3,4,-115.5511856,48.38265991
230,"LIBERAL MO",10,9,1,1,7,9,-94.52056122,37.55810547
230,"LIBERTY HILL TX",10,1,0,0,1,1,-97.92319489,30.66527367
230,"LIBERTY MO",10,30,10,9,11,30,-94.4196167,39.24604034
230,"LIBERTY SC",10,1,0,0,1,1,-82.69210052,34.78824234
230,"LIGONIER PA",10,1,0,1,0,1,-79.23710632,40.24316025
230,"LILBURN GA",10,4,2,1,1,4,-84.14273834,33.89017868
230,"LILLINGTON NC",10,3,2,0,1,3,-78.81506348,35.39981079
230,"LIMA OH",10,4,1,1,2,4,-84.10490417,40.74259186
230,"LINCOLN CA",10,4,2,0,2,4,-121.2951202,38.89149475
230,"LINCOLN IL",10,2,0,0,2,2,-89.36495209,40.1486702
230,"LINCOLN MA",10,1,0,1,0,1,-71.30281067,42.4262085
230,"LINCOLN NE",10,127,35,38,54,127,-96.6674118,40.80001068
230,"LINCOLN PARK MI",10,2,1,1,0,2,-83.17868042,42.25064468
230,"LINCOLN PARK NJ",10,1,0,0,1,1,-74.30114746,40.92467117
230,"LINCOLNSHIRE IL",10,1,0,0,1,1,-87.90823364,42.18999863
230,"LINCOLNTON NC",10,3,2,1,0,3,-81.25417328,35.47389603
230,"LINCOLNWOOD IL",10,2,0,0,2,2,-87.73023987,42.00463104
230,"LINDALE TX",10,7,2,3,2,7,-95.40984344,32.51585007
230,"LINDEN TN",10,1,0,1,0,1,-87.83943939,35.61751175
230,"LINDENWOLD NJ",10,2,0,1,1,2,-74.99706268,39.82461548
230,"LINO LAKES MN",10,1,0,1,0,1,-93.08938599,45.16019058
230,"LISBON OH",10,1,0,1,0,1,-80.76804352,40.77227402
230,"LITCHFIELD IL",10,1,0,1,0,1,-89.65457916,39.17536163
230,"LITITZ PA",10,1,0,0,1,1,-76.30600739,40.15749741
230,"LITTLE CHUTE WI",10,2,1,0,1,2,-88.31884003,44.27976608
230,"LITTLE FALLS NJ",10,1,0,1,0,1,-74.20709229,40.86914444
230,"LITTLE FALLS NY",10,1,0,0,1,1,-74.85877991,43.04351807
230,"LITTLE ROCK AR",10,359,93,93,173,359,-92.28178406,34.7369194
230,"LITTLESTOWN PA",10,1,0,1,0,1,-77.08756256,39.74491119
230,"LITTLETON CO",10,14,4,5,5,14,-105.0176163,39.6132431
230,"LIVE OAK CA",10,2,1,1,0,2,-121.662529,39.2755127
230,"LIVERMORE CA",10,6,2,1,3,6,-121.7701416,37.68147659
230,"LIVINGSTON MT",10,16,0,6,10,16,-110.5622253,45.66219711
230,"LIVINGSTON NJ",10,1,1,0,0,1,-74.31424713,40.79631042
230,"LIVONIA MI",10,13,6,1,6,13,-83.35256958,42.36862564
230,"LOBELVILLE TN",10,1,0,0,1,1,-87.78421021,35.77219772
230,"LOCKPORT NY",10,2,0,2,0,2,-78.69011688,43.17089081
230,"LOCUST NC",10,3,0,2,1,3,-80.42564392,35.26195145
230,"LODI CA",10,12,5,0,7,12,-121.2742386,38.12984467
230,"LODI NJ",10,3,1,0,2,3,-74.08244324,40.88240814
230,"LODI WI",10,1,1,0,0,1,-89.52679443,43.31368637
230,"LOGAN OH",10,3,0,1,2,3,-82.40658569,39.54026794
230,"LOGAN UT",10,18,7,5,6,18,-111.8171616,41.73900604
230,"LOGANSPORT IN",10,2,1,1,0,2,-86.36410522,40.75329208
230,"LOMIRA WI",10,5,1,3,1,5,-88.44380188,43.59117126
230,"LOMPOC CA",10,1,1,0,0,1,-120.4598694,34.63894272
230,"LONG BEACH CA",10,232,62,67,103,232,-118.1908112,33.7670517
230,"LONG BEACH MS",10,1,0,1,0,1,-89.15268707,30.35081673
230,"LONG BEACH NY",10,8,1,3,4,8,-73.6654129,40.58349991
230,"LONG BEACH WA",10,5,2,0,3,5,-124.0569916,46.35176086
230,"LONG BRANCH NJ",10,3,1,1,1,3,-73.991745,40.30428314
230,"LONG LAKE WI",10,1,0,1,0,1,-88.6680603,45.84259415
230,"LONGMONT CO",10,14,3,3,8,14,-105.1026764,40.16700745
230,"LONGVIEW TX",10,9,3,4,2,9,-94.73707581,32.4966507
230,"LONGVIEW WA",10,34,4,14,16,34,-122.9404221,46.1375885
230,"LORAIN OH",10,7,0,3,4,7,-82.17118073,41.45874023
230,"LORIS SC",10,4,1,2,1,4,-78.89011383,34.05680084
230,"LOS ALTOS CA",10,8,2,2,4,8,-122.1163025,37.38525772
230,"LOS ANGELES CA",10,6563,1652,1993,2918,6563,-118.2459106,34.05225754
230,"LOS FRESNOS TX",10,1,1,0,0,1,-97.47680664,26.07257271
230,"LOS GATOS CA",10,14,2,6,6,14,-121.9771652,37.22674561
230,"LOS LUNAS NM",10,4,2,1,1,4,-106.7300263,34.80502701
230,"LOUISA KY",10,2,0,0,2,2,-82.60322571,38.11429596
230,"LOUISA VA",10,10,1,3,6,10,-78.00349426,38.0253067
230,"LOUISBURG KS",10,10,0,6,4,10,-94.68140411,38.61960602
230,"LOUISVILLE CO",10,11,3,1,7,11,-105.1326523,39.97768402
230,"LOVELADY TX",10,1,1,0,0,1,-95.44617462,31.12744713
230,"LOVELAND CO",10,22,3,5,14,22,-105.0755997,40.39763641
230,"LOVES PARK IL",10,5,2,2,1,5,-89.05864716,42.31984711
230,"LOVINGTON NM",10,1,1,0,0,1,-103.3533325,32.9454422
230,"LOWELL IN",10,8,4,3,1,8,-87.42073059,41.29130173
230,"LOWELL MA",10,14,5,4,5,14,-71.31530762,42.63344574
230,"LUBBOCK TX",10,47,7,19,21,47,-101.8544312,33.59677505
230,"LUCEDALE MS",10,3,0,1,2,3,-88.59013367,30.92567635
230,"LUFKIN TX",10,3,0,1,2,3,-94.72932434,31.33858681
230,"LUMBERTON NC",10,4,0,3,1,4,-79.00803375,34.61832428
230,"LURAY VA",10,3,0,1,2,3,-78.45899963,38.66542816
230,"LUTHER OK",10,1,0,0,1,1,-97.19435883,35.66645432
230,"LYNCHBURG VA",10,9,0,4,5,9,-79.14174652,37.41383362
230,"LYNDEN WA",10,6,3,1,2,6,-122.455101,48.94639969
230,"LYNDHURST NJ",10,2,0,2,0,2,-74.12353516,40.81222153
230,"LYNDHURST OH",10,1,0,0,1,1,-81.48820496,41.52012253
230,"LYNN MA",10,15,2,4,9,15,-70.94833374,42.46699905
230,"LYNNWOOD WA",10,17,5,7,5,17,-122.3175736,47.82042313
230,"LYNWOOD CA",10,6,1,2,3,6,-118.2135544,33.93053055
230,"MADERA CA",10,6,1,2,3,6,-120.0627594,36.96101379
230,"MADISON AL",10,12,0,3,3,6,-86.487213135,33.561834335
230,"MADISON HEIGHTS MI",10,1,0,0,1,1,-83.10519409,42.48604965
230,"MADISON IL",10,2,0,0,2,2,-90.15700531,38.68284988
230,"MADISON MS",10,22,5,4,13,22,-90.11543274,32.46231079
230,"MADISON NJ",10,4,2,1,1,4,-74.41627502,40.76013184
230,"MADISON OH",10,1,0,0,1,1,-81.04933929,41.77106476
230,"MADISON SD",10,2,0,1,1,2,-97.11444855,44.00682449
230,"MADISON VA",10,1,0,1,0,1,-78.25695038,38.38075638
230,"MADISON WI",10,402,95,124,183,402,-89.40128326,43.07303619
230,"MADISON WV",10,1,0,0,1,1,-81.82273102,38.06180191
230,"MADISONVILLE KY",10,1,0,0,1,1,-87.49914551,37.32824707
230,"MADISONVILLE LA",10,2,0,0,2,2,-90.15699005,30.40480232
230,"MADISONVILLE TX",10,1,0,0,1,1,-95.9119339,30.95035172
230,"MAHOMET IL",10,3,0,0,3,3,-88.40461731,40.19519806
230,"MAHTOMEDI MN",10,1,0,1,0,1,-92.95236206,45.06974411
230,"MAHWAH NJ",10,1,1,0,0,1,-74.14279175,41.08900452
230,"MAIDEN NC",10,1,0,0,1,1,-81.21118164,35.57601166
230,"MAITLAND FL",10,1,0,0,1,1,-81.36436462,28.62580872
230,"MAIZE KS",10,1,0,0,1,1,-97.46515656,37.77322006
230,"MALDEN MA",10,3,1,0,2,3,-71.06546783,42.42518234
230,"MALVERN AR",10,1,0,1,0,1,-92.81313324,34.36237717
230,"MALVERNE NY",10,3,1,1,1,3,-73.67324829,40.67933273
230,"MAMMOTH LAKES CA",10,5,2,2,1,5,-119.0125961,37.60457611
230,"MANALAPAN NJ",10,3,1,2,0,3,-74.39516449,40.25764465
230,"MANASSAS PARK VA",10,2,0,1,1,2,-77.46895599,38.7841301
230,"MANASSAS VA",10,21,6,5,10,21,-77.47459412,38.75112534
230,"MANCHESTER CT",10,5,2,1,2,5,-72.52075958,41.77622986
230,"MANCHESTER KY",10,1,0,0,1,1,-83.76169586,37.15374756
230,"MANCHESTER MO",10,2,2,0,0,2,-90.50953674,38.597229
230,"MANCHESTER NH",10,153,32,50,71,153,-71.45406342,42.99581528
230,"MANDAN ND",10,2,2,0,0,2,-100.8964386,46.82664108
230,"MANDEVILLE LA",10,6,1,3,2,6,-90.06562805,30.35881805
230,"MANHATTAN BEACH CA",10,25,14,4,7,25,-118.4129181,33.88484192
230,"MANHATTAN KS",10,48,7,14,27,48,-96.57228851,39.18354034
230,"MANILA AR",10,1,0,0,1,1,-90.16703796,35.88010788
230,"MANITOU SPRINGS CO",10,4,1,1,2,4,-104.9184494,38.85948944
230,"MANKATO MN",10,58,18,10,30,58,-94.02125549,44.15895462
230,"MANNING SC",10,26,8,9,9,26,-80.21025085,33.69546509
230,"MANOR TX",10,2,0,0,2,2,-97.55760193,30.34129524
230,"MANSFIELD AR",10,3,0,1,2,3,-94.2530365,35.05989456
230,"MANSFIELD OH",10,3,0,0,3,3,-82.51545715,40.75864792
230,"MANSFIELD TX",10,2,0,1,1,2,-97.14230347,32.56362152
230,"MANTECA CA",10,13,2,6,5,13,-121.2179031,37.79747391
230,"MANTON MI",10,1,0,1,0,1,-85.39889526,44.41087341
230,"MAPLE GROVE MN",10,9,4,4,1,9,-93.47679138,45.14711761
230,"MAPLE HEIGHTS OH",10,1,0,0,1,1,-81.5656662,41.41540146
230,"MAPLETON IA",10,1,1,0,0,1,-95.79370117,42.16596603
230,"MAPLETON KS",10,1,1,0,0,1,-94.8840332,38.01527786
230,"MAPLEWOOD MN",10,2,0,1,1,2,-93.05480194,45.01259232
230,"MAPLEWOOD MO",10,9,3,1,5,9,-90.32471466,38.6126976
230,"MAPLEWOOD NJ",10,10,0,3,7,10,-74.27243805,40.77401733
230,"MARATHON FL",10,1,0,1,0,1,-81.09011841,24.71463966
230,"MARBLEHEAD MA",10,3,0,1,2,3,-70.85662079,42.50020599
230,"MARFA TX",10,1,1,0,0,1,-104.0205383,30.30808449
230,"MARGATE FL",10,1,0,1,0,1,-80.20605469,26.24529266
230,"MARIANNA FL",10,20,5,5,10,20,-85.22673798,30.77488518
230,"MARICOPA AZ",10,1,1,0,0,1,-112.0491562,33.05832672
230,"MARIETTA GA",10,57,8,16,33,57,-84.54958344,33.9527359
230,"MARIETTA OH",10,3,0,1,2,3,-81.45451355,39.41536331
230,"MARINA CA",10,2,0,1,1,2,-121.8042831,36.6841507
230,"MARION AR",10,5,2,2,1,5,-90.19646454,35.21472931
230,"MARION IA",10,3,1,0,2,3,-91.60752869,42.032547
230,"MARION IL",10,5,1,0,4,5,-88.93344116,37.73056412
230,"MARION IN",10,13,1,3,9,13,-85.65896606,40.55827332
230,"MARION KS",10,1,0,1,0,1,-97.018013,38.34838867
230,"MARION MS",10,1,0,0,1,1,-88.64802551,32.41785049
230,"MARION OH",10,4,2,0,2,4,-83.12861633,40.58881378
230,"MARION VA",10,2,0,2,0,2,-81.51425934,36.83526993
230,"MARISSA IL",10,1,1,0,0,1,-89.7505188,38.25014496
230,"MARKHAM IL",10,1,0,0,1,1,-87.69510651,41.59363937
230,"MARKS MS",10,5,3,1,1,5,-90.27207947,34.25684357
230,"MARLBORO NJ",10,1,1,0,0,1,-74.24552917,40.31547546
230,"MARLBOROUGH MA",10,2,1,0,1,2,-71.55128479,42.34592819
230,"MARQUETTE MI",10,5,1,2,2,5,-87.39571381,46.54323196
230,"MARS PA",10,1,0,1,0,1,-80.01100159,40.69602585
230,"MARSHALL MI",10,12,6,2,4,12,-84.9631424,42.27227402
230,"MARSHALL MN",10,13,5,4,4,13,-95.78921509,44.4466362
230,"MARSHALL MO",10,2,2,0,0,2,-93.19745636,39.12294769
230,"MARSHALL NC",10,1,0,0,1,1,-82.68395996,35.79773331
230,"MARSHALLTOWN IA",10,23,2,6,15,23,-92.90861511,42.04956055
230,"MARSHFIELD MO",10,1,1,0,0,1,-92.90744781,37.33891678
230,"MARTIN TN",10,3,1,1,1,3,-88.85335541,36.34902573
230,"MARTINEZ CA",10,5,1,2,2,5,-122.1364365,38.01914597
230,"MARTINS FERRY OH",10,4,0,1,3,4,-80.72425842,40.09586716
230,"MARTINSVILLE IN",10,1,0,1,0,1,-86.42851257,39.42800903
230,"MARTINSVILLE VA",10,2,0,0,2,2,-79.87229156,36.69199371
230,"MARYLAND HEIGHTS MO",10,8,0,2,6,8,-90.43025208,38.71334076
230,"MARYSVILLE CA",10,4,3,1,0,4,-121.5933762,39.14567947
230,"MARYSVILLE OH",10,1,0,0,1,1,-83.36706543,40.2364006
230,"MARYSVILLE WA",10,3,1,2,0,3,-122.179451,48.05155182
230,"MARYVILLE MO",10,1,1,0,0,1,-94.87281036,40.34609604
230,"MARYVILLE TN",10,32,7,7,18,32,-83.96243286,35.76000977
230,"MASCOUTAH IL",10,1,1,0,0,1,-89.79308319,38.49026489
230,"MASON CITY IA",10,12,1,6,5,12,-93.20175934,43.15355301
230,"MASON MI",10,5,1,3,1,5,-84.44378662,42.57910538
230,"MASON OH",10,31,6,10,15,31,-84.30989075,39.36032104
230,"MASON TN",10,14,4,6,4,14,-89.5331192,35.41201401
230,"MASONVILLE IA",10,1,0,0,1,1,-91.5915451,42.47937012
230,"MASSENA NY",10,2,0,1,1,2,-74.89122772,44.92828751
230,"MASSILLON OH",10,3,0,3,0,3,-81.52096558,40.7966156
230,"MATTHEWS NC",10,2,0,1,1,2,-80.72332001,35.11704254
230,"MATTOON IL",10,12,1,10,1,12,-88.37306976,39.48309326
230,"MAUMEE OH",10,3,0,1,2,3,-83.65665436,41.56746292
230,"MAYFIELD HEIGHTS OH",10,1,1,0,0,1,-81.45755005,41.51942062
230,"MAYFIELD KY",10,14,5,5,4,14,-88.63654327,36.74169922
230,"MAYNARD MA",10,2,0,1,1,2,-71.44880676,42.43361664
230,"MAYSVILLE NC",10,2,0,1,1,2,-77.23084259,34.90504074
230,"MCALLEN TX",10,51,11,18,22,51,-98.23077393,26.20433426
230,"MCDONOUGH GA",10,2,1,1,0,2,-84.1467514,33.44765472
230,"MCFARLAND CA",10,1,0,1,0,1,-119.2310333,35.67798996
230,"MCFARLAND WI",10,1,0,1,0,1,-89.28981781,43.01242828
230,"MCKINNEY TX",10,27,5,10,12,27,-96.6155777,33.19782257
230,"MCLEAN TX",10,1,0,0,1,1,-100.600174,35.23252487
230,"MCMINNVILLE OR",10,8,1,2,5,8,-123.2019272,45.20968628
230,"MEADVILLE PA",10,2,1,1,0,2,-80.15116119,41.64140701
230,"MEBANE NC",10,5,1,2,2,5,-79.26649475,36.09629059
230,"MECHANICSBURG OH",10,1,0,1,0,1,-83.55617523,40.07216644
230,"MECHANICSBURG PA",10,9,0,2,7,9,-77.00779724,40.21432114
230,"MEDFORD MA",10,9,4,4,1,9,-71.10526276,42.41849518
230,"MEDFORD OR",10,21,8,5,8,21,-122.8773193,42.32625961
230,"MEDIA PA",10,2,0,1,1,2,-75.38693237,39.91692734
230,"MEDICAL LAKE WA",10,5,0,0,5,5,-117.682518,47.57226944
230,"MEDINA OH",10,2,0,1,1,2,-81.86336517,41.13858795
230,"MEDWAY MA",10,8,2,2,4,8,-71.39579773,42.14194107
230,"MELBOURNE FL",10,13,4,5,4,13,-80.60625458,28.07838249
230,"MELROSE MA",10,5,0,3,2,5,-71.07271576,42.45837784
230,"MELROSE PARK IL",10,2,1,1,0,2,-87.85682678,41.90048218
230,"MEMPHIS TN",10,850,220,239,391,850,-90.01696014,35.1194191
230,"MENA AR",10,14,4,6,4,14,-94.24035645,34.58638
230,"MENASHA WI",10,3,1,1,1,3,-88.44643402,44.20197296
230,"MENLO PARK CA",10,21,7,5,9,21,-122.1842423,37.45361328
230,"MENOMONEE FALLS WI",10,2,2,0,0,2,-88.11719513,43.17907715
230,"MENTOR OH",10,8,3,1,4,8,-81.33918762,41.66637421
230,"MERCED CA",10,13,3,4,6,13,-120.4848785,37.30197525
230,"MERCEDES TX",10,2,1,1,0,2,-97.91394043,26.15032959
230,"MERIDEN CT",10,1,0,1,0,1,-72.80596161,41.5384407
230,"MERIDIAN ID",10,6,2,1,3,6,-116.3941193,43.611866
230,"MERIDIAN MS",10,4,0,2,2,4,-88.70374298,32.36473846
230,"MERRIAM KS",10,1,1,0,0,1,-94.69395447,39.02367401
230,"MERRILLVILLE IN",10,6,0,2,4,6,-87.33312988,41.48298645
230,"MESA AZ",10,112,30,41,41,112,-111.8239059,33.42222214
230,"MESQUITE NV",10,3,0,2,1,3,-114.0683136,36.80557251
230,"MESQUITE TX",10,26,5,7,14,26,-96.59959412,32.76692581
230,"METUCHEN NJ",10,1,0,1,0,1,-74.36269379,40.543293
230,"MEXICO ME",10,1,0,0,1,1,-70.54452515,44.56102371
230,"MEXICO MO",10,2,2,0,0,2,-91.8833313,39.16965866
230,"MIAMI BEACH FL",10,134,36,28,70,134,-80.12982178,25.79146576
230,"MIAMI FL",10,1256,294,394,568,1256,-80.19329071,25.77483749
230,"MIAMISBURG OH",10,5,1,2,2,5,-84.28652191,39.643116
230,"MIDDLEBURG VA",10,3,0,1,2,3,-77.73491669,38.96906662
230,"MIDDLEBURY IN",10,3,1,0,2,3,-85.71139526,41.67531967
230,"MIDDLEBURY VT",10,11,2,4,5,11,-73.16629028,44.01540756
230,"MIDDLESEX NJ",10,1,0,0,1,1,-74.49213409,40.57284164
230,"MIDDLETON WI",10,1,0,1,0,1,-89.50476074,43.09717941
230,"MIDDLETOWN CT",10,10,1,3,6,10,-72.64955902,41.56232071
230,"MIDDLETOWN DE",10,5,0,2,3,5,-75.71700287,39.44935226
230,"MIDDLETOWN NJ",10,3,1,2,0,3,-74.11607361,40.39449692
230,"MIDDLETOWN NY",10,5,1,1,3,5,-74.4223938,41.44607544
230,"MIDDLETOWN OH",10,6,1,1,4,6,-84.39844513,39.51361084
230,"MIDDLEVILLE MI",10,1,1,0,0,1,-85.46193695,42.71302032
230,"MIDLAND MI",10,12,2,1,9,12,-84.24700928,43.61585236
230,"MIDLAND TX",10,7,1,3,3,7,-102.0793686,31.99754143
230,"MIDLOTHIAN TX",10,2,0,1,1,2,-96.99511719,32.4827919
230,"MIDWAY GA",10,1,0,1,0,1,-81.43025208,31.80617905
230,"MIDWAY UT",10,1,1,0,0,1,-111.4762039,40.51210022
230,"MIDWEST CITY OK",10,3,0,2,1,3,-97.39709473,35.44970703
230,"MILAN IL",10,1,1,0,0,1,-90.57264709,41.45294952
230,"MILFORD CT",10,5,1,2,2,5,-73.05560303,41.2226181
230,"MILFORD DE",10,5,1,2,2,5,-75.42737579,38.9128685
230,"MILFORD IA",10,1,1,0,0,1,-95.15058899,43.32461929
230,"MILFORD MA",10,52,15,16,21,52,-71.51522064,42.14015198
230,"MILFORD MI",10,1,0,0,1,1,-83.59909821,42.59347534
230,"MILFORD NY",10,12,4,2,6,12,-74.94455719,42.59064865
230,"MILFORD OH",10,1,0,1,0,1,-84.29400635,39.17559433
230,"MILL VALLEY CA",10,10,0,6,4,10,-122.5473328,37.90579224
230,"MILLBROOK NY",10,2,0,1,1,2,-73.69306183,41.78520966
230,"MILLEDGEVILLE GA",10,5,3,1,1,5,-83.23179626,33.08055878
230,"MILLSBORO DE",10,3,2,1,0,3,-75.29344177,38.58910751
230,"MILLTOWN NJ",10,1,1,0,0,1,-74.44260406,40.45628738
230,"MILLVILLE NJ",10,2,1,0,1,2,-75.03882599,39.40239716
230,"MILPITAS CA",10,1,0,0,1,1,-121.9090805,37.42808533
230,"MILTON FL",10,2,2,0,0,2,-87.03953552,30.63289833
230,"MILTON MA",10,2,1,0,1,2,-71.06531525,42.25027466
230,"MILTON WI",10,2,0,2,0,2,-88.9439621,42.77545547
230,"MILWAUKEE WI",10,764,228,220,316,764,-87.90684509,43.03887939
230,"MILWAUKIE OR",10,4,1,1,2,4,-122.6417084,45.44596481
230,"MINDEN LA",10,50,18,8,24,50,-93.28716278,32.61589432
230,"MINERSVILLE PA",10,1,0,0,1,1,-76.26126862,40.69085693
230,"MINIER IL",10,1,0,1,0,1,-89.31304932,40.43381882
230,"MINNEAPOLIS MN",10,1406,369,426,611,1406,-93.26397705,44.97980118
230,"MINNETONKA MN",10,3,2,1,0,3,-93.43367004,44.92795181
230,"MINOT ND",10,5,3,2,0,5,-101.2953949,48.23139572
230,"MINSTER OH",10,1,0,0,1,1,-84.3759613,40.39321518
230,"MINT HILL NC",10,1,0,0,1,1,-80.64685059,35.17968369
230,"MIRAMAR FL",10,18,2,8,8,18,-80.23181915,25.98794746
230,"MISHAWAKA IN",10,15,5,4,6,15,-86.18048859,41.65872574
230,"MISSION KS",10,68,23,14,31,68,-94.65638733,39.02796173
230,"MISSION TX",10,10,4,1,5,10,-98.32580566,26.21655273
230,"MISSION VIEJO CA",10,4,1,1,2,4,-117.6737366,33.59992218
230,"MISSOULA MT",10,53,14,14,25,53,-113.9832687,46.87278366
230,"MISSOURI CITY TX",10,24,3,8,13,24,-95.5381012,29.61878204
230,"MITCHELL IN",10,2,0,0,2,2,-86.47343445,38.73275375
230,"MITCHELL SD",10,2,0,0,2,2,-98.02590179,43.70991898
230,"MOAB UT",10,5,1,3,1,5,-109.5508347,38.57315063
230,"MOBERLY MO",10,2,1,0,1,2,-92.43862152,39.41818619
230,"MOBILE AL",10,101,31,22,48,101,-88.04309845,30.69476128
230,"MODESTO CA",10,49,10,15,24,49,-120.9991455,37.63897324
230,"MOKENA IL",10,2,0,1,1,2,-87.88947296,41.52630615
230,"MONAHANS TX",10,1,1,0,0,1,-102.8932419,31.59444237
230,"MONCKS CORNER SC",10,1,0,0,1,1,-80.01290131,33.19626236
230,"MONESSEN PA",10,2,0,0,2,2,-79.88707733,40.14862442
230,"MONMOUTH IL",10,1,1,0,0,1,-90.64776611,40.91139221
230,"MONMOUTH OR",10,3,1,2,0,3,-123.2363892,44.84816742
230,"MONONA WI",10,2,0,2,0,2,-89.33418274,43.06205368
230,"MONROE LA",10,86,20,29,37,86,-92.11960602,32.50980759
230,"MONROE MI",10,6,2,0,4,6,-83.39758301,41.91663742
230,"MONROE NC",10,1,0,0,1,1,-80.54924011,34.98587036
230,"MONROVIA CA",10,20,5,4,11,20,-118.0006485,34.14796829
230,"MONTAGUE MI",10,2,0,2,0,2,-86.35713959,43.41694641
230,"MONTCLAIR NJ",10,25,6,7,12,25,-74.20848083,40.82605362
230,"MONTEBELLO CA",10,3,0,0,3,3,-118.1069412,34.00930023
230,"MONTEREY CA",10,20,4,3,13,20,-121.8974838,36.6002388
230,"MONTEREY PARK CA",10,4,0,3,1,4,-118.1248398,34.06269836
230,"MONTEVALLO AL",10,3,2,0,1,3,-86.86419678,33.10087967
230,"MONTGOMERY AL",10,123,34,26,63,123,-86.29966736,32.36724472
230,"MONTGOMERY TX",10,3,0,0,3,3,-95.69664001,30.38855171
230,"MONTICELLO IL",10,1,0,0,1,1,-88.57354736,40.02787399
230,"MONTICELLO KY",10,1,0,1,0,1,-84.88193512,36.81594086
230,"MONTICELLO MN",10,1,0,1,0,1,-93.79497528,45.30529785
230,"MONTICELLO NY",10,1,0,1,0,1,-74.68832397,41.65591812
230,"MONTPELIER VT",10,3,1,2,0,3,-72.57458496,44.26039124
230,"MONTROSE CO",10,1,1,0,0,1,-107.8707047,38.4788475
230,"MOORE OK",10,20,4,10,6,20,-97.48735046,35.33969498
230,"MOORESTOWN NJ",10,2,1,0,1,2,-74.94165039,39.96718597
230,"MOORESVILLE IN",10,4,1,0,3,4,-86.37399292,39.61291504
230,"MOORESVILLE NC",10,28,8,11,9,28,-80.80976868,35.58535004
230,"MOORHEAD MN",10,18,5,6,7,18,-96.76844025,46.87382507
230,"MOORPARK CA",10,7,0,3,4,7,-118.8839111,34.28554535
230,"MORAGA CA",10,1,0,0,1,1,-122.1321945,37.83471298
230,"MOREHEAD KY",10,3,1,0,2,3,-83.43223572,38.18409348
230,"MORGAN CITY LA",10,2,2,0,0,2,-91.20729065,29.69994926
230,"MORGAN HILL CA",10,8,1,1,6,8,-121.6563797,37.1303978
230,"MORGANTON NC",10,1,1,0,0,1,-81.68434906,35.74584961
230,"MORGANTOWN WV",10,49,8,16,25,49,-79.95038605,39.63131714
230,"MOROCCO IN",10,1,0,0,1,1,-87.45333862,40.94620895
230,"MORRIS IL",10,1,1,0,0,1,-88.42147064,41.3571167
230,"MORRIS MN",10,10,2,2,6,10,-95.91436005,45.58617401
230,"MORRISTOWN NJ",10,22,6,8,8,22,-74.48057556,40.79689789
230,"MORRISTOWN TN",10,2,0,2,0,2,-83.29478455,36.21415329
230,"MORRISVILLE NC",10,2,1,0,1,2,-78.82486725,35.82374954
230,"MORRO BAY CA",10,1,0,1,0,1,-120.8519135,35.36568451
230,"MORROW GA",10,12,0,4,8,12,-84.33943939,33.58339691
230,"MORTON GROVE IL",10,4,2,1,1,4,-87.78246307,42.04076767
230,"MORTON IL",10,1,1,0,0,1,-89.45970917,40.61309433
230,"MOSCOW ID",10,14,3,6,5,14,-117.0021973,46.73223877
230,"MOSCOW MILLS MO",10,1,0,0,1,1,-90.91833496,38.94809341
230,"MOSES LAKE WA",10,8,3,1,4,8,-119.2802811,47.12987137
230,"MOSS POINT MS",10,2,0,1,1,2,-88.53965759,30.40934944
230,"MOULTON AL",10,1,0,0,1,1,-87.29332733,34.48143387
230,"MOULTRIE GA",10,5,2,0,3,5,-83.78891754,31.18035507
230,"MOUND MN",10,1,1,0,0,1,-93.66635132,44.93652725
230,"MOUNDSVILLE WV",10,65,12,18,35,65,-80.74716949,39.92013931
230,"MOUNT HOLLY NC",10,4,0,2,2,4,-81.0157547,35.29826736
230,"MOUNT HOLLY NJ",10,3,0,1,2,3,-74.78692627,39.99301147
230,"MOUNT HOREB WI",10,1,0,1,0,1,-89.7384491,43.00873566
230,"MOUNT JULIET TN",10,3,2,0,1,3,-86.51877594,36.19998932
230,"MOUNT LEBANON PA",10,1,0,0,1,1,-80.04911804,40.35546494
230,"MOUNT MORRIS MI",10,2,1,1,0,2,-83.69506073,43.11864471
230,"MOUNT PLEASANT MI",10,4,1,0,3,4,-84.76785278,43.59777832
230,"MOUNT PLEASANT SC",10,5,2,1,2,5,-79.86242676,32.79427719
230,"MOUNT PLEASANT TX",10,1,0,0,1,1,-94.96855927,33.15682602
230,"MOUNT POCONO PA",10,1,0,1,0,1,-75.36369324,41.12226868
230,"MOUNT PROSPECT IL",10,1,0,0,1,1,-87.93763733,42.0663414
230,"MOUNT RAINIER MD",10,13,5,3,5,13,-76.96430206,38.9414978
230,"MOUNT STERLING KY",10,2,1,1,0,2,-83.94326782,38.05655289
230,"MOUNT VERNON GA",10,1,0,0,1,1,-82.59407806,32.17881012
230,"MOUNT VERNON IL",10,5,1,0,4,5,-88.90307617,38.31738663
230,"MOUNT VERNON IN",10,3,1,0,2,3,-87.89586639,37.93523407
230,"MOUNT VERNON NY",10,4,0,2,0,2,-76.36322403,41.83351135
230,"MOUNT VERNON OH",10,1,1,0,0,1,-82.48577118,40.3935585
230,"MOUNT WASHINGTON KY",10,1,0,0,1,1,-85.5454483,38.05005264
230,"MOUNTAIN HOME AR",10,4,2,1,1,4,-92.38542175,36.33543015
230,"MOUNTAIN HOME ID",10,2,1,0,1,2,-115.6928406,43.13270187
230,"MOUNTAIN VIEW AR",10,1,0,0,1,1,-92.11795807,35.86831665
230,"MOUNTAIN VIEW CA",10,78,19,29,30,78,-122.0861969,37.3859024
230,"MOUNTAIN WI",10,1,1,0,0,1,-88.47368622,45.18442154
230,"MOUNTLAKE TERRACE WA",10,5,1,1,3,5,-122.3119507,47.78780365
230,"MUKILTEO WA",10,1,1,0,0,1,-122.3008041,47.94359589
230,"MULBERRY FL",10,1,0,1,0,1,-81.97315979,27.89601898
230,"MUNCIE IN",10,73,12,24,37,73,-85.38398743,40.18970871
230,"MUNDELEIN IL",10,3,0,0,3,3,-88.00391388,42.26291275
230,"MUNFORD TN",10,1,0,0,1,1,-89.81508636,35.44957352
230,"MUNFORDVILLE KY",10,5,0,5,0,5,-85.89085388,37.27248383
230,"MUNISING MI",10,1,0,1,0,1,-86.64807892,46.410923
230,"MUNSTER IN",10,1,0,0,1,1,-87.51268768,41.56475449
230,"MURFREESBORO TN",10,68,11,27,30,68,-86.39038086,35.84575653
230,"MURPHY TX",10,2,1,1,0,2,-96.61357117,33.01515198
230,"MURRAY KY",10,20,5,6,9,20,-88.31504059,36.61037827
230,"MURRAY UT",10,3,1,1,1,3,-111.8896103,40.66687012
230,"MURRIETA CA",10,11,2,5,4,11,-117.2157898,33.55398941
230,"MURRYSVILLE PA",10,1,0,1,0,1,-79.69709015,40.4287529
230,"MUSCATINE IA",10,4,1,1,2,4,-91.05540466,41.4216156
230,"MUSKEGON MI",10,14,2,2,3,7,-86.25441742,43.23139763
230,"MUSKOGEE OK",10,34,6,10,18,34,-95.36999512,35.74824142
230,"MUSTANG OK",10,1,0,0,1,1,-97.72509766,35.38425446
230,"MYRTLE BEACH SC",10,15,1,7,7,15,-78.88601685,33.69656372
230,"NACOGDOCHES TX",10,7,2,3,2,7,-94.6559906,31.60386467
230,"NAMPA ID",10,14,1,5,8,14,-116.5658188,43.54054642
230,"NANTUCKET MA",10,2,0,1,1,2,-70.09862518,41.28360748
230,"NAPA CA",10,11,2,4,5,11,-122.2872086,38.29692841
230,"NAPERVILLE IL",10,80,18,27,35,80,-88.14768219,41.78578949
230,"NAPLES FL",10,53,8,21,24,53,-81.79434204,26.14280128
230,"NAPOLEON OH",10,1,1,0,0,1,-84.12521362,41.39214706
230,"NAPPANEE IN",10,1,0,0,1,1,-86.00133514,41.44298935
230,"NARBERTH PA",10,1,1,0,0,1,-75.25990295,40.00860596
230,"NASHUA NH",10,5,4,0,1,5,-71.46669769,42.76576996
230,"NASHVILLE GA",10,1,0,0,1,1,-83.24996185,31.20802689
230,"NATALIA TX",10,1,0,1,0,1,-98.86307526,29.19000626
230,"NATCHITOCHES LA",10,2,1,0,1,2,-93.08662415,31.76096535
230,"NATICK MA",10,2,1,1,0,2,-71.3484726,42.2836113
230,"NAUGATUCK CT",10,12,5,2,5,12,-73.04972076,41.4863205
230,"NEBRASKA CITY NE",10,1,0,1,0,1,-95.85987854,40.67683411
230,"NEDERLAND CO",10,1,0,1,0,1,-105.5114899,39.96115494
230,"NEEDHAM MA",10,82,19,22,41,82,-71.21767426,42.27159119
230,"NEENAH WI",10,2,1,0,1,2,-88.4626236,44.18569183
230,"NELIGH NE",10,1,1,0,0,1,-98.03055573,42.128685
230,"NEOGA IL",10,1,0,1,0,1,-88.45291901,39.31969833
230,"NEOSHO MO",10,3,1,2,0,3,-94.36846161,36.86910629
230,"NETTLETON MS",10,2,1,1,0,2,-88.62237549,34.08900452
230,"NEW ALBANY IN",10,14,8,4,2,14,-85.80917358,38.29167938
230,"NEW BALTIMORE MI",10,1,1,0,0,1,-82.73680115,42.68103409
230,"NEW BEDFORD MA",10,5,1,3,1,5,-70.93328857,41.63626862
230,"NEW BERLIN WI",10,1,0,0,1,1,-88.1087265,42.97659683
230,"NEW BERN NC",10,19,3,4,12,19,-77.04354095,35.10897827
230,"NEW BRAUNFELS TX",10,57,10,13,34,57,-98.12486267,29.70325089
230,"NEW BRITAIN CT",10,2,1,1,0,2,-72.77884674,41.6615181
230,"NEW BRUNSWICK NJ",10,7,4,2,1,7,-74.45104218,40.48620987
230,"NEW CARROLLTON MD",10,5,1,2,2,5,-76.8794632,38.97011185
230,"NEW CASTLE DE",10,32,9,8,15,32,-75.56227875,39.66440964
230,"NEW CASTLE PA",10,4,1,2,1,4,-80.34657288,41.00389481
230,"NEW FREEDOM PA",10,1,0,0,1,1,-76.70059967,39.73806763
230,"NEW HARMONY IN",10,5,3,1,1,5,-87.93526459,38.12969589
230,"NEW HAVEN CT",10,417,106,136,175,417,-72.92726898,41.3084259
230,"NEW HOPE PA",10,2,2,0,0,2,-74.95053864,40.36468124
230,"NEW IBERIA LA",10,3,0,1,2,3,-91.81869507,30.0039444
230,"NEW KENSINGTON PA",10,1,0,1,0,1,-79.76441956,40.57001114
230,"NEW LONDON CT",10,5,1,1,3,5,-72.09841156,41.35572815
230,"NEW LONDON MN",10,6,1,4,1,6,-94.94470978,45.30108261
230,"NEW MADRID MO",10,6,3,1,2,6,-89.52796936,36.58650589
230,"NEW MARTINSVILLE WV",10,1,1,0,0,1,-80.85782623,39.64151764
230,"NEW MELLE MO",10,1,0,1,0,1,-90.87984467,38.71007538
230,"NEW ORLEANS LA",10,1529,384,443,702,1529,-90.07525635,29.95483589
230,"NEW PALTZ NY",10,3,0,0,3,3,-74.08605194,41.74787903
230,"NEW PHILADELPHIA OH",10,1,0,0,1,1,-81.44538879,40.48986053
230,"NEW PORT RICHEY FL",10,16,7,2,7,16,-82.71899414,28.24477577
230,"NEW PROVIDENCE NJ",10,1,0,1,0,1,-74.40058136,40.69844055
230,"NEW RICHMOND WI",10,1,0,1,0,1,-92.53678131,45.12298965
230,"NEW ROCHELLE NY",10,8,1,1,6,8,-73.78160858,40.91175842
230,"NEW SMYRNA BEACH FL",10,2,0,2,0,2,-80.92392731,29.0242157
230,"NEW YORK NY",10,5613,1534,1619,2460,5613,-74.00528717,40.7145195
230,"NEWARK CA",10,6,1,3,2,6,-122.0424347,37.5296669
230,"NEWARK DE",10,79,24,28,27,79,-75.74462128,39.68774414
230,"NEWARK NJ",10,338,86,102,150,338,-74.17185211,40.73570633
230,"NEWARK OH",10,4,2,0,2,4,-82.40110779,40.05843353
230,"NEWBERG OR",10,5,3,0,2,5,-122.9754334,45.29994202
230,"NEWBERRY SC",10,2,0,0,2,2,-81.61828613,34.2746582
230,"NEWBURGH IN",10,7,2,2,3,7,-87.40516663,37.94437027
230,"NEWBURGH NY",10,12,4,3,5,12,-74.00939941,41.50367737
230,"NEWBURYPORT MA",10,5,0,1,4,5,-70.8768692,42.81164551
230,"NEWINGTON CT",10,1,0,1,0,1,-72.72303772,41.69794464
230,"NEWMAN CA",10,1,0,0,1,1,-121.0232544,37.31364059
230,"NEWNAN GA",10,7,2,5,0,7,-84.79645538,33.37108231
230,"NEWPORT KY",10,2,1,0,1,2,-84.49560547,39.09162521
230,"NEWPORT NEWS VA",10,29,4,11,14,29,-76.42758942,36.97909927
230,"NEWPORT OR",10,3,1,0,2,3,-124.0554047,44.6362915
230,"NEWPORT RI",10,21,3,7,11,21,-71.31213379,41.49024963
230,"NEWPORT TN",10,2,0,0,2,2,-83.18756104,35.96707916
230,"NEWTON IL",10,6,0,4,2,6,-88.16280365,38.99100876
230,"NEWTON MA",10,44,10,13,21,44,-71.20809937,42.33743286
230,"NEWTON NC",10,6,3,1,2,6,-81.22117615,35.67030334
230,"NEWTON NJ",10,1,0,0,1,1,-74.7516861,41.0583992
230,"NEWTOWN PA",10,4,2,0,2,4,-74.93606567,40.22966003
230,"NIAGARA FALLS NY",10,28,6,11,11,28,-79.05632019,43.09456253
230,"NICEVILLE FL",10,1,0,0,1,1,-86.50150299,30.52109146
230,"NICHOLASVILLE KY",10,2,1,1,0,2,-84.57271576,37.88071442
230,"NILES IL",10,2,0,0,2,2,-87.80277252,42.01877594
230,"NILES MI",10,1,0,1,0,1,-86.25424194,41.82971573
230,"NILES OH",10,3,1,1,1,3,-80.76469421,41.18286133
230,"NISKAYUNA NY",10,4,1,1,2,4,-73.84505463,42.77999115
230,"NIXA MO",10,69,15,21,33,69,-93.29502869,37.04324341
230,"NOBLE OK",10,1,0,0,1,1,-97.39689636,35.13511658
230,"NOBLESVILLE IN",10,16,5,3,8,16,-86.01766205,40.03728104
230,"NOCONA TX",10,6,2,3,1,6,-97.72662354,33.78715515
230,"NOEL MO",10,8,1,3,4,8,-94.4858551,36.54568481
230,"NOLANVILLE TX",10,1,1,0,0,1,-97.60596466,31.07933617
230,"NOLENSVILLE TN",10,2,1,1,0,2,-86.66940308,35.95249557
230,"NORCROSS GA",10,21,8,6,7,21,-84.21324158,33.94129181
230,"NORFOLK MA",10,1,0,1,0,1,-71.32408142,42.11960602
230,"NORFOLK VA",10,304,86,74,144,304,-76.28334045,36.84831619
230,"NORMAL IL",10,29,3,12,14,29,-88.99052429,40.51409912
230,"NORMAN OK",10,87,23,26,38,87,-97.44689178,35.22203827
230,"NORRISTOWN PA",10,2,0,1,1,2,-75.33937836,40.12155151
230,"NORTH ADAMS MA",10,2,1,0,1,2,-73.10797882,42.70087814
230,"NORTH ANDOVER MA",10,6,3,2,1,6,-71.13425446,42.69897079
230,"NORTH ARLINGTON NJ",10,1,1,0,0,1,-74.13215637,40.78865814
230,"NORTH AUGUSTA SC",10,4,0,1,3,4,-81.96509552,33.5021019
230,"NORTH BEND OR",10,1,0,0,1,1,-124.2263718,43.40610886
230,"NORTH BEND WA",10,13,4,6,3,13,-121.7899017,47.49547195
230,"NORTH BERGEN NJ",10,41,11,15,15,41,-74.0112381,40.8045845
230,"NORTH BERWICK ME",10,1,0,0,1,1,-70.73209381,43.30367661
230,"NORTH CANTON OH",10,1,1,0,0,1,-81.40194702,40.87594223
230,"NORTH CHARLESTON SC",10,14,3,2,9,14,-79.97457886,32.85499191
230,"NORTH CHICAGO IL",10,5,0,2,3,5,-87.8412323,42.3254509
230,"NORTH EAST MD",10,1,0,0,1,1,-75.94083405,39.60018539
230,"NORTH EAST PA",10,3,2,1,0,3,-79.83345795,42.21583176
230,"NORTH HAVEN ME",10,1,0,1,0,1,-68.87295532,44.13141251
230,"NORTH LAS VEGAS NV",10,10,4,2,4,10,-115.1192093,36.19900131
230,"NORTH LIBERTY IA",10,1,1,0,0,1,-91.59856415,41.74905777
230,"NORTH LITTLE ROCK AR",10,36,5,11,20,36,-92.26677704,34.76465988
230,"NORTH MANCHESTER IN",10,1,0,1,0,1,-85.76879883,41.00079346
230,"NORTH MIAMI BEACH FL",10,1,0,0,1,1,-80.16223907,25.93397713
230,"NORTH MIAMI FL",10,21,1,9,11,21,-80.18624115,25.8908596
230,"NORTH OGDEN UT",10,2,1,0,1,2,-111.9736023,41.30478668
230,"NORTH OLMSTED OH",10,2,0,0,2,2,-81.92334747,41.41566849
230,"NORTH PLATTE NE",10,7,1,3,3,7,-100.7660141,41.12404633
230,"NORTH POLE AK",10,2,1,1,0,2,-147.3626251,64.7430191
230,"NORTH PORT FL",10,2,2,0,0,2,-82.23706055,27.04372597
230,"NORTH READING MA",10,1,0,0,1,1,-71.0776062,42.57518387
230,"NORTH RIDGEVILLE OH",10,1,0,1,0,1,-82.04491425,41.37031937
230,"NORTH RIVERSIDE IL",10,3,1,0,2,3,-87.82305908,41.84282684
230,"NORTH SALT LAKE UT",10,2,1,1,0,2,-111.9105759,40.85150528
230,"NORTH SYRACUSE NY",10,1,0,0,1,1,-76.12913513,43.13497543
230,"NORTH WALES PA",10,1,0,0,1,1,-75.27763367,40.21118927
230,"NORTHAMPTON MA",10,35,10,16,9,35,-72.64012146,42.32544708
230,"NORTHBROOK IL",10,2,0,1,1,2,-87.82922363,42.12767792
230,"NORTHFIELD MN",10,1,0,1,0,1,-93.16210175,44.45811081
230,"NORTHGLENN CO",10,2,0,0,2,2,-104.9886932,39.88547516
230,"NORTHLAKE IL",10,1,0,0,1,1,-87.89591217,41.91732407
230,"NORTHPORT AL",10,4,1,2,1,4,-87.57746124,33.22927856
230,"NORTHPORT MI",10,1,0,0,1,1,-85.61663818,45.13160324
230,"NORTHPORT NY",10,4,2,1,1,4,-73.34220123,40.90099335
230,"NORTON SHORES MI",10,1,1,0,0,1,-86.26406097,43.16886902
230,"NORWALK CA",10,3,0,2,1,3,-118.0839539,33.90219116
230,"NORWALK CT",10,9,2,2,5,9,-73.40729523,41.11759949
230,"NORWALK OH",10,3,1,0,2,3,-82.61576843,41.24267197
230,"NORWICH CT",10,16,3,5,8,16,-72.07475281,41.52449036
230,"NORWOOD MA",10,1,1,0,0,1,-71.1987915,42.19477844
230,"NORWOOD OH",10,3,0,1,2,3,-84.45967865,39.15586853
230,"NOVATO CA",10,21,10,5,6,21,-122.576561,38.11727142
230,"NOVI MI",10,7,1,3,3,7,-83.47566223,42.48064423
230,"NUTLEY NJ",10,9,3,2,4,9,-74.15930939,40.82229996
230,"NYACK NY",10,6,1,2,3,6,-73.91687012,41.09091568
230,"O'FALLON MO",10,34,12,11,11,34,-90.69979095,38.8109436
230,"OAK BLUFFS MA",10,14,0,5,9,14,-70.56096649,41.45436859
230,"OAK BROOK IL",10,3,1,0,2,3,-87.92926788,41.83280945
230,"OAK CREEK WI",10,4,0,3,1,4,-87.86346436,42.88599014
230,"OAK HARBOR WA",10,1,1,0,0,1,-122.6395798,48.29240036
230,"OAK LAWN IL",10,4,1,1,2,4,-87.7545929,41.721138
230,"OAK PARK IL",10,16,6,3,7,16,-87.78443909,41.88500595
230,"OAK PARK MI",10,12,2,1,3,6,-84.21956253,42.40898132
230,"OAK RIDGE TN",10,7,1,5,1,7,-84.26974487,36.01036072
230,"OAKDALE LA",10,19,1,5,13,19,-92.66092682,30.8165493
230,"OAKDALE MN",10,1,0,0,1,1,-92.95690155,44.98758316
230,"OAKLAND CA",10,1470,374,446,650,1470,-122.2733154,37.80438614
230,"OAKLAND MD",10,2,0,1,0,1,-77.64079285,39.19859505
230,"OAKLAND PARK FL",10,4,2,1,1,4,-80.13152313,26.1731205
230,"OBERLIN OH",10,9,2,1,6,9,-82.21720886,41.29413223
230,"OBLONG IL",10,3,1,0,2,3,-87.90914154,39.00207138
230,"OCALA FL",10,10,5,0,5,10,-82.13973236,29.18780708
230,"OCEAN CITY MD",10,4,2,0,2,4,-75.08437347,38.33656311
230,"OCEAN SPRINGS MS",10,1,0,0,1,1,-88.82833862,30.41417313
230,"OCEANSIDE CA",10,154,37,50,67,154,-117.3814011,33.19587326
230,"OCOEE FL",10,1,0,1,0,1,-81.54336548,28.56987
230,"ODESSA MO",10,2,0,0,2,2,-93.95418549,38.99940491
230,"ODESSA TX",10,11,5,1,5,11,-102.3682938,31.84587097
230,"OGALLALA NE",10,17,3,8,6,17,-101.7200775,41.1279068
230,"OGDEN UT",10,49,9,13,27,49,-111.9730225,41.22582626
230,"OGDENSBURG NY",10,4,1,2,1,4,-75.48552704,44.69423294
230,"OHIO IL",10,1,0,1,0,1,-89.46100616,41.55773544
230,"OJAI CA",10,13,4,5,4,13,-119.2175903,34.4372139
230,"OKAWVILLE IL",10,1,0,1,0,1,-89.55079651,38.43439865
230,"OKEECHOBEE FL",10,1,0,0,1,1,-80.82913971,27.24450302
230,"OKLAHOMA CITY OK",10,313,81,76,156,313,-97.51699829,35.46761322
230,"OKMULGEE OK",10,2,0,0,2,2,-95.96085358,35.62366486
230,"OLATHE KS",10,129,28,37,64,129,-94.81970215,38.88142395
230,"OLD BRIDGE NJ",10,1,0,0,1,1,-74.36474609,40.41495895
230,"OLD ORCHARD BEACH ME",10,1,0,0,1,1,-70.37640381,43.51769257
230,"OLD SAYBROOK CT",10,2,0,0,2,2,-72.37509918,41.29185104
230,"OLEAN NY",10,6,0,3,3,6,-78.42921448,42.07747269
230,"OLIVE BRANCH MS",10,11,6,3,2,11,-89.82355499,34.96377563
230,"OLYMPIA FIELDS IL",10,1,0,0,1,1,-87.67446899,41.51344299
230,"OLYMPIA WA",10,169,39,49,81,169,-122.8909378,47.04053497
230,"OMAHA NE",10,362,90,103,169,362,-95.93825531,41.25878906
230,"ONALASKA WI",10,1,0,1,0,1,-91.23545074,43.88446808
230,"ONEONTA NY",10,5,0,2,3,5,-75.0631485,42.45296097
230,"ONTARIO CA",10,14,4,3,7,14,-117.6528702,34.06340408
230,"ONTARIO OR",10,1,1,0,0,1,-116.9652557,44.02645111
230,"OPA-LOCKA FL",10,1,0,1,0,1,-80.25005341,25.90292931
230,"OPELIKA AL",10,1,0,1,0,1,-85.3780365,32.64568329
230,"OPELOUSAS LA",10,3,1,1,1,3,-92.08177948,30.53403282
230,"ORANGE CA",10,32,6,7,19,32,-117.8544846,33.7877388
230,"ORANGE CITY IA",10,9,2,2,5,9,-96.05925751,43.00707626
230,"ORANGE PARK FL",10,20,3,9,8,20,-81.70614624,30.16655731
230,"ORANGE TX",10,15,3,4,8,15,-93.73699951,30.09343147
230,"ORANGE VA",10,1,0,0,1,1,-78.11038208,38.2454834
230,"ORANGEBURG SC",10,1,0,1,0,1,-80.86129761,33.48974228
230,"ORCHARD PARK NY",10,1,0,0,1,1,-78.74337006,42.76783371
230,"OREGON CITY OR",10,5,1,1,3,5,-122.6096726,45.35689163
230,"OREGON OH",10,1,0,1,0,1,-83.49133301,41.6401062
230,"OREGON WI",10,1,0,1,0,1,-89.38459778,42.92614746
230,"OREM UT",10,4,1,1,2,4,-111.6960449,40.29695892
230,"ORINDA CA",10,2,0,1,1,2,-122.1821137,37.87714767
230,"ORION IL",10,1,0,0,1,1,-90.38206482,41.35500336
230,"ORLAND PARK IL",10,2,0,0,2,2,-87.85391235,41.63027573
230,"ORLANDO FL",10,849,233,226,390,849,-81.3789978,28.53886795
230,"ORMOND BEACH FL",10,16,1,6,9,16,-81.05541992,29.28623772
230,"OROFINO ID",10,1,0,0,1,1,-116.2569122,46.47922134
230,"OSCEOLA AR",10,5,1,1,3,5,-89.96954346,35.70536041
230,"OSCEOLA IA",10,1,0,1,0,1,-93.76622009,41.03388596
230,"OSCEOLA MILLS PA",10,2,0,2,0,2,-78.27013397,40.85004807
230,"OSHKOSH WI",10,20,3,9,8,20,-88.54268646,44.02453613
230,"OSKALOOSA IA",10,4,1,1,2,4,-92.64469147,41.29632568
230,"OSSINING NY",10,3,2,1,0,3,-73.86093903,41.16327286
230,"OSSIPEE NH",10,1,0,1,0,1,-71.11573029,43.68548965
230,"OSWEGO IL",10,3,1,1,1,3,-88.3513031,41.68288422
230,"OSWEGO NY",10,5,1,0,4,5,-76.50988007,43.45563889
230,"OTTAWA KS",10,3,0,0,3,3,-95.26805878,38.61549759
230,"OTTUMWA IA",10,4,1,0,3,4,-92.41059113,41.01459122
230,"OVERLAND MO",10,4,1,2,1,4,-90.36277008,38.70130157
230,"OVERLAND PARK KS",10,70,18,18,34,70,-94.67124939,38.98216248
230,"OVIEDO FL",10,10,2,5,3,10,-81.20778656,28.67054749
230,"OWATONNA MN",10,11,3,1,7,11,-93.22633362,44.08358383
230,"OWENSBORO KY",10,12,4,3,5,12,-87.11345673,37.77421188
230,"OWENSVILLE MO",10,2,1,0,1,2,-91.50177765,38.34587479
230,"OWINGSVILLE KY",10,2,0,0,2,2,-83.76404572,38.14480591
230,"OWOSSO MI",10,1,0,0,1,1,-84.17687988,42.99795914
230,"OXFORD AL",10,3,0,1,2,3,-85.83503723,33.6145134
230,"OXFORD MI",10,9,1,5,3,9,-83.26428986,42.82481766
230,"OXFORD MS",10,61,16,20,25,61,-89.52319336,34.37203979
230,"OXFORD NC",10,2,0,1,1,2,-78.59002686,36.31116486
230,"OXFORD OH",10,10,3,3,4,10,-84.74536133,39.50694275
230,"OXNARD CA",10,47,10,10,27,47,-119.1790085,34.19766998
230,"OZARK MO",10,6,1,1,4,6,-93.20661163,37.02112198
230,"PACIFIC GROVE CA",10,1,0,0,1,1,-121.9299164,36.62815475
230,"PACIFIC MO",10,2,1,0,1,2,-90.74199677,38.48199081
230,"PACIFIC WA",10,1,1,0,0,1,-122.2527084,47.26421356
230,"PACIFICA CA",10,11,4,3,4,11,-122.4893951,37.61383438
230,"PADUCAH KY",10,48,11,15,22,48,-88.60009766,37.08333206
230,"PALATKA FL",10,1,0,1,0,1,-81.63694763,29.6489048
230,"PALESTINE TX",10,3,1,0,2,3,-95.6313324,31.76263046
230,"PALISADES PARK NJ",10,6,2,1,3,6,-73.9969635,40.84852982
230,"PALM BAY FL",10,9,1,2,6,9,-80.58313751,28.03806496
230,"PALM BEACH FL",10,41,13,8,20,41,-80.03616333,26.70643616
230,"PALM BEACH GARDENS FL",10,4,1,2,1,4,-80.07454681,26.8109169
230,"PALM DESERT CA",10,10,2,2,6,10,-116.3907166,33.72164154
230,"PALM SPRINGS CA",10,89,27,33,29,89,-116.5467758,33.83036423
230,"PALM SPRINGS FL",10,1,0,1,0,1,-80.09664154,26.63662338
230,"PALMDALE CA",10,30,5,9,16,30,-118.118454,34.57925034
230,"PALMER AK",10,2,0,2,0,2,-149.1138458,61.59459305
230,"PALMYRA MO",10,1,1,0,0,1,-91.53061676,39.80343628
230,"PALO ALTO CA",10,53,11,18,24,53,-122.1449661,37.44177628
230,"PANAMA CITY BEACH FL",10,13,6,2,5,13,-85.80211639,30.1792717
230,"PANAMA CITY FL",10,42,13,15,14,42,-85.65970612,30.16412926
230,"PAPILLION NE",10,4,0,2,2,4,-96.04257202,41.15442276
230,"PARADISE CA",10,2,1,0,1,2,-121.6395493,39.74609756
230,"PARADISE VALLEY AZ",10,1,0,0,1,1,-111.9442825,33.53105164
230,"PARAGOULD AR",10,5,2,3,0,5,-90.5002594,36.05854034
230,"PARAMOUNT CA",10,5,0,0,5,5,-118.161644,33.88947678
230,"PARIS IL",10,3,0,2,1,3,-87.69623566,39.61117172
230,"PARIS KY",10,2,0,0,2,2,-84.25283051,38.21011353
230,"PARIS TN",10,1,1,0,0,1,-88.3266983,36.30187225
230,"PARIS TX",10,5,1,1,3,5,-95.55589294,33.66113663
230,"PARK CITY KY",10,1,1,0,0,1,-86.04628754,37.09415436
230,"PARK CITY UT",10,11,2,3,6,11,-111.5018539,40.65143204
230,"PARK RIDGE IL",10,2,0,1,1,2,-87.84063721,42.01109314
230,"PARKER CO",10,25,12,4,9,25,-104.7624359,39.51849365
230,"PARKERSBURG WV",10,7,4,2,1,7,-81.54850006,39.28261948
230,"PARKVILLE MO",10,2,0,0,2,2,-94.68252563,39.19501114
230,"PARMA OH",10,10,1,5,4,10,-81.72257996,41.40510178
230,"PARSONS KS",10,2,0,1,1,2,-95.2614975,37.34062195
230,"PASADENA CA",10,162,39,46,77,162,-118.1466675,34.14794922
230,"PASADENA TX",10,8,1,2,5,8,-95.20979309,29.69150162
230,"PASCAGOULA MS",10,11,5,3,3,11,-88.55257416,30.36789703
230,"PASCO WA",10,7,0,0,7,7,-119.1023636,46.2282753
230,"PASS CHRISTIAN MS",10,1,0,1,0,1,-89.24402618,30.32174683
230,"PASSAIC NJ",10,2,1,0,1,2,-74.12754822,40.8571434
230,"PATASKALA OH",10,1,0,1,0,1,-82.67435455,39.99578094
230,"PATCHOGUE NY",10,1,0,1,0,1,-73.01426697,40.76568985
230,"PATERSON NJ",10,265,60,59,146,265,-74.17102051,40.91714478
230,"PATTEN ME",10,3,0,0,3,3,-68.45036316,45.99417496
230,"PAULSBORO NJ",10,1,0,0,1,1,-75.23970032,39.83067322
230,"PAW PAW MI",10,5,0,1,4,5,-85.89115143,42.21770477
230,"PAWTUCKET RI",10,2,2,0,0,2,-71.38137054,41.87892532
230,"PAYETTE ID",10,5,1,2,2,5,-116.9361572,44.07813263
230,"PAYSON UT",10,4,1,0,3,4,-111.7331848,40.04447937
230,"PEA RIDGE AR",10,1,1,0,0,1,-94.11558533,36.45391464
230,"PEABODY MA",10,1,0,0,1,1,-70.92794037,42.52825928
230,"PEARLAND TX",10,22,6,7,9,22,-95.28644562,29.56411743
230,"PEARSON GA",10,2,1,0,1,2,-82.85235596,31.29817009
230,"PECULIAR MO",10,2,0,2,0,2,-94.4588623,38.71911621
230,"PEKIN IL",10,2,0,0,2,2,-89.64067841,40.56766891
230,"PELAHATCHIE MS",10,1,0,1,0,1,-89.79850006,32.3132019
230,"PELLA IA",10,3,2,1,0,3,-92.92386627,41.40042114
230,"PEMBROKE NC",10,6,2,2,2,6,-79.19446564,34.68062592
230,"PEMBROKE PINES FL",10,22,5,8,9,22,-80.22357941,26.00384903
230,"PENDLETON OR",10,12,5,0,7,12,-118.7900848,45.67152786
230,"PENDLETON SC",10,13,5,3,5,13,-82.78354645,34.65194321
230,"PENNSVILLE NJ",10,2,0,2,0,2,-75.51573944,39.65373993
230,"PENSACOLA FL",10,82,14,25,43,82,-87.21669006,30.42154694
230,"PEORIA AZ",10,27,7,7,13,27,-112.2390747,33.58084106
230,"PEORIA HEIGHTS IL",10,1,0,0,1,1,-89.57430267,40.74733734
230,"PEORIA IL",10,42,8,12,22,42,-89.59487152,40.70241928
230,"PERRIS CA",10,3,0,2,1,3,-117.2306519,33.78261948
230,"PERRY FL",10,1,0,0,1,1,-83.58158875,30.11780548
230,"PERRY GA",10,1,0,1,0,1,-83.73152161,32.45870972
230,"PERRY MI",10,1,1,0,0,1,-84.21952057,42.82634354
230,"PERRY MO",10,1,0,0,1,1,-91.67559814,39.43136215
230,"PERRYSBURG OH",10,13,2,2,9,13,-83.62700653,41.55728531
230,"PERRYVILLE MD",10,1,0,0,1,1,-76.07060242,39.56047821
230,"PERRYVILLE MO",10,21,8,7,6,21,-89.86131287,37.72448349
230,"PERTH AMBOY NJ",10,1,0,0,1,1,-74.26480103,40.5068779
230,"PERU IN",10,1,0,0,1,1,-86.06684875,40.74810028
230,"PETALUMA CA",10,6,1,1,4,6,-122.6394272,38.23221207
230,"PETERSBURG VA",10,3,0,1,2,3,-77.40148926,37.2280426
230,"PFLUGERVILLE TX",10,7,2,0,5,7,-97.62039948,30.4396553
230,"PHARR TX",10,2,0,0,2,2,-98.1840744,26.19566154
230,"PHELPS NY",10,2,1,1,0,2,-77.05679321,42.95756912
230,"PHENIX CITY AL",10,3,1,1,1,3,-85.00059509,32.4714241
230,"PHILADELPHIA PA",10,2422,639,696,1087,2422,-75.16322327,39.95243835
230,"PHILADELPHIA TN",10,1,1,0,0,1,-84.40354156,35.67960358
230,"PHILIPPI WV",10,1,1,0,0,1,-80.04271698,39.15179443
230,"PHILLIPS ME",10,2,2,0,0,2,-70.33882904,44.82328033
230,"PHOENIX AZ",10,1021,249,307,465,1021,-112.0752716,33.44825363
230,"PHOENIXVILLE PA",10,3,0,3,0,3,-75.51416779,40.13076401
230,"PICAYUNE MS",10,11,3,1,7,11,-89.67980194,30.52602005
230,"PICO RIVERA CA",10,8,2,1,5,8,-118.0985489,33.983284
230,"PIEDMONT MO",10,1,0,0,1,1,-90.6958847,37.15434647
230,"PIEDMONT SD",10,1,0,1,0,1,-103.3931732,44.23329163
230,"PIKEVILLE KY",10,3,0,1,2,3,-82.51830292,37.47967529
230,"PIKEVILLE NC",10,2,0,1,1,2,-77.98130035,35.49745941
230,"PINE BLUFF AR",10,5,0,2,3,5,-92.00374603,34.22846222
230,"PINE LAWN MO",10,1,1,0,0,1,-90.27862549,38.69482803
230,"PINEBLUFF NC",10,1,0,1,0,1,-79.47153473,35.11040115
230,"PINEHURST NC",10,1,0,0,1,1,-79.46926117,35.19573975
230,"PINELLAS PARK FL",10,4,0,1,3,4,-82.69934845,27.84342194
230,"PINEVILLE LA",10,2,0,0,2,2,-92.43460083,31.32294083
230,"PINSON AL",10,1,0,0,1,1,-86.68317413,33.68905258
230,"PISCATAWAY NJ",10,5,0,0,5,5,-74.3984375,40.49933243
230,"PISMO BEACH CA",10,21,2,4,15,21,-120.6432953,35.1427269
230,"PITTSBORO NC",10,2,0,1,1,2,-79.17662811,35.72052002
230,"PITTSBURG CA",10,30,8,8,14,30,-121.8871613,38.02787781
230,"PITTSBURG KS",10,7,1,3,3,7,-94.70526123,37.41111374
230,"PITTSBURGH PA",10,1277,313,411,553,1277,-79.99537659,40.44091415
230,"PITTSFIELD IL",10,2,0,1,1,2,-90.80554962,39.60787964
230,"PITTSFIELD MA",10,40,11,9,20,40,-73.24451447,42.45004272
230,"PLACENTIA CA",10,1,0,0,1,1,-117.8715134,33.87210464
230,"PLACERVILLE CA",10,17,6,4,7,17,-120.8002701,38.72951508
230,"PLAINFIELD IL",10,5,1,3,1,5,-88.20417786,41.62700653
230,"PLAINFIELD IN",10,1,0,1,0,1,-86.39954376,39.70450974
230,"PLAINFIELD NJ",10,5,1,0,4,5,-74.40673065,40.63404083
230,"PLAINSBORO NJ",10,3,0,1,2,3,-74.59952545,40.33381653
230,"PLANO IL",10,2,1,0,1,2,-88.5372467,41.66307449
230,"PLANO TX",10,156,37,39,80,156,-96.69931793,33.01993942
230,"PLANT CITY FL",10,2,0,1,1,2,-82.11231232,28.01914597
230,"PLANTATION FL",10,15,4,5,6,15,-80.23281097,26.12825966
230,"PLAQUEMINE LA",10,11,3,3,5,11,-91.23427582,30.28962708
230,"PLATTEVILLE WI",10,1,0,0,1,1,-90.47890472,42.73428726
230,"PLATTSBURGH NY",10,4,1,1,2,4,-73.45239258,44.69951248
230,"PLEASANT GARDEN NC",10,1,0,0,1,1,-79.76168823,35.96221161
230,"PLEASANT HILL CA",10,1,0,0,1,1,-122.0632401,37.94770813
230,"PLEASANT HILL MO",10,1,0,1,0,1,-94.26996613,38.78768539
230,"PLEASANTON CA",10,3,0,1,2,3,-121.8771362,37.66220856
230,"PLEASANTON TX",10,1,0,0,1,1,-98.47924042,28.96782303
230,"PLEASANTVILLE OH",10,2,0,0,2,2,-82.52178192,39.81002045
230,"PLOVER WI",10,1,0,0,1,1,-89.54450226,44.45635605
230,"PLUM PA",10,1,0,1,0,1,-79.78238678,40.48848724
230,"PLYMOUTH IN",10,1,1,0,0,1,-86.31345367,41.33988953
230,"PLYMOUTH MA",10,33,4,17,12,33,-70.67458344,41.95769882
230,"PLYMOUTH MI",10,3,1,2,0,3,-83.46985626,42.37141418
230,"PLYMOUTH MN",10,3,0,3,0,3,-93.45163727,45.02838898
230,"POCATELLO ID",10,5,2,1,2,5,-112.4475937,42.87098694
230,"POINT PLEASANT NJ",10,1,1,0,0,1,-74.06723022,40.08329391
230,"POMONA CA",10,19,4,5,10,19,-117.7534485,34.05541611
230,"POMPANO BEACH FL",10,24,7,9,8,24,-80.12407684,26.23855591
230,"PONTIAC MI",10,13,2,6,5,13,-83.29104614,42.63900757
230,"PONTOTOC MS",10,1,0,1,0,1,-88.99865723,34.24829102
230,"POPLAR BLUFF MO",10,34,7,13,14,34,-90.3928833,36.75717545
230,"POQUOSON VA",10,1,1,0,0,1,-76.39202881,37.14147568
230,"PORT ANGELES WA",10,5,3,0,2,5,-123.4329224,48.11795044
230,"PORT ARTHUR TX",10,40,10,8,22,40,-93.93045807,29.90067863
230,"PORT HUENEME CA",10,1,0,0,1,1,-119.1969757,34.14772797
230,"PORT HURON MI",10,6,2,1,3,6,-82.42453766,42.97105026
230,"PORT ORANGE FL",10,12,5,2,5,12,-81.00856781,29.13491631
230,"PORT ORCHARD WA",10,8,4,2,2,8,-122.6369019,47.53696823
230,"PORT ORFORD OR",10,1,0,1,0,1,-124.4993668,42.74531555
230,"PORTAGE MI",10,1,0,1,0,1,-85.57974243,42.20133972
230,"PORTAGE PA",10,2,1,1,0,2,-78.67198181,40.38890076
230,"PORTAGE WI",10,4,0,2,2,4,-89.46311188,43.53891754
230,"PORTAGEVILLE MO",10,1,0,0,1,1,-89.69967651,36.42550278
230,"PORTER OK",10,6,3,2,1,6,-95.5231781,35.87133026
230,"PORTERFIELD WI",10,2,1,1,0,2,-87.79449463,45.15425491
230,"PORTERVILLE CA",10,3,0,1,2,3,-119.0190811,36.06521988
230,"PORTLAND IN",10,2,1,0,1,2,-84.97788239,40.43445969
230,"PORTLAND ME",10,254,66,70,118,254,-70.25403595,43.6618576
230,"PORTLAND OR",10,3050,821,882,1347,3050,-122.6786423,45.52309418
230,"PORTLAND TX",10,1,0,1,0,1,-97.32419586,27.87795258
230,"PORTOLA CA",10,1,1,0,0,1,-120.471283,39.81047058
230,"PORTSMOUTH NH",10,17,2,8,7,17,-70.76164246,43.07198334
230,"PORTSMOUTH VA",10,12,0,4,8,12,-76.29769135,36.83554077
230,"POTEAU OK",10,13,2,5,6,13,-94.623703,35.05377197
230,"POTOSI MO",10,1,1,0,0,1,-90.78826141,37.93638992
230,"POTTSTOWN PA",10,2,1,1,0,2,-75.64894867,40.24571609
230,"POTTSVILLE PA",10,1,1,0,0,1,-76.19465637,40.68566513
230,"POUGHKEEPSIE NY",10,24,8,7,9,24,-73.92034149,41.70055771
230,"POULSBO WA",10,1,0,0,1,1,-122.648819,47.73558426
230,"POULTNEY VT",10,1,0,0,1,1,-73.23524475,43.51735687
230,"POUND VA",10,1,0,0,1,1,-82.60127258,37.12379837
230,"POWAY CA",10,2,0,0,2,2,-117.0376205,32.96272659
230,"POWDER SPRINGS GA",10,1,0,0,1,1,-84.68379974,33.8599205
230,"PRAIRIE VIEW TX",10,2,0,1,1,2,-95.9883194,30.09370232
230,"PRAIRIE VILLAGE KS",10,4,0,3,1,4,-94.63400269,38.99189377
230,"PRATTVILLE AL",10,15,5,2,8,15,-86.45972443,32.46446228
230,"PRESCOTT AZ",10,13,2,4,7,13,-112.4702301,34.54008102
230,"PRESCOTT WI",10,1,0,0,1,1,-92.80226898,44.74862671
230,"PRICHARD AL",10,1,0,0,1,1,-88.07904053,30.739048
230,"PRIEST RIVER ID",10,1,0,0,1,1,-116.906868,48.18558121
230,"PRINCETON NJ",10,42,11,12,19,42,-74.65805817,40.34872055
230,"PRIOR LAKE MN",10,3,0,1,2,3,-93.42295837,44.71300507
230,"PROSPECT PA",10,1,0,0,1,1,-80.04576111,40.90452576
230,"PROSPER TX",10,25,5,5,15,25,-96.80168915,33.23641205
230,"PROVIDENCE RI",10,266,63,72,131,266,-71.40118408,41.82990265
230,"PROVINCETOWN MA",10,341,87,106,148,341,-70.17770386,42.05849075
230,"PROVO UT",10,37,9,14,14,37,-111.6589813,40.23337936
230,"PUEBLO CO",10,50,16,17,17,50,-104.6108551,38.25450516
230,"PULASKI IA",10,1,0,0,1,1,-92.27365112,40.69398499
230,"PULASKI TN",10,1,0,1,0,1,-87.03085327,35.19976807
230,"PULLMAN WA",10,50,12,11,27,50,-117.180481,46.73068619
230,"PUNTA GORDA FL",10,4,1,2,1,4,-82.04517365,26.93050766
230,"PURCELLVILLE VA",10,1,0,1,0,1,-77.71422577,39.13694763
230,"PURVIS MS",10,1,1,0,0,1,-89.41012573,31.14362907
230,"PUYALLUP WA",10,8,2,3,3,8,-122.2927628,47.19064331
230,"QUAKERTOWN PA",10,2,1,0,1,2,-75.33325958,40.44256592
230,"QUAPAW OK",10,1,0,0,1,1,-94.7911377,36.95119095
230,"QUEEN CREEK AZ",10,4,2,1,1,4,-111.6382294,33.25391769
230,"QUINCY IL",10,16,8,4,4,16,-91.41021729,39.9356575
230,"QUINCY MA",10,14,5,4,5,14,-71.00706482,42.24961472
230,"RACINE WI",10,28,9,12,7,28,-87.78296661,42.72628021
230,"RADFORD VA",10,13,0,8,5,13,-80.57588196,37.13208389
230,"RAEFORD NC",10,2,1,0,1,2,-79.22386169,34.98147964
230,"RALEIGH NC",10,742,208,220,314,742,-78.63800049,35.77230835
230,"RAMSEY NJ",10,7,0,4,3,7,-74.13990021,41.05768967
230,"RANCHO CORDOVA CA",10,30,6,4,20,30,-121.3053742,38.58900452
230,"RANCHO MIRAGE CA",10,1,0,1,0,1,-116.4143066,33.73956299
230,"RANCHO PALOS VERDES CA",10,1,0,0,1,1,-118.388916,33.74456406
230,"RANDOLPH MA",10,2,0,1,1,2,-71.03983307,42.1629715
230,"RANDOLPH ME",10,4,3,1,0,4,-69.75239563,44.23274612
230,"RANTOUL IL",10,1,1,0,0,1,-88.15558624,40.31206131
230,"RAPID CITY SD",10,12,4,5,3,12,-103.2325821,44.08078766
230,"RAVENSWOOD WV",10,1,0,0,1,1,-81.75624847,38.95030212
230,"RAYMOND MS",10,4,4,0,0,4,-90.42297363,32.25973892
230,"RAYNE LA",10,1,0,0,1,1,-92.2689209,30.23512268
230,"RAYTOWN MO",10,17,4,5,8,17,-94.46369934,39.00871277
230,"READING PA",10,10,2,2,6,10,-75.9259491,40.33562851
230,"RED BANK NJ",10,1,0,0,1,1,-74.06324768,40.3471756
230,"RED HOOK NY",10,1,1,0,0,1,-73.87477875,41.99516296
230,"RED LAKE FALLS MN",10,1,0,0,1,1,-96.27508545,47.88212967
230,"RED LION PA",10,7,2,2,3,7,-76.60523987,39.9010849
230,"RED OAK TX",10,1,0,0,1,1,-96.80502319,32.51770401
230,"RED WING MN",10,5,2,1,2,5,-92.53401184,44.56221771
230,"REDDING CA",10,17,4,5,8,17,-122.3944626,40.58649826
230,"REDLANDS CA",10,7,2,3,2,7,-117.21064,34.0318718
230,"REDMOND WA",10,91,23,27,41,91,-122.1240006,47.67367172
230,"REDONDO BEACH CA",10,59,25,20,14,59,-118.3907471,33.84916687
230,"REDWOOD CITY CA",10,35,7,13,15,35,-122.2364655,37.48601151
230,"REEDLEY CA",10,3,0,0,3,3,-119.4518738,36.59639359
230,"REIDSVILLE NC",10,10,1,5,4,10,-79.66392517,36.35525513
230,"RENO NV",10,222,52,58,112,222,-119.8160934,39.5294838
230,"RENTON WA",10,44,13,9,22,44,-122.2197342,47.48252487
230,"REPUBLIC MO",10,5,1,2,2,5,-93.48056793,37.12031555
230,"REVERE MA",10,3,1,1,1,3,-71.01091003,42.40863037
230,"REXBURG ID",10,1,0,0,1,1,-111.7915344,43.82584763
230,"REYNOLDSBURG OH",10,1,0,1,0,1,-82.81163788,39.95471191
230,"RIALTO CA",10,7,1,1,5,7,-117.3716126,34.1063118
230,"RICE LAKE WI",10,3,1,0,2,3,-91.73868561,45.5060463
230,"RICHARDSON TX",10,24,4,9,11,24,-96.73020172,32.94840622
230,"RICHFIELD MN",10,25,7,7,11,25,-93.28303528,44.87028503
230,"RICHLAND HILLS TX",10,6,2,1,3,6,-97.22873688,32.81633377
230,"RICHLAND MS",10,2,0,1,1,2,-90.16493225,32.22668076
230,"RICHLAND WA",10,17,5,4,8,17,-119.2866592,46.28547287
230,"RICHMOND CA",10,92,18,41,33,92,-122.3500443,37.9354744
230,"RICHMOND HEIGHTS MO",10,42,19,5,18,42,-90.31951904,38.62892532
230,"RICHMOND IN",10,10,2,4,4,10,-84.8900528,39.82888412
230,"RICHMOND KY",10,7,1,3,3,7,-84.29437256,37.74818802
230,"RICHMOND ME",10,1,1,0,0,1,-69.79788208,44.08757782
230,"RICHMOND MO",10,1,0,1,0,1,-93.97762299,39.2788353
230,"RICHMOND TX",10,3,1,0,2,3,-95.76106262,29.58276558
230,"RICHMOND VA",10,481,130,142,209,481,-77.45962524,37.55412674
230,"RIDGELAND MS",10,10,1,3,6,10,-90.13221741,32.42857742
230,"RIDGEWOOD NJ",10,3,0,2,1,3,-74.11595917,40.97959518
230,"RIDGWAY PA",10,5,3,1,1,5,-78.72838593,41.42049026
230,"RIDLEY PARK PA",10,2,1,1,0,2,-75.32323456,39.88137436
230,"RIFLE CO",10,1,0,0,1,1,-107.7840881,39.53457642
230,"RINGGOLD GA",10,2,0,1,1,2,-85.10852051,34.9195137
230,"RIO RANCHO NM",10,6,1,3,2,6,-106.6682816,35.23852539
230,"RIO VISTA CA",10,2,0,2,0,2,-121.6946182,38.15613556
230,"RIPLEY TN",10,1,0,0,1,1,-89.53194427,35.74080658
230,"RIPON CA",10,2,0,0,2,2,-121.1263886,37.74160385
230,"RIPON WI",10,1,0,0,1,1,-88.83634186,43.8422966
230,"RIVER FALLS WI",10,3,0,3,0,3,-92.62417603,44.86109543
230,"RIVERBANK CA",10,2,0,0,2,2,-120.9370804,37.73581314
230,"RIVERDALE GA",10,10,5,1,4,10,-84.4131012,33.57296371
230,"RIVERDALE IL",10,2,1,0,1,2,-87.633255,41.6336174
230,"RIVERHEAD NY",10,1,0,1,0,1,-72.66098785,40.91713333
230,"RIVERSIDE CA",10,140,38,42,60,140,-117.3973999,33.95311737
230,"RIVERSIDE IL",10,1,1,0,0,1,-87.82324219,41.8351059
230,"RIVERSIDE MO",10,11,1,4,6,11,-94.61373138,39.17760849
230,"RIVERSIDE NJ",10,2,1,0,1,2,-74.95646667,40.03240967
230,"ROANOKE RAPIDS NC",10,1,0,0,1,1,-77.65331268,36.46160889
230,"ROANOKE VA",10,27,7,12,8,27,-79.94111633,37.27119827
230,"ROBBINS IL",10,6,0,2,4,6,-87.70363617,41.64415359
230,"ROBINSON IL",10,16,6,5,5,16,-87.73912048,39.00521469
230,"ROBINSON TX",10,2,0,0,2,2,-97.11503601,31.46778679
230,"ROBSTOWN TX",10,4,0,1,3,4,-97.66947937,27.79080391
230,"ROCHESTER IN",10,2,1,0,1,2,-86.21604919,41.06472015
230,"ROCHESTER MI",10,2,1,0,1,2,-83.13374329,42.68050766
230,"ROCHESTER MN",10,51,11,18,22,51,-92.47042084,44.02156448
230,"ROCHESTER NY",10,413,91,120,202,413,-77.61522675,43.15487671
230,"ROCK FALLS IL",10,1,0,1,0,1,-89.68929291,41.77958298
230,"ROCK HILL SC",10,62,22,12,28,62,-81.02463531,34.92498779
230,"ROCK ISLAND IL",10,7,1,1,5,7,-90.5790329,41.50963593
230,"ROCK SPRINGS WY",10,4,1,2,1,4,-109.2040176,41.58724976
230,"ROCKDALE TX",10,3,2,0,1,3,-97.00177765,30.65601349
230,"ROCKFORD IL",10,46,15,11,20,46,-89.09428406,42.27135086
230,"ROCKFORD MI",10,4,2,0,2,4,-85.56002045,43.12025833
230,"ROCKFORD MN",10,1,0,0,1,1,-93.73521423,45.08799744
230,"ROCKINGHAM NC",10,1,1,0,0,1,-79.77334595,34.9397316
230,"ROCKLIN CA",10,4,2,0,2,4,-121.2383118,38.79031754
230,"ROCKPORT IN",10,1,0,1,0,1,-87.05454254,37.88529205
230,"ROCKPORT MA",10,5,3,2,0,5,-70.61954498,42.65607071
230,"ROCKVILLE CENTRE NY",10,1,1,0,0,1,-73.64044189,40.6588974
230,"ROCKVILLE MD",10,30,8,10,12,30,-77.15235901,39.08402252
230,"ROCKWALL TX",10,28,6,6,16,28,-96.46016693,32.93169022
230,"ROCKY HILL CT",10,9,2,2,5,9,-72.64056396,41.66537857
230,"ROCKY MOUNT NC",10,5,1,2,2,5,-77.78997803,35.93837738
230,"ROCKY MOUNT VA",10,1,0,1,0,1,-79.89165497,36.99800491
230,"ROCKY RIVER OH",10,6,2,1,3,6,-81.83889008,41.4756279
230,"ROGERS AR",10,19,8,2,9,19,-94.11903381,36.33228683
230,"ROGERSVILLE MO",10,1,1,0,0,1,-93.05628967,37.11710358
230,"ROGUE RIVER OR",10,1,0,1,0,1,-123.1744843,42.43546677
230,"ROLLA MO",10,3,1,1,1,3,-91.77151489,37.95161438
230,"ROLLING MEADOWS IL",10,1,0,0,1,1,-88.01329041,42.0840416
230,"ROME GA",10,3,1,0,2,3,-85.16900635,34.24008942
230,"ROME NY",10,2,0,1,1,2,-75.4548645,43.21290207
230,"RONAN MT",10,1,0,0,1,1,-114.1027756,47.52711487
230,"ROSCOE SD",10,2,1,1,0,2,-99.33797455,45.44993591
230,"ROSEBURG OR",10,4,0,3,1,4,-123.3444519,43.21644974
230,"ROSEDALE MS",10,1,0,1,0,1,-91.02830505,33.853508
230,"ROSELLE NJ",10,1,1,0,0,1,-74.2624588,40.66469574
230,"ROSEMEAD CA",10,1,0,0,1,1,-118.0746079,34.08071899
230,"ROSEMOUNT MN",10,1,0,0,1,1,-93.12598419,44.73943329
230,"ROSENBERG TX",10,3,0,1,2,3,-95.80905914,29.5575695
230,"ROSEVILLE CA",10,19,4,6,9,19,-121.2899246,38.75195694
230,"ROSEVILLE MI",10,1,0,0,1,1,-82.93720245,42.49747086
230,"ROSEVILLE MN",10,16,5,3,8,16,-93.14508057,45.02290726
230,"ROSLYN WA",10,1,0,0,1,1,-120.9952545,47.2230072
230,"ROSWELL GA",10,25,5,10,10,25,-84.36141205,34.02328491
230,"ROSWELL NM",10,2,1,0,1,2,-104.5282135,33.39533997
230,"ROUND LAKE IL",10,4,2,1,1,4,-88.09385681,42.35342789
230,"ROUND ROCK TX",10,13,0,6,7,13,-97.67939758,30.50861359
230,"ROWLETT TX",10,3,1,1,1,3,-96.56422424,32.90298462
230,"ROWLEY MA",10,2,0,1,1,2,-70.87771606,42.71709442
230,"ROXANA IL",10,1,0,1,0,1,-90.07637024,38.84868622
230,"ROY UT",10,3,2,0,1,3,-112.035286,41.16501999
230,"ROYAL OAK MI",10,26,7,13,6,26,-83.1442337,42.48933792
230,"ROYERSFORD PA",10,3,1,2,0,3,-75.53735352,40.18464279
230,"RUMSON NJ",10,33,3,12,18,33,-73.99851227,40.37051773
230,"RUSHVILLE IN",10,1,0,0,1,1,-85.45323944,39.6113205
230,"RUSSELLVILLE AR",10,1,0,1,0,1,-93.1343689,35.27845383
230,"RUSTON LA",10,8,2,3,3,8,-92.63848877,32.52357101
230,"RUTHERFORD NJ",10,1,1,0,0,1,-74.10585022,40.82668304
230,"RUTLAND VT",10,2,1,0,1,2,-72.97142029,43.61096954
230,"RYE CO",10,10,3,2,5,10,-104.9316177,37.92366791
230,"RYE NY",10,1,0,0,1,1,-73.68312836,40.98072433
230,"SACKETS HARBOR NY",10,4,1,0,3,4,-76.12520599,43.94608688
230,"SACO ME",10,1,0,0,1,1,-70.4417038,43.50106049
230,"SACRAMENTO CA",10,750,163,211,376,750,-121.4959793,38.58154297
230,"SADDLE BROOK NJ",10,13,3,6,4,13,-74.09207153,40.89922333
230,"SAGINAW MI",10,3,0,2,1,3,-83.95076752,43.41968918
230,"SAGINAW TX",10,1,0,0,1,1,-97.36431885,32.86053848
230,"SAHUARITA AZ",10,202,50,61,91,202,-110.9567032,31.95795059
230,"SALEM IL",10,21,6,7,8,21,-88.94590759,38.62715149
230,"SALEM IN",10,2,1,0,1,2,-86.10127258,38.60612488
230,"SALEM MA",10,16,6,5,5,16,-70.89565277,42.51993179
230,"SALEM MO",10,8,0,4,4,8,-91.53616333,37.64583206
230,"SALEM NH",10,4,0,1,3,4,-71.19998169,42.78861618
230,"SALEM OH",10,2,0,0,2,2,-80.85612488,40.90091705
230,"SALEM OR",10,144,38,43,63,144,-123.0377197,44.94248199
230,"SALEM VA",10,3,1,0,2,3,-80.05405426,37.29384232
230,"SALINA KS",10,6,1,1,4,6,-97.61184692,38.84041977
230,"SALINAS CA",10,74,14,21,39,74,-121.6571732,36.67780304
230,"SALISBURY MD",10,33,11,5,17,33,-75.5984726,38.36100388
230,"SALISBURY NC",10,19,5,5,9,19,-80.47377014,35.67113495
230,"SALT LAKE CITY UT",10,249,56,80,113,249,-111.8912659,40.77029037
230,"SALTILLO MS",10,2,0,2,0,2,-88.68186188,34.37690353
230,"SALTVILLE VA",10,1,0,0,1,1,-81.74578857,36.8660965
230,"SALUDA NC",10,1,0,1,0,1,-82.34889221,35.23649216
230,"SAN ANGELO TX",10,48,11,12,25,48,-100.4379044,31.46401215
230,"SAN ANSELMO CA",10,4,1,1,2,4,-122.5641785,37.97429276
230,"SAN ANTONIO TX",10,1202,278,378,546,1202,-98.49394989,29.42439651
230,"SAN BENITO TX",10,2,0,1,1,2,-97.63174438,26.1331501
230,"SAN BERNARDINO CA",10,52,13,18,21,52,-117.304596,34.12142563
230,"SAN BRUNO CA",10,1,1,0,0,1,-122.4133148,37.63018799
230,"SAN CARLOS CA",10,22,5,5,12,22,-122.262207,37.50718307
230,"SAN CLEMENTE CA",10,7,2,3,2,7,-117.6134033,33.42698669
230,"SAN DIEGO CA",10,1627,405,475,747,1627,-117.1587296,32.71524429
230,"SAN DIMAS CA",10,1,0,0,1,1,-117.8088913,34.10668945
230,"SAN FERNANDO CA",10,3,0,0,3,3,-118.4407349,34.28187561
230,"SAN FRANCISCO CA",10,2282,601,672,1009,2282,-122.4213257,37.77465057
230,"SAN GABRIEL CA",10,2,1,0,1,2,-118.107605,34.09612274
230,"SAN JOSE CA",10,475,111,117,247,475,-121.8973846,37.33491516
230,"SAN JUAN CAPISTRANO CA",10,1,0,1,0,1,-117.6644516,33.50197601
230,"SAN LEANDRO CA",10,39,8,21,10,39,-122.155983,37.70180511
230,"SAN LUIS OBISPO CA",10,32,8,9,15,32,-120.6622849,35.28281021
230,"SAN MARCOS CA",10,11,2,2,7,11,-117.1673966,33.14345551
230,"SAN MARCOS TX",10,100,17,28,55,100,-97.94176483,29.88363266
230,"SAN MATEO CA",10,25,6,7,12,25,-122.3270264,37.56283569
230,"SAN RAFAEL CA",10,11,4,4,3,11,-122.5331726,37.97325134
230,"SAN RAMON CA",10,13,4,1,8,13,-121.9799347,37.77985764
230,"SANDPOINT ID",10,2,0,0,2,2,-116.5548554,48.27656555
230,"SANDUSKY OH",10,2,1,0,1,2,-82.7080307,41.44903183
230,"SANDWICH MA",10,1,1,0,0,1,-70.49419403,41.75436783
230,"SANDY OR",10,39,17,8,14,39,-122.263649,45.39704132
230,"SANDY SPRINGS GA",10,9,2,2,5,9,-84.37850952,33.92443848
230,"SANFORD FL",10,64,18,13,33,64,-81.27256012,28.80128288
230,"SANGER CA",10,16,4,8,4,16,-119.5580063,36.70794296
230,"SANTA ANA CA",10,28,5,12,11,28,-117.8697281,33.74567413
230,"SANTA BARBARA CA",10,115,33,28,54,115,-119.7056656,34.4233017
230,"SANTA CLARA CA",10,53,8,17,28,53,-121.946434,37.34754181
230,"SANTA CRUZ CA",10,117,27,35,55,117,-122.0333557,36.97389984
230,"SANTA FE NM",10,101,24,28,49,101,-105.9468155,35.68014526
230,"SANTA MARIA CA",10,5,1,0,4,5,-120.437973,34.95292664
230,"SANTA MONICA CA",10,147,41,51,55,147,-118.4925232,34.01921082
230,"SANTA PAULA CA",10,1,0,0,1,1,-119.0609283,34.35404587
230,"SANTA ROSA CA",10,116,29,35,52,116,-122.7165146,38.44017792
230,"SANTEE CA",10,1,1,0,0,1,-116.9754105,32.83840942
230,"SAPULPA OK",10,3,0,0,3,3,-96.11476135,35.99878311
230,"SARANAC LAKE NY",10,2,1,0,1,2,-74.1305542,44.32965851
230,"SARASOTA FL",10,26,5,9,12,26,-82.53031158,27.33688736
230,"SARATOGA CA",10,2,0,1,1,2,-122.0252457,37.26384735
230,"SARATOGA SPRINGS NY",10,11,2,4,5,11,-73.78382111,43.08345032
230,"SARATOGA WY",10,1,0,0,1,1,-106.807579,41.45475769
230,"SARTELL MN",10,1,0,1,0,1,-94.20728302,45.62141418
230,"SATELLITE BEACH FL",10,1,1,0,0,1,-80.58939362,28.17677498
230,"SAUGERTIES NY",10,9,3,3,3,9,-73.95199585,42.07786942
230,"SAUK CENTRE MN",10,2,0,0,2,2,-94.95289612,45.73757935
230,"SAUK VILLAGE IL",10,2,1,1,0,2,-87.56780243,41.48827362
230,"SAUSALITO CA",10,7,2,2,3,7,-122.4881592,37.85736847
230,"SAVANNA OK",10,1,1,0,0,1,-95.8442688,34.82937241
230,"SAVANNAH GA",10,223,47,75,101,223,-81.09463501,32.07280731
230,"SAVANNAH MO",10,3,0,0,3,3,-94.83063507,39.94184875
230,"SAXONBURG PA",10,1,1,0,0,1,-79.80976105,40.75429535
230,"SAYBROOK IL",10,1,1,0,0,1,-88.52610016,40.42657089
230,"SAYREVILLE NJ",10,2,0,1,1,2,-74.36043549,40.45940018
230,"SCAPPOOSE OR",10,1,0,0,1,1,-122.8793793,45.75388336
230,"SCHAUMBURG IL",10,5,1,1,3,5,-88.08359528,42.03350449
230,"SCHENECTADY NY",10,6,3,1,2,6,-73.938591,42.81433487
230,"SCOTCH PLAINS NJ",10,2,0,2,0,2,-74.38912964,40.65579605
230,"SCOTLAND NECK NC",10,1,1,0,0,1,-77.41972351,36.12969589
230,"SCOTTSBORO AL",10,1,0,0,1,1,-86.03386688,34.67259216
230,"SCOTTSDALE AZ",10,136,27,49,60,136,-111.9002533,33.50918579
230,"SCRANTON PA",10,21,6,5,10,21,-75.66184998,41.40919113
230,"SCRANTON SC",10,2,1,0,1,2,-79.7436142,33.91777802
230,"SEABROOK TX",10,8,2,6,0,8,-95.02601624,29.56442451
230,"SEAFORD DE",10,6,3,3,0,6,-75.61972809,38.64723206
230,"SEAL BEACH CA",10,3,2,0,1,3,-118.1067505,33.74150848
230,"SEARCY AR",10,1,0,1,0,1,-91.73634338,35.25092697
230,"SEASIDE CA",10,2,0,0,2,2,-121.8542252,36.6110611
230,"SEASIDE OR",10,1,0,0,1,1,-123.9250565,45.99291992
230,"SEAT PLEASANT MD",10,4,1,0,3,4,-76.90610504,38.8963623
230,"SEATTLE WA",10,3283,917,968,1398,3283,-122.3343964,47.60571289
230,"SEBASTIAN FL",10,5,2,1,2,5,-80.47020721,27.81705856
230,"SEBASTOPOL CA",10,3,0,0,3,3,-122.8264999,38.40188217
230,"SECAUCUS NJ",10,1,0,1,0,1,-74.05567169,40.78977585
230,"SEDALIA MO",10,6,2,0,4,6,-93.22884369,38.70438766
230,"SEDONA AZ",10,10,2,2,6,10,-111.7623367,34.86959839
230,"SEGUIN TX",10,17,4,5,8,17,-97.96529388,29.56933594
230,"SELINSGROVE PA",10,3,0,3,0,3,-76.86167145,40.79915619
230,"SELLERSBURG IN",10,2,1,0,1,2,-85.75473785,38.39831543
230,"SELMA CA",10,3,2,0,1,3,-119.6140518,36.57050323
230,"SEMINOLE FL",10,1,1,0,0,1,-82.79083252,27.84035683
230,"SENATOBIA MS",10,1,1,0,0,1,-89.96900177,34.61786652
230,"SENECA FALLS NY",10,2,0,0,2,2,-76.79602814,42.91084671
230,"SENECA SC",10,6,2,0,4,6,-82.95318604,34.68600845
230,"SENECA WI",10,1,1,0,0,1,-90.95878601,43.2650795
230,"SEQUIM WA",10,4,1,3,0,4,-123.1045303,48.07928085
230,"SEVEN MILE OH",10,1,0,0,1,1,-84.55196381,39.48035049
230,"SEVIERVILLE TN",10,4,1,1,2,4,-83.56149292,35.86820984
230,"SEYMOUR CT",10,1,0,0,1,1,-73.0753479,41.39679718
230,"SEYMOUR IN",10,1,0,0,1,1,-85.89046478,38.95923996
230,"SHAFTER CA",10,1,0,0,1,1,-119.2740555,35.50065613
230,"SHAKER HEIGHTS OH",10,144,28,43,73,144,-81.53669739,41.47419357
230,"SHAKOPEE MN",10,3,1,0,2,3,-93.52770233,44.79788971
230,"SHALLOTTE NC",10,1,0,0,1,1,-78.38527679,33.97378159
230,"SHARON MA",10,1,0,1,0,1,-71.17311096,42.12431335
230,"SHARPSVILLE IN",10,3,0,1,2,3,-86.08840179,40.37942886
230,"SHAWNEE KS",10,45,10,12,23,45,-94.7208786,39.0417366
230,"SHAWNEE OK",10,10,4,2,4,10,-96.92608643,35.32754898
230,"SHEBOYGAN WI",10,139,31,46,62,139,-87.71476746,43.75089264
230,"SHEFFIELD LAKE OH",10,1,0,0,1,1,-82.10116577,41.48757935
230,"SHELBY NC",10,1,0,0,1,1,-81.53518677,35.29262543
230,"SHELBYVILLE IL",10,2,2,0,0,2,-88.78992462,39.40638733
230,"SHELBYVILLE IN",10,2,0,1,1,2,-85.77182007,39.5215683
230,"SHELBYVILLE KY",10,4,3,0,1,4,-85.22341156,38.21203232
230,"SHELBYVILLE MO",10,1,1,0,0,1,-92.04193878,39.80587006
230,"SHELBYVILLE TN",10,1,0,0,1,1,-86.46025848,35.4834137
230,"SHELDON IA",10,2,0,1,1,2,-95.8535614,43.18698502
230,"SHELTON CT",10,6,1,4,1,6,-73.09243011,41.31684494
230,"SHEPHERDSVILLE KY",10,1,0,0,1,1,-85.71594238,37.98869324
230,"SHERMAN IL",10,1,0,1,0,1,-89.60519409,39.89391327
230,"SHERMAN TX",10,5,0,1,4,5,-96.60933685,33.63597488
230,"SHERWOOD AR",10,3,0,0,3,3,-92.22438049,34.81515884
230,"SHERWOOD OR",10,3,0,3,0,3,-122.8425446,45.35624313
230,"SHINNSTON WV",10,1,0,1,0,1,-80.29944611,39.39526749
230,"SHIVELY KY",10,7,2,2,3,7,-85.82255554,38.20013809
230,"SHOREVIEW MN",10,2,0,0,2,2,-93.1241684,45.06987762
230,"SHOREWOOD WI",10,1,0,1,0,1,-87.88748932,43.08912277
230,"SHREVEPORT LA",10,116,26,28,62,116,-93.7507019,32.52565002
230,"SHREWSBURY MA",10,1,0,0,1,1,-71.7025528,42.29489517
230,"SIDNEY OH",10,1,1,0,0,1,-84.15549469,40.28426743
230,"SIERRA MADRE CA",10,9,1,3,5,9,-118.0547943,34.16183853
230,"SIERRA VISTA AZ",10,2,1,0,1,2,-110.3048325,31.55449295
230,"SIGNAL MOUNTAIN TN",10,2,0,0,2,2,-85.34446716,35.12252808
230,"SIKESTON MO",10,2,1,1,0,2,-89.5878067,36.87693024
230,"SILOAM GA",10,1,0,0,1,1,-83.08058929,33.53709412
230,"SILOAM SPRINGS AR",10,3,2,0,1,3,-94.54097748,36.18841934
230,"SILSBEE TX",10,1,0,0,1,1,-94.17839813,30.34930038
230,"SILVER CITY NM",10,1,0,0,1,1,-108.281929,32.77336884
230,"SILVERTON OR",10,1,0,1,0,1,-122.7857742,45.00499725
230,"SIMI VALLEY CA",10,20,7,6,7,20,-118.7839508,34.26951981
230,"SIMPSONVILLE SC",10,1,1,0,0,1,-82.25405121,34.73744202
230,"SIMSBURY CT",10,2,0,1,1,2,-72.8000412,41.8762207
230,"SIOUX CITY IA",10,11,3,1,7,11,-96.40085602,42.5001564
230,"SIOUX FALLS SD",10,64,19,18,27,64,-96.73429108,43.54177475
230,"SISTERS OR",10,1,0,0,1,1,-121.5517273,44.29083252
230,"SKANEATELES NY",10,1,0,0,1,1,-76.42854309,42.94717026
230,"SKOKIE IL",10,6,3,1,2,6,-87.73321533,42.03328705
230,"SLIDELL LA",10,24,2,10,12,24,-89.78143311,30.27558708
230,"SLIPPERY ROCK PA",10,1,0,0,1,1,-80.05516052,41.06407928
230,"SMITHTOWN NY",10,1,0,0,1,1,-73.1995163,40.85629654
230,"SMITHVILLE MO",10,2,0,0,2,2,-94.58171082,39.38669586
230,"SMYRNA GA",10,12,1,6,5,12,-84.51447296,33.88409042
230,"SMYRNA TN",10,3,0,0,3,3,-86.51843262,35.98318863
230,"SNOHOMISH WA",10,3,1,0,2,3,-122.1009903,47.91241837
230,"SNYDER TX",10,1,0,0,1,1,-100.9179764,32.71789169
230,"SOCIAL CIRCLE GA",10,29,4,11,14,29,-83.71785736,33.65628433
230,"SOLANA BEACH CA",10,3,1,2,0,3,-117.2725525,32.99123383
230,"SOLDOTNA AK",10,1,0,1,0,1,-151.0635071,60.47569275
230,"SOLEDAD CA",10,1,0,0,1,1,-121.3278732,36.42473984
230,"SOLVANG CA",10,1,0,0,1,1,-120.139946,34.59571075
230,"SOMERS WI",10,2,0,1,1,2,-87.9103775,42.64015579
230,"SOMERSET MA",10,1,1,0,0,1,-71.12979889,41.77045441
230,"SOMERSWORTH NH",10,1,0,1,0,1,-70.86653137,43.26175308
230,"SOMERVILLE MA",10,182,53,51,78,182,-71.09860992,42.38757324
230,"SOMERVILLE NJ",10,1,0,1,0,1,-74.60894775,40.57460785
230,"SONOMA CA",10,6,2,2,2,6,-122.4600754,38.29153061
230,"SONORA CA",10,27,9,5,13,27,-120.3842011,37.98400497
230,"SOUDERTON PA",10,2,0,1,1,2,-75.32456207,40.31177902
230,"SOUTH BELOIT IL",10,1,0,0,1,1,-89.03701782,42.49333191
230,"SOUTH BEND IN",10,107,29,30,48,107,-86.25171661,41.67295837
230,"SOUTH BOUND BROOK NJ",10,1,0,0,1,1,-74.53087616,40.55379105
230,"SOUTH GATE CA",10,52,10,21,21,52,-118.213707,33.95462799
230,"SOUTH HADLEY MA",10,6,2,1,3,6,-72.57582855,42.26013184
230,"SOUTH HOLLAND IL",10,5,0,2,3,5,-87.60710144,41.60099792
230,"SOUTH HOUSTON TX",10,7,2,4,1,7,-95.23612976,29.66330719
230,"SOUTH JORDAN UT",10,2,2,0,0,2,-111.9315186,40.56394577
230,"SOUTH LAKE TAHOE CA",10,21,5,7,9,21,-119.972786,38.94574356
230,"SOUTH MIAMI FL",10,4,0,1,3,4,-80.29296875,25.70849991
230,"SOUTH PITTSBURG TN",10,2,0,1,1,2,-85.70410156,35.01231766
230,"SOUTH PLAINFIELD NJ",10,1,1,0,0,1,-74.41103363,40.57961655
230,"SOUTH PORTLAND ME",10,4,0,2,2,4,-70.23975372,43.6415062
230,"SOUTH RIVER NJ",10,5,1,1,3,5,-74.38522339,40.44672394
230,"SOUTH SAN FRANCISCO CA",10,3,0,1,2,3,-122.4101868,37.65430069
230,"SOUTH SIOUX CITY NE",10,1,0,0,1,1,-96.4140625,42.47398376
230,"SOUTH TUCSON AZ",10,1,0,0,1,1,-110.9697952,32.19969177
230,"SOUTHAMPTON NY",10,80,16,32,32,80,-72.38861084,40.88444519
230,"SOUTHAVEN MS",10,3,1,1,1,3,-90.02496338,34.99386215
230,"SOUTHERN PINES NC",10,3,0,1,2,3,-79.39178467,35.17448425
230,"SOUTHFIELD MI",10,12,4,3,5,12,-83.22153473,42.47357559
230,"SOUTHGATE MI",10,1,0,1,0,1,-83.19342804,42.2142067
230,"SOUTHINGTON CT",10,4,2,2,0,4,-72.8768158,41.59680557
230,"SOUTHLAKE TX",10,4,2,1,1,4,-97.13466644,32.94153214
230,"SOUTHPORT NC",10,1,0,0,1,1,-78.01985931,33.9217453
230,"SOUTHWICK MA",10,1,0,0,1,1,-72.76921844,42.05488205
230,"SPARKS NV",10,14,6,3,5,14,-119.7548142,39.53468704
230,"SPARTA GA",10,1,1,0,0,1,-82.97600555,33.27603531
230,"SPARTA IL",10,2,0,1,1,2,-89.70211792,38.12332535
230,"SPARTA KY",10,1,0,0,1,1,-84.90686798,38.67728806
230,"SPARTA NC",10,1,0,1,0,1,-81.12025452,36.50556946
230,"SPARTANBURG SC",10,70,19,18,33,70,-81.93160248,34.94982529
230,"SPEARFISH SD",10,1,0,0,1,1,-103.8635941,44.49181366
230,"SPEEDWAY IN",10,104,24,31,49,104,-86.2671051,39.80224609
230,"SPENCER OK",10,1,0,1,0,1,-97.3780365,35.52297974
230,"SPIRO OK",10,3,0,2,1,3,-94.62031555,35.24132538
230,"SPOKANE WA",10,178,43,70,65,178,-117.4281387,47.65847015
230,"SPRING CITY PA",10,1,0,0,1,1,-75.54719543,40.17708588
230,"SPRING HILL TN",10,3,1,1,1,3,-86.93003845,35.75111389
230,"SPRING LAKE MI",10,1,1,0,0,1,-86.19725037,43.07686234
230,"SPRINGDALE AR",10,7,0,5,2,7,-94.12921143,36.1869278
230,"SPRINGDALE OH",10,1,0,1,0,1,-84.48524475,39.28693008
230,"SPRINGFIELD IL",10,115,29,37,49,115,-89.6439743,39.80184174
230,"SPRINGFIELD MA",10,52,7,20,25,52,-72.57289124,42.10980606
230,"SPRINGFIELD MO",10,648,184,162,302,648,-93.29862213,37.21548843
230,"SPRINGFIELD NJ",10,1,1,0,0,1,-74.31019592,40.72328568
230,"SPRINGFIELD OH",10,5,0,3,2,5,-83.80889893,39.92424011
230,"SPRINGFIELD OR",10,1,0,0,1,1,-123.024704,44.04590988
230,"SPRINGFIELD PA",10,1,0,0,1,1,-75.31934357,39.93074036
230,"SPRINGFIELD TN",10,4,1,1,2,4,-86.88502502,36.50941086
230,"SPRINGFIELD VT",10,2,1,1,0,2,-72.48161316,43.29873657
230,"SPRINGTOWN TX",10,1,0,1,0,1,-97.68406677,32.96629715
230,"ST LOUIS MO",10,11620,3351,2767,5502,11620,-90.19819641,38.62716675
230,"STAMFORD CT",10,19,5,4,10,19,-73.53807068,41.05353165
230,"STANLEY ND",10,1,0,1,0,1,-102.3895187,48.31685638
230,"STANWOOD WA",10,4,0,3,1,4,-122.3728256,48.24087524
230,"STAPLES MN",10,5,2,2,1,5,-94.79264069,46.35538483
230,"STARKVILLE MS",10,18,7,5,6,18,-88.81492615,33.46545029
230,"STATE COLLEGE PA",10,38,11,12,15,38,-77.85973358,40.79336929
230,"STATESBORO GA",10,28,4,8,16,28,-81.78266907,32.44914246
230,"STATESVILLE NC",10,1,1,0,0,1,-80.88671875,35.78310013
230,"STAUNTON IL",10,3,1,2,0,3,-89.79161072,39.01238632
230,"STAUNTON VA",10,1,0,0,1,1,-79.07145691,38.14970016
230,"STEAMBOAT SPRINGS CO",10,4,1,1,2,4,-106.8292313,40.48627853
230,"STEELTON PA",10,1,0,1,0,1,-76.84079742,40.23532486
230,"STEELVILLE MO",10,8,0,2,6,8,-91.35505676,37.96838379
230,"STEPHENS CITY VA",10,2,1,1,0,2,-78.217659,39.08377075
230,"STEPHENVILLE TX",10,1,1,0,0,1,-98.20308685,32.22081757
230,"STERLING HEIGHTS MI",10,12,4,3,5,12,-83.03016663,42.58047485
230,"STEUBENVILLE OH",10,3,1,0,2,3,-80.63353729,40.36983871
230,"STEVENS POINT WI",10,14,2,3,9,14,-89.57467651,44.52337265
230,"STILLWATER MN",10,1,0,1,0,1,-92.80657959,45.05171967
230,"STILLWATER OK",10,10,1,3,6,10,-97.0588913,36.11580658
230,"STOCKBRIDGE GA",10,11,4,4,3,11,-84.23356628,33.54455185
230,"STOCKTON CA",10,249,50,87,112,249,-121.293457,37.95776749
230,"STOKESDALE NC",10,1,0,1,0,1,-79.97875977,36.23734283
230,"STONE MOUNTAIN GA",10,17,3,2,12,17,-84.14538574,33.8065033
230,"STONEHAM MA",10,3,1,1,1,3,-71.09869385,42.48027039
230,"STORY CITY IA",10,1,0,0,1,1,-93.59599304,42.18712616
230,"STOUGHTON MA",10,3,1,0,2,3,-71.10134888,42.12547302
230,"STOUGHTON WI",10,1,0,0,1,1,-89.21815491,42.91680145
230,"STOW MA",10,1,0,1,0,1,-71.50474548,42.43725204
230,"STOW OH",10,5,2,0,3,5,-81.44025421,41.1593895
230,"STOWE VT",10,1,0,0,1,1,-72.68366241,44.46540451
230,"STRATFORD CT",10,4,1,1,2,4,-73.13223267,41.18459702
230,"STROUDSBURG PA",10,1,0,1,0,1,-75.19365692,40.98681259
230,"STUART FL",10,16,7,4,5,16,-80.25237274,27.19645882
230,"STUART VA",10,1,0,1,0,1,-80.26490784,36.64115906
230,"STURGEON BAY WI",10,1,0,1,0,1,-87.37574005,44.83692169
230,"STUTTGART AR",10,5,2,2,1,5,-91.55264282,34.50066376
230,"SUDBURY MA",10,1,0,0,1,1,-71.409729,42.38088989
230,"SUFFOLK VA",10,38,8,14,16,38,-76.58317566,36.72846985
230,"SUGAR CREEK MO",10,1,1,0,0,1,-94.44507599,39.10963821
230,"SUGAR LAND TX",10,13,2,4,7,13,-95.6352005,29.61997795
230,"SULLIVAN MO",10,5,1,1,3,5,-91.16096497,38.20802689
230,"SULPHUR LA",10,2,1,1,0,2,-93.37752533,30.23687744
230,"SULPHUR OK",10,2,2,0,0,2,-96.96926117,34.5080719
230,"SULPHUR ROCK AR",10,1,0,0,1,1,-91.50110626,35.75118637
230,"SUMMERVILLE SC",10,26,3,11,12,26,-80.17547607,33.01868439
230,"SUMMIT NJ",10,1,0,0,1,1,-74.3586731,40.74148178
230,"SUMNER WA",10,1,0,1,0,1,-122.2424011,47.20277405
230,"SUMTER SC",10,8,1,4,3,8,-80.34135437,33.92088318
230,"SUN PRAIRIE WI",10,2,0,0,2,2,-89.21392059,43.18373108
230,"SUNBURY PA",10,1,0,1,0,1,-76.79363251,40.86275864
230,"SUNNYVALE CA",10,34,14,11,9,34,-122.0380707,37.36878967
230,"SUNNYVALE TX",10,2,1,0,1,2,-96.56118774,32.7967453
230,"SUNRISE FL",10,4,1,1,2,4,-80.2282486,26.14059067
230,"SUNSET LA",10,1,0,1,0,1,-92.06873322,30.41154289
230,"SUPERIOR CO",10,4,0,4,0,4,-105.169548,39.95254517
230,"SURFSIDE BEACH SC",10,4,0,1,3,4,-78.97283173,33.6062355
230,"SURFSIDE FL",10,1,0,1,0,1,-80.12493134,25.87931252
230,"SUSQUEHANNA PA",10,1,1,0,0,1,-75.59903717,41.94361877
230,"SUTHERLIN OR",10,3,2,0,1,3,-123.3144531,43.38960648
230,"SUWANEE GA",10,4,1,2,1,4,-84.0713501,34.05178452
230,"SWANSEA IL",10,5,1,1,3,5,-89.98918152,38.53406143
230,"SWARTHMORE PA",10,1,1,0,0,1,-75.34899139,39.90222549
230,"SWEDESBORO NJ",10,3,0,0,3,3,-75.3094635,39.74773026
230,"SWEENY TX",10,6,2,2,2,6,-95.69893646,29.03920364
230,"SWEETWATER TN",10,1,0,0,1,1,-84.46063232,35.60184479
230,"SWEETWATER TX",10,1,0,0,1,1,-100.4070358,32.47128296
230,"SWISHER IA",10,2,1,0,1,2,-91.69330597,41.84576416
230,"SYLACAUGA AL",10,5,0,4,1,5,-86.25159454,33.17354202
230,"SYLVA NC",10,3,1,0,2,3,-83.22544861,35.37376022
230,"SYLVANIA OH",10,42,9,14,19,42,-83.71266174,41.71902466
230,"SYRACUSE NY",10,291,86,88,117,291,-76.14653015,43.04846191
230,"TACOMA WA",10,301,74,90,137,301,-122.4466705,47.25242233
230,"TAHLEQUAH OK",10,7,3,2,2,7,-94.9703064,35.91559982
230,"TAKOMA PARK MD",10,7,4,3,0,7,-77.00667572,38.97793198
230,"TALLAHASSEE FL",10,185,53,50,82,185,-84.27896881,30.44669914
230,"TALLMADGE OH",10,1,0,1,0,1,-81.44173431,41.10177231
230,"TALLULA IL",10,2,0,2,0,2,-89.93762207,39.94442749
230,"TALLULAH LA",10,1,0,0,1,1,-91.18704987,32.40855789
230,"TAMARAC FL",10,2,0,1,1,2,-80.22389984,26.19458199
230,"TAMPA FL",10,877,211,251,415,877,-82.4580307,27.94833755
230,"TANEYTOWN MD",10,1,0,1,0,1,-77.17409515,39.65792084
230,"TAOS NM",10,13,4,6,3,13,-105.5769424,36.40658188
230,"TARBORO NC",10,1,0,1,0,1,-77.5349884,35.89706039
230,"TARPON SPRINGS FL",10,77,17,14,46,77,-82.75656128,28.14682198
230,"TARRYTOWN NY",10,1,0,0,1,1,-73.85806274,41.07656097
230,"TAYLOR MI",10,6,1,3,2,6,-83.26967621,42.24112701
230,"TEA SD",10,7,0,3,4,7,-96.83795166,43.44678497
230,"TEANECK NJ",10,57,13,14,30,57,-74.01485443,40.89759064
230,"TEHACHAPI CA",10,4,0,1,3,4,-118.4508972,35.132164
230,"TELL CITY IN",10,1,0,1,0,1,-86.76784515,37.95154953
230,"TELLURIDE CO",10,1,0,1,0,1,-107.8138123,37.93754578
230,"TEMECULA CA",10,22,7,5,10,22,-117.1428146,33.48790741
230,"TEMPE AZ",10,236,60,72,104,236,-111.9108276,33.41504288
230,"TEMPLE CITY CA",10,3,0,2,1,3,-118.0596924,34.10735321
230,"TEMPLE TX",10,9,2,6,1,9,-97.34354401,31.09850502
230,"TERRE HAUTE IN",10,13,3,3,7,13,-87.41414642,39.46681976
230,"TEUTOPOLIS IL",10,1,0,0,1,1,-88.47222137,39.13311386
230,"TEWKSBURY MA",10,13,5,3,5,13,-71.23313904,42.61103439
230,"TEXARKANA AR",10,5,1,1,3,5,-94.03818512,33.44210052
230,"TEXARKANA TX",10,3,0,2,1,3,-94.04785156,33.42536545
230,"TEXAS CITY TX",10,3,0,1,2,3,-94.90317535,29.38432312
230,"THE DALLES OR",10,4,0,1,3,4,-121.1804581,45.59422684
230,"THIBODAUX LA",10,5,3,0,2,5,-90.82309723,29.79626465
230,"THOMASVILLE GA",10,4,0,3,1,4,-83.97835541,30.8371582
230,"THOMPSON ND",10,1,0,1,0,1,-97.10613251,47.77650833
230,"THORNTON CO",10,14,1,6,7,14,-104.9727631,39.86811829
230,"THORNTOWN IN",10,1,0,0,1,1,-86.6064682,40.1297493
230,"THOUSAND OAKS CA",10,11,2,4,5,11,-118.8398514,34.17078018
230,"THREE OAKS MI",10,1,1,0,0,1,-86.61090088,41.7985611
230,"THREE RIVERS MI",10,2,0,1,1,2,-85.63246918,41.94419861
230,"TIFFIN OH",10,2,0,1,1,2,-83.17781067,41.11477661
230,"TIFTON GA",10,3,0,0,3,3,-83.508255,31.4508934
230,"TIGARD OR",10,26,10,4,12,26,-122.7737198,45.4310112
230,"TIGER GA",10,1,0,1,0,1,-83.43260956,34.84734344
230,"TILLAMOOK OR",10,2,0,1,1,2,-123.8468399,45.45576096
230,"TIMPSON TX",10,1,1,0,0,1,-94.39550781,31.90409851
230,"TINLEY PARK IL",10,5,2,1,2,5,-87.78465271,41.57352448
230,"TITUSVILLE FL",10,1,1,0,0,1,-80.80722809,28.61296272
230,"TOCCOA GA",10,1,0,0,1,1,-83.33230591,34.5774498
230,"TOLEDO IA",10,2,0,2,0,2,-92.58429718,41.99272537
230,"TOLEDO OH",10,269,87,67,115,269,-83.55497742,41.66411591
230,"TOMBALL TX",10,7,3,2,2,7,-95.6162262,30.09776115
230,"TOMBSTONE AZ",10,12,2,7,3,12,-110.0689316,31.71310997
230,"TOMS RIVER NJ",10,3,1,1,1,3,-74.19700623,39.95401382
230,"TONAWANDA NY",10,5,1,1,3,5,-78.88004303,43.02050018
230,"TONKAWA OK",10,1,0,1,0,1,-97.3106308,36.67843628
230,"TOOELE UT",10,10,4,3,3,10,-112.3005066,40.53457642
230,"TOPEKA KS",10,74,18,25,31,74,-95.67857361,39.04813766
230,"TOPPENISH WA",10,13,4,0,9,13,-120.3111954,46.37686539
230,"TOPSFIELD MA",10,2,0,2,0,2,-70.94822693,42.6378746
230,"TORONTO KS",10,14,3,3,8,14,-95.94944,37.79908752
230,"TORRANCE CA",10,54,19,15,20,54,-118.3428345,33.8359642
230,"TORRINGTON CT",10,16,4,3,9,16,-73.12056732,41.80105209
230,"TORRINGTON WY",10,3,2,1,0,3,-104.1826859,42.06502533
230,"TOWNSEND MA",10,1,0,0,1,1,-71.7042923,42.66703415
230,"TRACY CA",10,4,0,1,3,4,-121.427269,37.73949814
230,"TRAVERSE CITY MI",10,17,6,4,7,17,-85.6207962,44.76324844
230,"TREASURE ISLAND FL",10,4,2,0,2,4,-82.76873779,27.76968193
230,"TREMONT IL",10,3,1,1,1,3,-89.49304199,40.52783585
230,"TRENTON FL",10,2,0,0,2,2,-82.81704712,29.61356735
230,"TRENTON NJ",10,36,12,11,13,36,-74.74206543,40.21709442
230,"TRENTON OH",10,4,1,0,3,4,-84.45779419,39.48095703
230,"TROY AL",10,6,3,2,1,6,-85.97013855,31.80913544
230,"TROY MI",10,12,0,5,7,12,-83.14983368,42.60589218
230,"TROY MO",10,36,12,11,13,36,-90.98098755,38.979702
230,"TROY NY",10,14,4,3,7,14,-73.69088745,42.72839737
230,"TROY OH",10,13,4,4,5,13,-84.20330811,40.03966141
230,"TRUTH OR CONSEQUENCES NM",10,3,0,1,2,3,-107.2433853,33.13360596
230,"TRYON NC",10,1,0,0,1,1,-82.23826599,35.20822144
230,"TUCKAHOE NY",10,10,2,1,7,10,-73.82630157,40.95046616
230,"TUCKER GA",10,2,2,0,0,2,-84.21690369,33.85486603
230,"TUCSON AZ",10,424,97,133,194,424,-110.9277954,32.22209167
230,"TUKWILA WA",10,1,0,1,0,1,-122.26371,47.47369385
230,"TULARE CA",10,5,0,2,3,5,-119.3488922,36.20763016
230,"TULLAHOMA TN",10,2,1,0,1,2,-86.20916748,35.36205673
230,"TULSA OK",10,272,66,86,120,272,-95.98488617,36.1603241
230,"TUMWATER WA",10,4,3,0,1,4,-122.9116669,47.00710678
230,"TUNKHANNOCK PA",10,1,0,0,1,1,-75.94562531,41.5386734
230,"TUPELO MS",10,13,2,4,7,13,-88.71934509,34.26508713
230,"TURLOCK CA",10,6,1,2,3,6,-120.8488617,37.49431229
230,"TURTLE CREEK PA",10,5,2,0,3,5,-79.8516922,40.39013672
230,"TUSCALOOSA AL",10,75,24,24,27,75,-87.56897736,33.21024704
230,"TUSCUMBIA AL",10,2,1,1,0,2,-87.70251465,34.73139191
230,"TUSTIN CA",10,13,4,3,6,13,-117.8277283,33.74598312
230,"TUTTLE OK",10,1,1,0,0,1,-97.82015991,35.29173279
230,"TWIN FALLS ID",10,10,2,5,3,10,-114.4627686,42.56301498
230,"TYLER TX",10,43,13,7,23,43,-95.3013916,32.35176468
230,"TYRONE GA",10,1,1,0,0,1,-84.59676361,33.47140121
230,"TYRONE PA",10,1,0,0,1,1,-78.23786926,40.67061996
230,"UKIAH CA",10,5,0,2,3,5,-123.2104721,39.15015793
230,"UNION BEACH NJ",10,1,0,0,1,1,-74.17740631,40.44681931
230,"UNION CITY CA",10,5,2,1,2,5,-122.0214462,37.59539032
230,"UNION CITY GA",10,1,0,1,0,1,-84.55107117,33.58210373
230,"UNION ME",10,1,0,0,1,1,-69.27328491,44.21183395
230,"UNION MO",10,9,3,2,4,9,-91.00618744,38.44558716
230,"UNION NJ",10,3,0,2,1,3,-74.26235199,40.69780731
230,"UNION SC",10,2,0,0,2,2,-81.62347412,34.71575165
230,"UNIONTOWN PA",10,5,3,2,0,5,-79.7276535,39.89894104
230,"UNIVERSAL CITY TX",10,1,1,0,0,1,-98.29141235,29.54836273
230,"UNIVERSITY CITY MO",10,131,50,34,47,131,-90.33391571,38.66000748
230,"UNIVERSITY HEIGHTS OH",10,1,0,1,0,1,-81.5369873,41.49779892
230,"UNIVERSITY PLACE WA",10,2,0,1,1,2,-122.5529404,47.2352562
230,"UPLAND CA",10,3,1,1,1,3,-117.6498413,34.09745026
230,"UPPER DARBY PA",10,1,1,0,0,1,-75.27319336,39.92858124
230,"UPPER MARLBORO MD",10,7,1,4,2,7,-76.74905396,38.81620026
230,"UPPER SANDUSKY OH",10,2,0,0,2,2,-83.28137207,40.82746506
230,"UPTON MA",10,1,0,0,1,1,-71.60129547,42.17463303
230,"URBANA IL",10,49,8,14,27,49,-88.20746613,40.11079025
230,"URBANDALE IA",10,2,0,0,2,2,-93.71256256,41.62665176
230,"UTICA NY",10,10,4,1,5,10,-75.23220062,43.10119629
230,"UVALDE TX",10,13,2,4,7,13,-99.78696442,29.20999336
230,"VACAVILLE CA",10,17,6,4,7,17,-121.9900284,38.35633469
230,"VADER WA",10,1,0,1,0,1,-122.962738,46.40246582
230,"VADNAIS HEIGHTS MN",10,1,0,1,0,1,-93.07452393,45.05739975
230,"VALDOSTA GA",10,81,15,29,37,81,-83.27806854,30.83293533
230,"VALLEJO CA",10,70,21,19,30,70,-122.2594299,38.1039505
230,"VALLEY STREAM NY",10,1,0,1,0,1,-73.70756531,40.66439819
230,"VALPARAISO IN",10,33,11,8,14,33,-87.05838013,41.46813583
230,"VAN ALSTYNE TX",10,1,0,1,0,1,-96.57787323,33.42159271
230,"VAN TX",10,2,0,2,0,2,-95.63737488,32.52528
230,"VANCOUVER WA",10,72,19,17,36,72,-122.6816559,45.63534164
230,"VANDALIA IL",10,1,1,0,0,1,-89.09368896,38.96084595
230,"VARNADO LA",10,1,0,1,0,1,-89.82972717,30.89409256
230,"VARNVILLE SC",10,3,0,1,2,3,-81.07863617,32.85089874
230,"VENETA OR",10,3,0,2,1,3,-123.3538208,44.04835129
230,"VENICE FL",10,6,1,2,3,6,-82.45388031,27.10065269
230,"VERMILLION SD",10,6,1,3,2,6,-96.92948914,42.77981949
230,"VERNON TX",10,2,0,2,0,2,-99.26555634,34.15447235
230,"VERO BEACH FL",10,13,3,5,5,13,-80.39705658,27.63908195
230,"VERONA WI",10,2,1,0,1,2,-89.53356171,42.99075699
230,"VERSAILLES KY",10,2,0,1,1,2,-84.73013306,38.05267715
230,"VESTAL NY",10,2,0,1,1,2,-76.05289459,42.08543015
230,"VESTAVIA HILLS AL",10,2,1,0,1,2,-86.78768921,33.44869995
230,"VICKSBURG MS",10,36,7,14,15,36,-90.87818909,32.35280991
230,"VICTOR ID",10,1,0,1,0,1,-111.1136398,43.60249329
230,"VICTORIA TX",10,20,1,4,15,20,-97.00409698,28.80560303
230,"VICTORVILLE CA",10,47,18,12,17,47,-117.2928162,34.53612137
230,"VIDALIA GA",10,7,4,0,3,7,-82.41294098,32.21813965
230,"VIENNA VA",10,34,11,7,16,34,-77.2645874,38.90164566
230,"VIENNA WV",10,4,1,1,2,4,-81.54671478,39.33840179
230,"VILLA PARK IL",10,1,0,0,1,1,-87.98905182,41.88983536
230,"VILLA RICA GA",10,4,1,1,2,4,-84.91907501,33.73210907
230,"VINALHAVEN ME",10,1,0,1,0,1,-68.81904602,44.04660416
230,"VINCENNES IN",10,1,1,0,0,1,-87.5169754,38.68549347
230,"VINE GROVE KY",10,5,1,2,2,5,-85.98104858,37.81027222
230,"VINELAND NJ",10,3,2,0,1,3,-75.02515411,39.48631668
230,"VIRGINIA BEACH VA",10,386,96,113,177,386,-75.97751617,36.8533783
230,"VISALIA CA",10,6,3,1,2,6,-119.2938156,36.33000946
230,"VISTA CA",10,11,2,6,3,11,-117.2447052,33.2000885
230,"VIVIAN LA",10,1,0,0,1,1,-93.98780823,32.87190247
230,"WACO TX",10,63,16,22,25,63,-97.14704895,31.54987144
230,"WAITE PARK MN",10,83,23,21,39,83,-94.224823,45.55731201
230,"WAKE FOREST NC",10,18,6,5,7,18,-78.50919342,35.98039246
230,"WAKEFIELD MA",10,8,0,3,5,8,-71.07489014,42.51018906
230,"WALDOBORO ME",10,2,0,1,1,2,-69.37466431,44.09539795
230,"WALES WI",10,1,0,1,0,1,-88.37697601,43.00463104
230,"WALKER MI",10,1,0,0,1,1,-85.7684021,43.00150299
230,"WALLA WALLA WA",10,8,1,4,3,8,-118.3452072,46.06405258
230,"WALLACE NC",10,2,0,2,0,2,-77.99450684,34.73618317
230,"WALLINGFORD CT",10,2,0,1,1,2,-72.82215118,41.45715332
230,"WALNUT CA",10,1,0,0,1,1,-117.866745,34.02024841
230,"WALNUT CREEK CA",10,12,3,5,4,12,-122.0670624,37.90636826
230,"WALNUT RIDGE AR",10,2,0,1,1,2,-90.95601654,36.06839371
230,"WALNUT SPRINGS TX",10,1,0,1,0,1,-97.75035095,32.05815125
230,"WALPOLE MA",10,13,1,5,7,13,-71.2485199,42.14173889
230,"WALTHAM MA",10,10,3,4,3,10,-71.2346344,42.37656403
230,"WAPPINGERS FALLS NY",10,3,0,1,2,3,-73.91039276,41.59646606
230,"WARDEN WA",10,3,0,1,2,3,-119.0420456,46.96730423
230,"WARE MA",10,2,1,0,1,2,-72.24856567,42.26243591
230,"WARM SPRINGS GA",10,1,1,0,0,1,-84.68063354,32.89083862
230,"WARNER ROBINS GA",10,3,0,1,2,3,-83.59963989,32.62118149
230,"WARREN AR",10,1,1,0,0,1,-92.06491089,33.61291885
230,"WARREN MI",10,226,83,46,97,226,-83.02783203,42.47764969
230,"WARREN OH",10,6,4,1,1,6,-80.81771851,41.23757935
230,"WARRENSBURG MO",10,6,2,2,2,6,-93.73639679,38.76289749
230,"WARRENTON MO",10,2,1,1,0,2,-91.14160919,38.81156921
230,"WARRENTON OR",10,2,2,0,0,2,-123.9260635,46.16466522
230,"WARRENTON VA",10,25,8,9,8,25,-77.79475403,38.71380615
230,"WARSAW IN",10,1,0,0,1,1,-85.85310364,41.23810196
230,"WARSAW NC",10,6,0,3,3,6,-78.09035492,34.99985886
230,"WARSAW NY",10,1,1,0,0,1,-78.13197327,42.74021912
230,"WARWICK RI",10,8,1,4,3,8,-71.37738037,41.69232941
230,"WASCO CA",10,2,0,0,2,2,-119.3427811,35.59425735
230,"WASHINGTON DC",10,10738,2978,3045,4715,10738,-77.01257324,38.88911819
230,"WASHINGTON IA",10,1,0,1,0,1,-91.69322205,41.29916
230,"WASHINGTON MO",10,106,24,23,59,106,-91.01213074,38.55807495
230,"WASHINGTON PA",10,7,1,1,5,7,-80.24552155,40.17398453
230,"WASHINGTON UT",10,1,0,0,1,1,-113.5095291,37.13038635
230,"WASHOUGAL WA",10,12,3,3,6,12,-122.3545303,45.58441925
230,"WASILLA AK",10,23,7,7,9,23,-149.4517059,61.58290482
230,"WATERBURY CT",10,8,2,3,3,8,-73.05029297,41.55849075
230,"WATERLOO IA",10,15,2,4,9,15,-92.34320831,42.49277496
230,"WATERLOO IL",10,3,0,2,1,3,-90.14981842,38.3361702
230,"WATERTOWN NY",10,6,1,3,2,6,-75.9100647,43.97471619
230,"WATERTOWN SD",10,2,1,0,1,2,-97.11455536,44.9015274
230,"WATERTOWN WI",10,9,3,2,4,9,-88.72946167,43.19454193
230,"WATERVILLE ME",10,9,1,3,5,9,-69.63098145,44.55205154
230,"WATSONTOWN PA",10,1,0,1,0,1,-76.86334991,41.08452606
230,"WATSONVILLE CA",10,4,2,1,1,4,-121.7594147,36.90995407
230,"WAUKEE IA",10,2,0,0,2,2,-93.8857193,41.61172485
230,"WAUKEGAN IL",10,8,0,3,5,8,-87.84466553,42.36366653
230,"WAUKESHA WI",10,51,11,7,33,51,-88.23146057,43.01194382
230,"WAUNAKEE WI",10,4,1,0,3,4,-89.45576477,43.19177246
230,"WAUSAU WI",10,18,3,5,10,18,-89.63059998,44.95904922
230,"WAUSEON OH",10,1,0,1,0,1,-84.14173889,41.54945755
230,"WAUWATOSA WI",10,5,0,3,2,5,-88.00754547,43.04960632
230,"WAVERLY NE",10,1,0,1,0,1,-96.52924347,40.9175148
230,"WAXAHACHIE TX",10,8,4,3,1,8,-96.84883118,32.38674545
230,"WAXHAW NC",10,4,1,0,3,4,-80.74282074,34.92486572
230,"WAYCROSS GA",10,3,2,1,0,3,-82.35388184,31.21380043
230,"WAYNE NE",10,2,0,1,1,2,-97.01864624,42.23064804
230,"WAYNE NJ",10,23,3,3,17,23,-74.27560425,40.92553711
230,"WAYNE PA",10,1,0,0,1,1,-75.38678741,40.04436111
230,"WAYNESBORO PA",10,2,0,1,1,2,-77.5769043,39.75597763
230,"WAYNESBORO VA",10,1,0,0,1,1,-78.88896179,38.06871414
230,"WAYNESVILLE MO",10,8,2,3,3,8,-92.20101166,37.8287735
230,"WAYNESVILLE NC",10,2,0,1,1,2,-82.98840332,35.48899078
230,"WEATHERFORD TX",10,3,1,1,1,3,-97.79758453,32.7595253
230,"WEAVERVILLE NC",10,7,2,4,1,7,-82.56031799,35.6974411
230,"WEBSTER GROVES MO",10,3,0,1,2,3,-90.35769653,38.59287262
230,"WEBSTER NY",10,2,0,1,1,2,-77.42967224,43.21234131
230,"WEED CA",10,23,5,12,6,23,-122.388382,41.42225266
230,"WEEHAWKEN NJ",10,5,0,3,2,5,-74.01938629,40.7696991
230,"WEIRTON WV",10,7,0,3,4,7,-80.58799744,40.40523529
230,"WELLESLEY MA",10,6,1,2,3,6,-71.29138947,42.29670715
230,"WELLMAN IA",10,2,0,1,1,2,-91.83855438,41.46408463
230,"WELLSBORO PA",10,1,0,0,1,1,-77.29973602,41.74900436
230,"WELLSBURG NY",10,1,0,1,0,1,-76.72628784,42.01628876
230,"WENATCHEE WA",10,4,1,1,2,4,-120.3128357,47.42322159
230,"WENTZVILLE MO",10,7,2,2,3,7,-90.85335541,38.81171036
230,"WESLACO TX",10,51,9,12,30,51,-97.99131775,26.16018867
230,"WEST ALLIS WI",10,1,0,1,0,1,-88.00700378,43.01686478
230,"WEST BEND WI",10,1,0,1,0,1,-88.18346405,43.42544556
230,"WEST BRANCH IA",10,1,0,1,0,1,-91.34673309,41.67153931
230,"WEST CHESTER OH",10,3,1,0,2,3,-84.40789032,39.33029938
230,"WEST CHESTER PA",10,27,7,7,13,27,-75.60475159,39.96074677
230,"WEST CHICAGO IL",10,4,0,1,3,4,-88.20433807,41.88489914
230,"WEST COVINA CA",10,12,3,3,6,12,-117.9406204,34.0685463
230,"WEST DES MOINES IA",10,17,4,6,7,17,-93.71179962,41.57717514
230,"WEST FARGO ND",10,13,5,3,5,13,-96.90450287,46.87138367
230,"WEST HARTFORD CT",10,30,5,9,16,30,-72.74108887,41.76238251
230,"WEST HAVEN CT",10,2,1,0,1,2,-72.94598389,41.27069473
230,"WEST HOLLYWOOD CA",10,121,41,34,46,121,-118.3634567,34.08982468
230,"WEST JORDAN UT",10,8,1,3,4,8,-111.9405594,40.60975647
230,"WEST LAFAYETTE IN",10,47,7,15,25,47,-86.9082489,40.42613983
230,"WEST LIBERTY KY",10,3,3,0,0,3,-83.25924683,37.92175293
230,"WEST MILTON OH",10,1,0,1,0,1,-84.32810211,39.96263123
230,"WEST MONROE LA",10,3,2,0,1,3,-92.14794922,32.5187645
230,"WEST ORANGE NJ",10,6,0,2,4,6,-74.23833466,40.7989006
230,"WEST ORANGE TX",10,1,0,0,1,1,-93.78001404,30.08396149
230,"WEST PALM BEACH FL",10,151,39,42,70,151,-80.05298615,26.71585464
230,"WEST PLAINS MO",10,7,0,3,4,7,-91.85284424,36.72810745
230,"WEST RICHLAND WA",10,2,1,0,1,2,-119.3632965,46.30400085
230,"WEST SACRAMENTO CA",10,5,0,1,4,5,-121.5324554,38.58049393
230,"WEST SENECA NY",10,1,0,0,1,1,-78.79914856,42.85012436
230,"WEST TX",10,12,6,1,5,12,-97.09226227,31.80267906
230,"WEST VALLEY CITY UT",10,1,0,0,1,1,-111.9695816,40.69639969
230,"WEST WARWICK RI",10,20,5,9,6,20,-71.5218811,41.70644379
230,"WEST YELLOWSTONE MT",10,1,0,0,1,1,-111.1018829,44.66385651
230,"WESTBROOK ME",10,2,1,1,0,2,-70.37012482,43.67708588
230,"WESTERLY RI",10,2,1,1,0,2,-71.82659149,41.37784958
230,"WESTERN SPRINGS IL",10,1,0,0,1,1,-87.90084076,41.80975342
230,"WESTERVILLE OH",10,26,5,11,10,26,-82.92906952,40.12620926
230,"WESTFIELD IN",10,16,3,6,7,16,-86.12757111,40.04309464
230,"WESTFIELD MA",10,2,0,1,1,2,-72.74882507,42.12547302
230,"WESTFIELD NJ",10,16,5,3,8,16,-74.34671783,40.65938187
230,"WESTFORD MA",10,2,1,0,1,2,-71.43686676,42.57947159
230,"WESTLAKE LA",10,2,0,1,1,2,-93.25387573,30.23937988
230,"WESTLAND MI",10,5,2,1,2,5,-83.39988708,42.32430649
230,"WESTMINSTER CO",10,10,4,3,3,10,-105.0385208,39.83644867
230,"WESTMINSTER MD",10,6,1,3,2,6,-76.99542999,39.57574463
230,"WESTMONT IL",10,2,1,1,0,2,-87.97566223,41.79613113
230,"WESTON MA",10,1,0,0,1,1,-71.30235291,42.36714172
230,"WESTPORT CT",10,1,0,0,1,1,-73.35696411,41.14154053
230,"WESTPORT NY",10,26,8,6,12,26,-73.43728638,44.18396759
230,"WESTVILLE OK",10,4,0,1,3,4,-94.56835937,35.99255753
230,"WESTWEGO LA",10,3,1,0,2,3,-90.14245605,29.90624237
230,"WESTWOOD NJ",10,1,0,1,0,1,-74.03186798,40.9915657
230,"WHARTON TX",10,1,0,1,0,1,-96.10342407,29.31210136
230,"WHEAT RIDGE CO",10,2,0,0,2,2,-105.0783615,39.76603317
230,"WHEATON IL",10,27,8,10,9,27,-88.10729218,41.86618805
230,"WHEATON MN",10,1,0,0,1,1,-96.49972534,45.80414581
230,"WHEELING IL",10,6,3,1,2,6,-87.92919159,42.13937759
230,"WHEELING WV",10,23,9,8,6,23,-80.7192688,40.06991577
230,"WHITE BEAR LAKE MN",10,5,3,0,2,5,-93.01039886,45.08457947
230,"WHITE HOUSE TN",10,3,0,2,1,3,-86.65110016,36.47054672
230,"WHITE OAK PA",10,1,0,1,0,1,-79.8089447,40.33785248
230,"WHITE PLAINS NY",10,4,0,2,2,4,-73.76217651,41.03399658
230,"WHITE SETTLEMENT TX",10,1,0,0,1,1,-97.45877838,32.75975037
230,"WHITEFISH MT",10,6,2,0,4,6,-114.3380127,48.41337967
230,"WHITEHALL PA",10,2,1,0,1,2,-79.99015045,40.36117554
230,"WHITEWATER WI",10,10,1,4,5,10,-88.73226166,42.83348846
230,"WHITING IN",10,1,1,0,0,1,-87.49537659,41.68428421
230,"WHITMAN MA",10,1,1,0,0,1,-70.93466187,42.0807991
230,"WHITTIER CA",10,20,5,6,9,20,-118.0349197,33.9793129
230,"WICHITA FALLS TX",10,27,4,12,11,27,-98.49403381,33.91383743
230,"WICHITA KS",10,176,50,54,72,176,-97.3383255,37.69230652
230,"WILDWOOD NJ",10,2,0,0,2,2,-74.81436157,38.99205017
230,"WILKES-BARRE PA",10,5,2,1,2,5,-75.88058472,41.24601746
230,"WILKESBORO NC",10,1,0,0,1,1,-81.16051483,36.1464119
230,"WILKINSBURG PA",10,8,2,2,4,8,-79.88179016,40.44174194
230,"WILLIAMS AZ",10,1,0,1,0,1,-112.1919174,35.24922943
230,"WILLIAMS CA",10,11,4,3,4,11,-122.151535,39.15454483
230,"WILLIAMSBURG VA",10,40,6,8,26,40,-76.70659637,37.27114868
230,"WILLIAMSON WV",10,2,0,1,1,2,-82.27328491,37.67479324
230,"WILLIAMSPORT PA",10,1,1,0,0,1,-77.00060272,41.24121475
230,"WILLIAMSTON MI",10,1,1,0,0,1,-84.28330231,42.68922043
230,"WILLIAMSTOWN KY",10,3,0,2,1,3,-84.56015778,38.63843536
230,"WILLIAMSTOWN MA",10,8,2,2,4,8,-73.21173859,42.70910263
230,"WILLIAMSVILLE NY",10,3,0,1,2,3,-78.73756409,42.96403885
230,"WILLINGBORO NJ",10,4,1,1,2,4,-74.86815643,40.02816391
230,"WILLIS TX",10,1,0,1,0,1,-95.48044586,30.42520714
230,"WILLISTON FL",10,1,0,0,1,1,-82.44662476,29.38799858
230,"WILLISTON ND",10,4,0,2,2,4,-103.6307449,48.14650726
230,"WILLMAR MN",10,3,1,1,1,3,-95.04427338,45.12181473
230,"WILLOUGHBY HILLS OH",10,1,0,0,1,1,-81.41830444,41.598526
230,"WILLOUGHBY OH",10,1,0,1,0,1,-81.40597534,41.63972092
230,"WILLOW SPRINGS IL",10,3,0,1,2,3,-87.8605423,41.74113464
230,"WILLS POINT TX",10,1,0,0,1,1,-96.00700378,32.70846939
230,"WILMETTE IL",10,1,0,0,1,1,-87.72296143,42.07221222
230,"WILMINGTON DE",10,38,8,16,14,38,-75.54558563,39.74601364
230,"WILMINGTON NC",10,68,15,23,30,68,-77.94431305,34.22592926
230,"WILMINGTON OH",10,1,0,0,1,1,-83.82820892,39.44527435
230,"WILSON NC",10,3,0,1,2,3,-77.914711,35.72143173
230,"WILSONVILLE OR",10,1,0,0,1,1,-122.7757416,45.29935455
230,"WINCHESTER KY",10,14,4,8,2,14,-84.17945862,37.99042511
230,"WINCHESTER MA",10,1,1,0,0,1,-71.13614655,42.45266342
230,"WINCHESTER VA",10,19,4,5,10,19,-78.16301727,39.18608475
230,"WINDER GA",10,17,6,1,10,17,-83.71982574,33.99271393
230,"WINDERMERE FL",10,21,4,5,12,21,-81.53463745,28.49615097
230,"WINDHAM OH",10,2,0,0,2,2,-81.04442596,41.23672867
230,"WINDSOR CO",10,1,0,1,0,1,-104.9023056,40.47741699
230,"WINDSOR CT",10,5,3,2,0,5,-72.64279175,41.85288239
230,"WINDSOR MO",10,39,9,12,18,39,-93.5224762,38.53234863
230,"WINDSOR VT",10,1,0,0,1,1,-72.38378906,43.48069
230,"WINFIELD WV",10,1,1,0,0,1,-81.89334106,38.53351212
230,"WINNETKA IL",10,1,0,0,1,1,-87.73626709,42.10827255
230,"WINONA MN",10,10,2,5,3,10,-91.63965607,44.04986572
230,"WINOOSKI VT",10,1,1,0,0,1,-73.18509674,44.49157333
230,"WINSTON-SALEM NC",10,118,24,45,49,118,-80.24356842,36.1001091
230,"WINTER HAVEN FL",10,7,3,2,2,7,-81.73223114,28.02276421
230,"WINTER PARK CO",10,22,3,11,8,22,-105.7649307,39.89161301
230,"WINTER PARK FL",10,61,18,16,27,61,-81.33872223,28.6003685
230,"WINTERS CA",10,1,0,0,1,1,-121.9734039,38.52486038
230,"WISCASSET ME",10,1,0,0,1,1,-69.66466522,44.00312805
230,"WISCONSIN RAPIDS WI",10,2,0,1,1,2,-89.81743622,44.38348007
230,"WITTENBERG WI",10,1,1,0,0,1,-89.16960144,44.82727051
230,"WOBURN MA",10,3,0,1,2,3,-71.15155029,42.47951508
230,"WOLFEBORO NH",10,1,0,0,1,1,-71.1996994,43.58374405
230,"WOODBURN OR",10,2,0,0,2,2,-122.8577652,45.14351273
230,"WOODBURY MN",10,21,2,8,11,21,-92.95999908,44.92368698
230,"WOODBURY NJ",10,8,2,2,4,8,-75.15171051,39.83841705
230,"WOODINVILLE WA",10,5,1,1,3,5,-122.1656876,47.75372314
230,"WOODLAND CA",10,7,3,3,1,7,-121.7751541,38.67827225
230,"WOODSTOCK GA",10,2,0,2,0,2,-84.51925659,34.10178375
230,"WOODSTOCK IL",10,1,0,1,0,1,-88.4488678,42.31498718
230,"WOODSTOCK VA",10,1,1,0,0,1,-78.50556183,38.88199234
230,"WOODSTOWN NJ",10,1,0,0,1,1,-75.32749939,39.65195465
230,"WOONSOCKET RI",10,1,0,0,1,1,-71.51394653,42.00294876
230,"WOOSTER OH",10,11,2,3,6,11,-81.93497467,40.80502319
230,"WORCESTER MA",10,78,18,27,33,78,-71.801651,42.26288986
230,"WORTH IL",10,1,0,0,1,1,-87.79718018,41.68992233
230,"WORTHINGTON MN",10,1,0,1,0,1,-95.5971756,43.62000275
230,"WORTHINGTON OH",10,7,0,4,3,7,-83.01785278,40.09322739
230,"WRIGHT CITY MO",10,3,0,0,3,3,-91.02021027,38.82786942
230,"WYANDOTTE MI",10,4,0,1,3,4,-83.15003204,42.21445465
230,"WYLIE TX",10,5,1,1,3,5,-96.5396347,33.01520157
230,"WYOMING DE",10,1,1,0,0,1,-75.55825043,39.11818314
230,"WYOMING MI",10,6,1,2,3,6,-85.70549011,42.9133873
230,"WYOMING MN",10,4,1,1,2,4,-92.99753571,45.33620453
230,"XENIA OH",10,1,0,0,1,1,-83.92948151,39.68489075
230,"YAKIMA WA",10,12,2,2,8,12,-120.508812,46.60157394
230,"YELLOW SPRINGS OH",10,2,1,1,0,2,-83.88698578,39.80642319
230,"YELM WA",10,3,0,3,0,3,-122.608902,46.94182968
230,"YONKERS NY",10,36,10,10,16,36,-73.89792633,40.93142319
230,"YORK NE",10,3,1,1,1,3,-97.59262848,40.8681221
230,"YORK PA",10,38,9,14,15,38,-76.72687531,39.96264267
230,"YORK SC",10,1,0,0,1,1,-81.24180603,34.99464035
230,"YORKVILLE IL",10,2,0,1,1,2,-88.44723511,41.64102936
230,"YOUNGSTOWN OH",10,448,132,126,190,448,-80.64901733,41.1000061
230,"YPSILANTI MI",10,51,12,18,21,51,-83.61315155,42.24105453
230,"YUCAIPA CA",10,4,0,2,2,4,-117.0447998,34.03347397
230,"YUKON OK",10,5,0,1,4,5,-97.76316071,35.50673294
230,"YUMA AZ",10,24,10,5,9,24,-114.6262665,32.72531128
230,"YUMA CO",10,6,0,1,5,6,-102.7258301,40.12628937
230,"ZACHARY LA",10,2,1,0,1,2,-91.15661621,30.64884186
230,"ZANESVILLE OH",10,5,2,2,1,5,-82.01314545,39.94056702
230,"ZEPHYRHILLS FL",10,1,1,0,0,1,-82.18080902,28.2341938
231,"ABERDEEN MD",11,1,0,1,0,1,-76.16343689,39.50980759
231,"ABERDEEN SD",11,8,4,2,2,8,-98.48273468,45.46180344
231,"ABILENE KS",11,21,5,6,10,21,-97.21461487,38.9171524
231,"ABILENE TX",11,16,2,6,8,16,-99.73384094,32.44894028
231,"ABINGDON VA",11,1,0,0,1,1,-81.97711945,36.7100563
231,"ABINGTON PA",11,3,0,0,3,3,-75.11743164,40.12073898
231,"ABSECON NJ",11,62,21,7,34,62,-74.49462128,39.42850494
231,"ACTON MA",11,4,4,0,0,4,-71.43197632,42.48540115
231,"ACWORTH GA",11,11,4,4,3,11,-84.67662811,34.06597519
231,"ADA OK",11,7,3,0,4,7,-96.67899323,34.77481842
231,"ADAIRSVILLE GA",11,1,0,1,0,1,-84.93426514,34.36875153
231,"ADAMSVILLE TN",11,2,1,1,0,2,-88.39057922,35.23587036
231,"ADDISON IL",11,1,0,0,1,1,-87.98938751,41.93162155
231,"ADDISON TX",11,57,9,13,35,57,-96.82976532,32.96215057
231,"ADEL GA",11,2,2,0,0,2,-83.42346191,31.13760948
231,"ADRIAN MI",11,3,1,1,1,3,-84.03691101,41.89771652
231,"ADRIAN MO",11,1,0,0,1,1,-94.35219574,38.39756775
231,"AHOSKIE NC",11,1,1,0,0,1,-76.98433685,36.28694534
231,"AIKEN SC",11,4,0,1,3,4,-81.71619415,33.55714417
231,"AKRON OH",11,129,30,35,64,129,-81.51885223,41.08151627
231,"AKRON PA",11,2,0,1,1,2,-76.20130157,40.15691757
231,"ALABASTER AL",11,2,1,1,0,2,-86.81655121,33.24436188
231,"ALAMEDA CA",11,91,26,28,37,91,-122.2444763,37.76513672
231,"ALAMOGORDO NM",11,9,2,4,3,9,-105.9584656,32.90003967
231,"ALAMOSA CO",11,5,1,2,2,5,-105.8724442,37.46229935
231,"ALBANY GA",11,9,3,1,5,9,-84.15510559,31.58296013
231,"ALBANY LA",11,7,3,2,2,7,-90.58232117,30.50474739
231,"ALBANY NY",11,239,57,50,132,239,-73.75520325,42.6529007
231,"ALBANY OR",11,4,2,0,2,4,-123.1083984,44.63620758
231,"ALBERTVILLE MN",11,1,0,1,0,1,-93.65481567,45.23791885
231,"ALBION NY",11,2,0,0,2,2,-78.19290924,43.24666595
231,"ALBUQUERQUE NM",11,694,153,184,357,694,-106.6517639,35.08336639
231,"ALEXANDRIA IN",11,1,0,0,1,1,-85.67569733,40.2626915
231,"ALEXANDRIA LA",11,15,6,2,7,15,-92.44517517,31.31143761
231,"ALEXANDRIA MN",11,9,3,3,3,9,-95.37786865,45.88516617
231,"ALEXANDRIA VA",11,253,61,89,103,253,-77.04605103,38.80503082
231,"ALHAMBRA CA",11,1,1,0,0,1,-118.1287003,34.0954628
231,"ALICE TX",11,4,2,2,0,4,-98.07035828,27.7528286
231,"ALICEVILLE AL",11,1,0,1,0,1,-88.15151978,33.12960434
231,"ALIQUIPPA PA",11,5,0,5,0,5,-80.23978424,40.63685608
231,"ALLEGAN MI",11,1,0,1,0,1,-85.85546112,42.52919769
231,"ALLEN PARK MI",11,1,0,1,0,1,-83.21057892,42.25782394
231,"ALLEN TX",11,10,3,2,5,10,-96.67116547,33.10336685
231,"ALLENTOWN PA",11,30,12,8,10,30,-75.46569824,40.60851288
231,"ALLIANCE NE",11,2,2,0,0,2,-102.8736877,42.10169601
231,"ALMA AR",11,1,0,1,0,1,-94.22241974,35.47818375
231,"ALMA GA",11,1,0,1,0,1,-82.46193695,31.53981018
231,"ALMA MI",11,3,2,0,1,3,-84.65994263,43.37918854
231,"ALPHARETTA GA",11,8,4,1,3,8,-84.29410553,34.07542419
231,"ALPINE TX",11,1,1,0,0,1,-103.6622238,30.35860062
231,"ALSIP IL",11,1,0,0,1,1,-87.73867035,41.66915894
231,"ALTAMONTE SPRINGS FL",11,8,2,1,5,8,-81.39485931,28.66284752
231,"ALTON IL",11,41,9,12,20,41,-90.18429565,38.89074326
231,"ALTON TX",11,3,0,2,1,3,-98.30632782,26.28513527
231,"ALTOONA IA",11,1,0,0,1,1,-93.46868896,41.64997482
231,"ALTOONA PA",11,11,2,4,5,11,-78.39411163,40.51860046
231,"ALTUS OK",11,2,0,1,1,2,-99.33457184,34.63834
231,"ALVA OK",11,11,4,5,2,11,-98.66719055,36.80501556
231,"ALVIN TX",11,3,0,1,2,3,-95.24459076,29.42417526
231,"AMARILLO TX",11,51,10,16,25,51,-101.8324051,35.22210312
231,"AMERICAN FORK UT",11,2,0,1,1,2,-111.8032379,40.34251022
231,"AMES IA",11,114,35,31,48,114,-93.61370087,42.02269363
231,"AMHERST MA",11,20,5,3,12,20,-72.5192337,42.37371826
231,"AMHERST NY",11,2,1,0,1,2,-78.79901886,42.9784317
231,"AMHERST OH",11,7,2,4,1,7,-82.22229767,41.39805603
231,"AMITYVILLE NY",11,4,1,1,2,4,-73.41622162,40.67899323
231,"AMORY MS",11,1,0,0,1,1,-88.48745728,33.98094559
231,"AMSTERDAM NY",11,2,0,2,0,2,-74.18743134,42.93893051
231,"ANACORTES WA",11,6,3,2,1,6,-122.6148834,48.51247025
231,"ANAHEIM CA",11,49,6,18,25,49,-117.9165115,33.8354454
231,"ANCHORAGE AK",11,100,17,34,49,100,-149.8811951,61.21649933
231,"ANDERSON IN",11,23,4,10,9,23,-85.68051147,40.1053772
231,"ANDERSON SC",11,8,4,2,2,8,-82.65641785,34.50934219
231,"ANDOVER KS",11,5,3,1,1,5,-97.13726807,37.71379852
231,"ANDOVER MA",11,2,2,0,0,2,-71.13011169,42.65668869
231,"ANGOLA NY",11,2,1,1,0,2,-79.0273056,42.63856506
231,"ANKENY IA",11,6,2,0,4,6,-93.60646057,41.72983551
231,"ANN ARBOR MI",11,285,64,89,132,285,-83.74536896,42.28347015
231,"ANNAPOLIS MD",11,50,7,15,28,50,-76.49166107,38.97844696
231,"ANNAWAN IL",11,1,0,1,0,1,-89.90499115,41.39733887
231,"ANNISTON AL",11,2,1,1,0,2,-85.8313446,33.65997314
231,"ANNVILLE PA",11,3,0,2,1,3,-76.51483917,40.32979584
231,"ANOKA MN",11,6,2,1,3,6,-93.3874588,45.19776535
231,"ANSONIA CT",11,1,0,0,1,1,-73.0779953,41.34640884
231,"ANTIOCH CA",11,10,1,7,2,10,-121.808136,38.0049057
231,"APACHE JUNCTION AZ",11,4,2,2,0,4,-111.5511551,33.41511536
231,"APEX NC",11,6,1,2,3,6,-78.84952545,35.73279572
231,"APOPKA FL",11,11,2,3,6,11,-81.5089798,28.68117523
231,"APPLE VALLEY MN",11,5,4,1,0,5,-93.21794128,44.73189926
231,"APPLETON WI",11,22,3,2,17,22,-88.41551208,44.2618866
231,"ARAB AL",11,67,21,16,30,67,-86.49552917,34.31829453
231,"ARANSAS PASS TX",11,1,1,0,0,1,-97.150383,27.91025734
231,"ARCADIA CA",11,16,4,2,10,16,-118.0368881,34.1397934
231,"ARCADIA FL",11,1,0,0,1,1,-81.85810089,27.21654701
231,"ARCATA CA",11,8,2,3,3,8,-124.08564,40.86624527
231,"ARDEN HILLS MN",11,5,0,2,3,5,-93.15720367,45.05033112
231,"ARDMORE OK",11,2,1,1,0,2,-97.14401245,34.17425156
231,"ARKADELPHIA AR",11,3,0,0,3,3,-93.05423737,34.12095642
231,"ARKANSAS CITY KS",11,2,0,0,2,2,-97.03897858,37.06211472
231,"ARLINGTON HEIGHTS IL",11,12,3,3,6,12,-87.98104858,42.08821106
231,"ARLINGTON MA",11,25,11,1,13,25,-71.15559387,42.41545486
231,"ARLINGTON TN",11,3,2,0,1,3,-89.66139984,35.29637527
231,"ARLINGTON TX",11,224,30,68,126,224,-97.10882568,32.73590469
231,"ARLINGTON WA",11,3,2,0,1,3,-122.1277237,48.19829941
231,"ARNOLD MO",11,5,2,0,3,5,-90.37690735,38.43906784
231,"ARROYO GRANDE CA",11,1,0,1,0,1,-120.5928879,35.11868668
231,"ARTESIA CA",11,4,0,0,4,4,-118.0846176,33.86582184
231,"ARVADA CO",11,6,1,1,4,6,-105.0886612,39.8028183
231,"ASBURY PARK NJ",11,14,5,3,6,14,-74.01100159,40.22047806
231,"ASHEBORO NC",11,12,1,4,7,12,-79.81291199,35.70822525
231,"ASHEVILLE NC",11,238,68,62,108,238,-82.55367279,35.60134888
231,"ASHLAND AL",11,12,6,6,0,12,-85.83626556,33.27382278
231,"ASHLAND IL",11,2,0,0,2,2,-90.00800323,39.88794327
231,"ASHLAND KY",11,3,0,3,0,3,-82.63764954,38.47874069
231,"ASHLAND MA",11,2,2,0,0,2,-71.46256256,42.26143265
231,"ASHLAND MO",11,4,0,1,3,4,-92.25737762,38.77433395
231,"ASHLAND OH",11,3,0,3,0,3,-82.31797028,40.86874771
231,"ASHLAND OR",11,57,14,19,24,57,-122.7111359,42.19425583
231,"ASHLAND VA",11,72,15,19,38,72,-77.47959137,37.75937653
231,"ASHLAND WI",11,10,7,3,0,10,-90.88419342,46.59241104
231,"ASHTABULA OH",11,6,0,3,3,6,-80.78971863,41.86506653
231,"ASPEN CO",11,18,3,6,9,18,-106.8185959,39.19105911
231,"ASTORIA OR",11,9,1,7,1,9,-123.8339157,46.18756866
231,"ATASCADERO CA",11,2,0,1,1,2,-120.6487961,35.47494888
231,"ATCHISON KS",11,3,0,2,1,3,-95.12229919,39.56309128
231,"ATHENS AL",11,2,1,0,1,2,-86.97190857,34.80292892
231,"ATHENS OH",11,27,7,9,11,27,-82.10113525,39.32934952
231,"ATHENS PA",11,13,5,3,5,13,-76.52072906,41.9661293
231,"ATHENS TX",11,4,4,0,0,4,-95.85599518,32.20513916
231,"ATHERTON CA",11,1,1,0,0,1,-122.2001801,37.46142578
231,"ATKINS AR",11,1,0,0,1,1,-92.93680573,35.24659729
231,"ATLANTA GA",11,5075,1315,1455,2305,5075,-84.38757324,33.74927521
231,"ATLANTA LA",11,1,1,0,0,1,-92.73879242,31.8054924
231,"ATLANTA TX",11,1,0,0,1,1,-94.16465759,33.11408615
231,"ATLANTIC BEACH FL",11,5,1,0,4,5,-81.39808655,30.33498573
231,"ATLANTIC CITY NJ",11,25,4,8,13,25,-74.42202759,39.36457062
231,"ATOKA OK",11,1,0,0,1,1,-96.12915039,34.38588333
231,"ATOKA TN",11,1,1,0,0,1,-89.77851868,35.44120789
231,"ATTICA IN",11,2,0,1,1,2,-87.24867249,40.29444122
231,"ATTLEBORO MA",11,5,1,2,2,5,-71.28439331,41.94469833
231,"AUBURN AL",11,39,5,17,17,39,-85.48087311,32.61021423
231,"AUBURN CA",11,362,99,75,188,362,-121.0794067,38.89623642
231,"AUBURN IL",11,1,1,0,0,1,-89.74681854,39.59179688
231,"AUBURN ME",11,5,2,1,2,5,-70.23028564,44.09794235
231,"AUBURN NY",11,1,0,0,1,1,-76.56542969,42.93203735
231,"AUBURN WA",11,12,1,3,8,12,-122.2304688,47.30677795
231,"AUGUSTA KS",11,1,0,1,0,1,-96.97721863,37.68652725
231,"AUGUSTA ME",11,1,0,0,1,1,-69.7781601,44.31053925
231,"AURORA CO",11,98,30,33,35,98,-104.8693161,39.73983765
231,"AURORA IL",11,34,8,14,12,34,-88.32048798,41.76070023
231,"AURORA NY",11,2,1,0,1,2,-76.70005035,42.75400162
231,"AUSTELL GA",11,6,2,0,4,6,-84.63414001,33.81290054
231,"AUSTIN IN",11,1,0,0,1,1,-85.80773163,38.75847626
231,"AUSTIN MN",11,3,0,2,1,3,-92.97491455,43.6665535
231,"AUSTIN TX",11,3712,942,1085,1685,3712,-97.74386597,30.26748466
231,"AUSTINTOWN OH",11,7,2,2,3,7,-80.76424408,41.10162354
231,"AVENAL CA",11,1,0,1,0,1,-120.1306839,36.00422668
231,"AVON CO",11,2,1,0,1,2,-106.5237427,39.63142395
231,"AVON LAKE OH",11,3,1,1,1,3,-82.02809906,41.50548935
231,"AVONDALE AZ",11,13,1,5,7,13,-112.3513947,33.43592072
231,"AZLE TX",11,1,0,1,0,1,-97.54621887,32.89556885
231,"AZUSA CA",11,4,0,3,1,4,-117.9098816,34.13357544
231,"BAINBRIDGE GA",11,2,1,0,1,2,-84.57505798,30.90430069
231,"BAKER LA",11,1,1,0,0,1,-91.16854858,30.58853531
231,"BAKERSFIELD CA",11,103,26,28,49,103,-119.0206375,35.37326813
231,"BALDWIN CITY KS",11,15,5,3,7,15,-95.18656921,38.77522659
231,"BALDWIN NY",11,1,0,0,1,1,-73.60838318,40.65660858
231,"BALDWIN PARK CA",11,2,0,1,1,2,-117.9624786,34.08519363
231,"BALDWINSVILLE NY",11,1,1,0,0,1,-76.33219147,43.15886307
231,"BALDWYN MS",11,7,3,3,1,7,-88.63553619,34.5099411
231,"BALLSTON SPA NY",11,2,0,2,0,2,-73.84790039,43.00103378
231,"BALLWIN MO",11,27,8,4,15,27,-90.54669189,38.5951004
231,"BALLY PA",11,1,0,0,1,1,-75.58628845,40.40263367
231,"BALTIMORE MD",11,1404,342,414,648,1404,-76.6115799,39.29075623
231,"BANDON OR",11,4,2,1,1,4,-124.4105606,43.11890793
231,"BANGOR ME",11,45,16,15,14,45,-68.77653503,44.80109406
231,"BANGOR PA",11,3,0,2,1,3,-75.20609283,40.86587524
231,"BAR HARBOR ME",11,12,4,3,5,12,-68.20309448,44.38752747
231,"BARABOO WI",11,3,1,0,2,3,-89.74446869,43.47089767
231,"BARBOURVILLE KY",11,1,0,1,0,1,-83.88861084,36.86665726
231,"BARDSTOWN KY",11,18,4,0,5,9,-85.46318817,37.810512545
231,"BARGERSVILLE IN",11,1,1,0,0,1,-86.16780853,39.52098083
231,"BARRE VT",11,1,1,0,0,1,-72.50119781,44.19706345
231,"BARRINGTON IL",11,1,0,1,0,1,-88.13623047,42.15398788
231,"BARROW AK",11,2,0,2,0,2,-156.7964325,71.29006195
231,"BARTLESVILLE OK",11,2,0,2,0,2,-95.98135376,36.74737549
231,"BARTLETT IL",11,6,0,4,2,6,-88.18564606,41.9950676
231,"BARTLETT TN",11,5,2,2,1,5,-89.87441254,35.20460892
231,"BARTONVILLE IL",11,75,18,19,38,75,-89.65235138,40.6502037
231,"BARTOW FL",11,2,0,1,1,2,-81.84252167,27.89712715
231,"BASSFIELD MS",11,2,0,2,0,2,-89.73988342,31.49684715
231,"BASTROP LA",11,3,0,1,2,3,-91.91439819,32.77897644
231,"BASTROP TX",11,18,6,9,3,18,-97.31572723,30.11092758
231,"BATESVILLE IN",11,1,1,0,0,1,-85.22227478,39.3000145
231,"BATESVILLE MS",11,4,1,0,3,4,-89.94464874,34.31167603
231,"BATON ROUGE LA",11,331,99,89,143,331,-91.15479279,30.45132256
231,"BATTLE CREEK MI",11,12,2,4,6,12,-85.17985535,42.32100677
231,"BATTLE GROUND WA",11,2,0,0,2,2,-122.5356064,45.78078842
231,"BAXTER SPRINGS KS",11,3,0,0,3,3,-94.73813629,37.02472305
231,"BAY CITY MI",11,9,0,4,5,9,-83.8886261,43.59466171
231,"BAY CITY TX",11,2,0,1,1,2,-95.9697113,28.98308754
231,"BAY LAKE FL",11,1,1,0,0,1,-81.92185974,28.45840073
231,"BAYFIELD WI",11,1,0,0,1,1,-90.81848145,46.81044769
231,"BAYONNE NJ",11,5,2,1,2,5,-74.10975647,40.66794968
231,"BAYTOWN TX",11,19,4,2,13,19,-94.97782135,29.73608589
231,"BEACON NY",11,16,6,4,6,16,-73.9688797,41.50502014
231,"BEAR LAKE MI",11,1,0,0,1,1,-86.14846802,44.42086029
231,"BEARDSLEY MN",11,1,0,1,0,1,-96.71322632,45.55812454
231,"BEAUFORT NC",11,4,1,2,1,4,-76.66288757,34.71848679
231,"BEAUFORT SC",11,9,0,2,7,9,-80.68718719,32.44019699
231,"BEAUMONT CA",11,1,0,1,0,1,-116.9783173,33.9292717
231,"BEAUMONT TX",11,29,7,7,15,29,-94.10238647,30.08622551
231,"BEAVER PA",11,5,0,3,2,5,-80.30450439,40.69532776
231,"BEAVER UT",11,2,1,0,1,2,-112.6483307,38.27668381
231,"BEAVERCREEK OH",11,8,4,0,4,8,-84.06332397,39.70913696
231,"BEAVERTON OR",11,70,21,24,25,70,-122.8055344,45.48670197
231,"BECKLEY WV",11,1,0,0,1,1,-81.18963623,37.77680588
231,"BEDFORD IN",11,3,1,2,0,3,-86.48697662,38.86146164
231,"BEDFORD MA",11,1,1,0,0,1,-71.27526855,42.49069214
231,"BEDFORD NY",11,3,1,1,1,3,-73.64318085,41.204319
231,"BEDFORD TX",11,6,1,2,3,6,-97.14364624,32.8442955
231,"BEDFORD VA",11,1,1,0,0,1,-79.52242279,37.33457184
231,"BEEBE AR",11,2,0,1,1,2,-91.87966156,35.07094574
231,"BEECH GROVE IN",11,2,1,1,0,2,-86.08973694,39.72201157
231,"BEEVILLE TX",11,3,0,1,2,3,-97.7488327,28.40157127
231,"BEL AIR MD",11,4,1,1,2,4,-76.34788513,39.53611374
231,"BELEN NM",11,1,0,1,0,1,-106.7750244,34.65850067
231,"BELL CA",11,1,0,1,0,1,-118.1889572,33.97753906
231,"BELLAIRE TX",11,1,1,0,0,1,-95.4592514,29.70632935
231,"BELLE GLADE FL",11,1,1,0,0,1,-80.66747284,26.68785477
231,"BELLEFONTE PA",11,6,4,1,1,6,-77.77765656,40.91333389
231,"BELLEVIEW FL",11,1,0,0,1,1,-82.06185913,29.05568314
231,"BELLEVILLE IL",11,160,39,49,72,160,-89.98438263,38.52002716
231,"BELLEVILLE MI",11,8,4,2,2,8,-83.48514557,42.20495987
231,"BELLEVUE KY",11,1,0,0,1,1,-84.47879791,39.10644531
231,"BELLEVUE NE",11,7,1,3,3,7,-95.89156342,41.13648224
231,"BELLEVUE OH",11,1,0,1,0,1,-82.84135437,41.27357483
231,"BELLEVUE PA",11,1,0,0,1,1,-80.05105591,40.49424362
231,"BELLEVUE WA",11,60,14,24,22,60,-122.2029648,47.61014557
231,"BELLFLOWER CA",11,7,0,4,3,7,-118.1186295,33.88169479
231,"BELLINGHAM WA",11,173,49,49,75,173,-122.4727402,48.76121521
231,"BELLMAWR NJ",11,14,0,6,8,14,-75.09385681,39.86771774
231,"BELLPORT NY",11,6,2,4,0,6,-72.93808746,40.75737
231,"BELMONT CA",11,3,1,0,2,3,-122.2783508,37.51996613
231,"BELMONT MA",11,1,0,1,0,1,-71.1774292,42.39597321
231,"BELMONT MS",11,2,0,1,1,2,-88.20941162,34.51007462
231,"BELOIT WI",11,1,0,0,1,1,-89.03194427,42.50856781
231,"BELTON MO",11,3,3,0,0,3,-94.53222656,38.81176376
231,"BELTON TX",11,8,1,3,4,8,-97.46511841,31.05611229
231,"BELVIDERE IL",11,4,1,2,1,4,-88.84451294,42.26396942
231,"BEMIDJI MN",11,5,2,2,1,5,-94.88105774,47.47352982
231,"BENBROOK TX",11,5,2,1,2,5,-97.46098328,32.67370987
231,"BEND OR",11,169,52,25,92,169,-121.3171387,44.0577774
231,"BENICIA CA",11,6,0,2,4,6,-122.1603012,38.04900742
231,"BENTON AR",11,2,0,1,1,2,-92.58699036,34.56454468
231,"BENTON HARBOR MI",11,3,0,2,1,3,-86.45429993,42.11692429
231,"BENTON LA",11,1,0,0,1,1,-93.74242401,32.69527817
231,"BENTONVILLE AR",11,10,3,4,3,10,-94.20933533,36.3728447
231,"BEREA OH",11,17,8,6,3,17,-81.85396576,41.36633301
231,"BERGENFIELD NJ",11,3,0,0,3,3,-73.99640656,40.92791748
231,"BERKELEY CA",11,593,171,168,254,593,-122.2752533,37.87145615
231,"BERKLEY MI",11,4,0,0,4,4,-83.18341827,42.50307083
231,"BERLIN MD",11,1,1,0,0,1,-75.21686554,38.32276917
231,"BERRIEN SPRINGS MI",11,2,0,0,2,2,-86.33900452,41.94654846
231,"BERTHOUD CO",11,1,1,0,0,1,-105.0858917,40.30111313
231,"BERWICK ME",11,1,1,0,0,1,-70.86322784,43.26593399
231,"BERWICK PA",11,4,2,1,1,4,-76.23230743,41.05486679
231,"BERWYN IL",11,5,2,0,3,5,-87.79390717,41.85061646
231,"BESSEMER AL",11,8,2,1,5,8,-86.95465851,33.40222549
231,"BESSEMER CITY NC",11,1,0,1,0,1,-81.28375244,35.28520966
231,"BETHALTO IL",11,2,0,1,1,2,-90.04077911,38.90911865
231,"BETHEL PARK PA",11,5,1,2,2,5,-80.01592255,40.33843613
231,"BETHLEHEM PA",11,26,9,4,13,26,-75.36949921,40.62598801
231,"BETTENDORF IA",11,3,2,0,1,3,-90.51612854,41.52465439
231,"BEVERLY HILLS CA",11,70,28,15,27,70,-118.4019775,34.07383347
231,"BEVERLY MA",11,2,1,1,0,2,-70.87913513,42.55848312
231,"BEXLEY OH",11,1,0,0,1,1,-82.93772888,39.96929932
231,"BIDDEFORD ME",11,1,0,0,1,1,-70.45225525,43.49275208
231,"BIG BEAR LAKE CA",11,2,1,1,0,2,-116.91362,34.24382782
231,"BIG RAPIDS MI",11,1,0,1,0,1,-85.48376465,43.69808578
231,"BIG SANDY MT",11,1,0,0,1,1,-110.1191177,48.17901993
231,"BIG SPRING TX",11,1,0,1,0,1,-101.4811173,32.25181198
231,"BIG STONE GAP VA",11,9,3,4,2,9,-82.74668884,36.88179398
231,"BIGFORK MN",11,1,1,0,0,1,-93.65458679,47.74435425
231,"BILLERICA MA",11,2,1,1,0,2,-71.26820374,42.55883408
231,"BILLINGS MT",11,30,12,6,12,30,-108.504631,45.7833786
231,"BILOXI MS",11,12,2,5,5,12,-88.89369202,30.40021133
231,"BINGHAMTON NY",11,38,7,14,17,38,-75.91755676,42.0986557
231,"BIRDSBORO PA",11,3,1,2,0,3,-75.80335236,40.26465225
231,"BIRMINGHAM AL",11,465,131,129,205,465,-86.80226898,33.52098846
231,"BIRMINGHAM MI",11,11,2,3,6,11,-83.21121216,42.54697418
231,"BISBEE AZ",11,46,13,10,23,46,-109.9298477,31.44821548
231,"BISMARCK ND",11,15,4,6,5,15,-100.7789612,46.80673981
231,"BIXBY OK",11,24,5,9,10,24,-95.88382721,35.94215775
231,"BLACK MOUNTAIN NC",11,1,1,0,0,1,-82.32103729,35.61796188
231,"BLACKFOOT ID",11,5,1,2,2,5,-112.3463059,43.1905098
231,"BLACKSBURG VA",11,151,36,43,72,151,-80.41369629,37.22999573
231,"BLAINE MN",11,4,0,1,3,4,-93.23551178,45.171978
231,"BLAINE WA",11,2,1,0,1,2,-122.7500839,48.99335098
231,"BLANCHESTER OH",11,1,1,0,0,1,-83.98893738,39.29340363
231,"BLOOMFIELD HILLS MI",11,3,1,1,1,3,-83.24560547,42.58376312
231,"BLOOMFIELD NJ",11,5,2,3,0,5,-74.18488312,40.8069458
231,"BLOOMINGTON IL",11,24,3,7,14,24,-88.99375916,40.48418045
231,"BLOOMINGTON IN",11,136,41,31,64,136,-86.53382874,39.16920471
231,"BLOOMINGTON MN",11,7,2,1,4,7,-93.29154205,44.82648849
231,"BLOOMSBURG PA",11,3,0,1,2,3,-76.45426178,41.00380325
231,"BLOOMSDALE MO",11,1,1,0,0,1,-90.21808624,38.00960922
231,"BLUE ISLAND IL",11,1,0,0,1,1,-87.67993927,41.657444
231,"BLUE RIDGE TX",11,1,0,0,1,1,-96.40189362,33.2983017
231,"BLUE SPRINGS MO",11,22,6,5,11,22,-94.2820816,39.01689148
231,"BLUFF CITY TN",11,1,0,1,0,1,-82.26051331,36.47451019
231,"BLUFFTON GA",11,5,3,0,2,5,-84.86750031,31.5231266
231,"BLUFFTON SC",11,7,1,2,4,7,-80.86026001,32.23733902
231,"BLYTHEWOOD SC",11,2,0,0,2,2,-80.97387695,34.21453476
231,"BOARDMAN OH",11,1,0,0,1,1,-80.66256714,41.02441788
231,"BOAZ AL",11,1,0,1,0,1,-86.16611481,34.20103073
231,"BOCA RATON FL",11,69,11,20,38,69,-80.08280182,26.35960197
231,"BOILING SPRINGS NC",11,3,0,0,3,3,-81.66678619,35.25450516
231,"BOLINGBROOK IL",11,33,6,13,14,33,-88.06878662,41.69866562
231,"BOLIVAR MO",11,1,0,0,1,1,-93.41101074,37.61450195
231,"BONITA SPRINGS FL",11,7,0,0,7,7,-81.77822876,26.34039497
231,"BONNE TERRE MO",11,1,1,0,0,1,-90.55574036,37.92339325
231,"BONNEY LAKE WA",11,7,0,4,3,7,-122.1883698,47.17679596
231,"BOONE CO",11,3,2,1,0,3,-104.2575378,38.24863815
231,"BOONE NC",11,12,3,3,6,12,-81.67436218,36.21696472
231,"BOONES MILL VA",11,10,3,5,2,10,-79.9546051,37.11700821
231,"BOONVILLE NC",11,2,0,1,1,2,-80.70774841,36.23297882
231,"BORDENTOWN NJ",11,3,1,1,1,3,-74.7159729,40.15003586
231,"BOSCAWEN NH",11,1,0,1,0,1,-71.62001801,43.31507111
231,"BOSSIER CITY LA",11,3,0,1,2,3,-93.73249817,32.51643753
231,"BOSTON MA",11,2612,659,713,1240,2612,-71.05905151,42.35883713
231,"BOTHELL WA",11,30,8,9,13,30,-122.2075424,47.75966263
231,"BOULDER CO",11,211,54,64,93,211,-105.2715302,40.01483917
231,"BOUND BROOK NJ",11,1,0,0,1,1,-74.53753662,40.5687561
231,"BOUNTIFUL UT",11,2,1,1,0,2,-111.8825684,40.88913345
231,"BOWIE MD",11,71,21,12,38,71,-76.77848816,39.00718689
231,"BOWLING GREEN KY",11,37,5,13,19,37,-86.4437027,36.99057388
231,"BOWLING GREEN OH",11,35,10,12,13,35,-83.65102386,41.37505341
231,"BOWMAN SC",11,2,0,0,2,2,-80.68243408,33.34929657
231,"BOXFORD MA",11,6,0,2,4,6,-70.99541473,42.66123581
231,"BOYNTON BEACH FL",11,15,5,5,5,15,-80.066185,26.52592087
231,"BOZEMAN MT",11,44,11,15,18,44,-111.0471649,45.6803093
231,"BRADDOCK PA",11,1,0,0,1,1,-79.86782837,40.4034462
231,"BRADENTON FL",11,11,2,2,7,11,-82.57459259,27.49969101
231,"BRADLEY BEACH NJ",11,1,0,0,1,1,-74.01112366,40.20234299
231,"BRADLEY IL",11,2,0,1,1,2,-87.86099243,41.14196014
231,"BRAINERD MN",11,2,1,1,0,2,-94.20135498,46.35787582
231,"BRANDON MS",11,30,9,10,11,30,-89.98616028,32.27327728
231,"BRANSON MO",11,13,4,3,6,13,-93.21912384,36.64381409
231,"BRATTLEBORO VT",11,1,0,1,0,1,-72.55673981,42.85120392
231,"BRAZORIA TX",11,2,1,0,1,2,-95.56978607,29.04499435
231,"BREA CA",11,3,1,1,1,3,-117.9015732,33.91663361
231,"BREAUX BRIDGE LA",11,1,0,0,1,1,-91.89958954,30.27367973
231,"BRECKENRIDGE CO",11,4,0,1,3,4,-106.0398636,39.48156357
231,"BRECKSVILLE OH",11,5,2,3,0,5,-81.62625122,41.32006836
231,"BREESE IL",11,2,0,0,2,2,-89.52734375,38.61071396
231,"BREMEN IN",11,1,0,0,1,1,-86.14834595,41.44665146
231,"BREMERTON WA",11,26,5,4,17,26,-122.6345291,47.56690598
231,"BRENHAM TX",11,1,1,0,0,1,-96.39807129,30.16748047
231,"BRENTWOOD CA",11,9,2,3,4,9,-121.6984329,37.93167496
231,"BRENTWOOD TN",11,1,0,0,1,1,-86.78275299,36.03345108
231,"BREVARD NC",11,28,6,12,10,28,-82.73400116,35.23363113
231,"BREWER ME",11,4,1,1,2,4,-68.75276184,44.79284286
231,"BREWSTER OH",11,6,0,3,3,6,-81.5980072,40.70691681
231,"BREWSTER WA",11,4,0,2,2,4,-119.7827835,48.09584427
231,"BREWTON AL",11,79,21,23,35,79,-87.07205963,31.10564423
231,"BRIDGEPORT CT",11,36,10,10,16,36,-73.2040863,41.16743088
231,"BRIDGEPORT TX",11,2,0,2,0,2,-97.75536346,33.21035767
231,"BRIDGETON MO",11,3,0,1,2,3,-90.41161346,38.76696396
231,"BRIDGETON NJ",11,1,1,0,0,1,-75.23321533,39.42769623
231,"BRIGHAM CITY UT",11,1,1,0,0,1,-112.0170517,41.50990677
231,"BRIGHTON CO",11,3,1,1,1,3,-104.8175278,39.97783661
231,"BRISTOL CT",11,39,14,11,14,39,-72.94853973,41.67193222
231,"BRISTOL RI",11,1,0,1,0,1,-71.26984406,41.67538452
231,"BRISTOL TN",11,32,9,4,19,32,-82.17338562,36.58886719
231,"BRISTOL VA",11,7,2,2,3,7,-82.18840027,36.59663391
231,"BROCKTON MA",11,20,2,4,14,20,-71.01748657,42.08340454
231,"BROKEN ARROW OK",11,37,12,8,17,37,-95.79160309,36.05273056
231,"BRONSON MI",11,1,1,0,0,1,-85.19442749,41.87239456
231,"BRONXVILLE NY",11,8,2,2,4,8,-73.83145905,40.93828583
231,"BROOKFIELD IL",11,4,2,0,2,4,-87.85184479,41.82412338
231,"BROOKFIELD WI",11,2,0,0,2,2,-88.10640717,43.06070328
231,"BROOKINGS OR",11,6,1,5,0,6,-124.2865219,42.05229187
231,"BROOKINGS SD",11,11,3,4,4,11,-96.79450989,44.3097229
231,"BROOKLINE MA",11,10,4,2,4,10,-71.12002563,42.33176804
231,"BROOKLYN MI",11,1,0,0,1,1,-84.24793243,42.10597992
231,"BROOKLYN PARK MN",11,3,0,3,0,3,-93.35662079,45.09407043
231,"BROOKNEAL VA",11,2,1,1,0,2,-78.94335937,37.05040741
231,"BROOKSIDE VILLAGE TX",11,2,0,1,1,2,-95.32555389,29.58737183
231,"BROOKSVILLE FL",11,2,0,1,1,2,-82.38734436,28.55600739
231,"BROOMFIELD CO",11,28,6,9,13,28,-105.0877686,39.92069244
231,"BROWNFIELD TX",11,4,0,0,4,4,-102.2751923,33.18150711
231,"BROWNSVILLE TN",11,1,1,0,0,1,-89.27153778,35.59300232
231,"BROWNSVILLE TX",11,15,3,5,7,15,-97.4977951,25.90228081
231,"BRUNSWICK GA",11,6,2,0,4,6,-81.49102783,31.1502285
231,"BRUNSWICK ME",11,3,1,2,0,3,-69.96412659,43.91474533
231,"BRUNSWICK OH",11,6,4,0,2,6,-81.84169769,41.23830795
231,"BRYAN TX",11,12,6,1,5,12,-96.3704071,30.67456818
231,"BRYANT AR",11,6,0,1,5,6,-92.48953247,34.59588242
231,"BUCHANAN MI",11,4,1,0,3,4,-86.3614502,41.82715225
231,"BUCKEYE AZ",11,4,0,1,3,4,-112.5852661,33.37036896
231,"BUCKHANNON WV",11,3,0,1,2,3,-80.22968292,38.99204254
231,"BUCKLEY WA",11,2,1,0,1,2,-122.0293274,47.16257095
231,"BUCYRUS OH",11,2,0,1,1,2,-82.97511292,40.80856323
231,"BUDA TX",11,4,0,2,2,4,-97.84067535,30.08543968
231,"BUENA PARK CA",11,3,1,2,0,3,-117.999939,33.86748123
231,"BUENA VISTA CO",11,2,0,0,2,2,-106.1334534,38.84151459
231,"BUENA VISTA GA",11,1,0,0,1,1,-84.51670074,32.31921768
231,"BUFFALO NY",11,514,129,140,245,514,-78.87787628,42.8867836
231,"BUFORD GA",11,5,2,1,2,5,-84.00788879,34.11735535
231,"BUHLER KS",11,1,0,1,0,1,-97.7707901,38.13441849
231,"BULLHEAD CITY AZ",11,1,0,1,0,1,-114.5695648,35.1478157
231,"BUNCETON MO",11,1,0,0,1,1,-92.79986572,38.78822708
231,"BUNKER HILL IL",11,1,0,0,1,1,-89.95170593,39.04272842
231,"BURBANK CA",11,91,32,17,42,91,-118.3104782,34.18065262
231,"BURIEN WA",11,2,0,0,2,2,-122.3500137,47.47027206
231,"BURLESON TX",11,1,0,1,0,1,-97.32151794,32.54247665
231,"BURLINGAME CA",11,10,3,5,2,10,-122.3685074,37.58408737
231,"BURLINGTON IA",11,2,0,1,1,2,-91.11296082,40.80773544
231,"BURLINGTON NC",11,1,0,1,0,1,-79.43729401,36.09585953
231,"BURLINGTON NJ",11,11,1,1,9,11,-74.86417389,40.07125092
231,"BURLINGTON VT",11,132,48,23,61,132,-73.20542908,44.47687531
231,"BURLINGTON WI",11,1,0,1,0,1,-88.27623749,42.67818832
231,"BURNET TX",11,1,1,0,0,1,-98.22889709,30.75881004
231,"BURNHAM IL",11,1,0,1,0,1,-87.55692291,41.63884354
231,"BURNSVILLE MN",11,9,2,2,5,9,-93.27822113,44.76760483
231,"BURNSVILLE NC",11,1,0,1,0,1,-82.30067444,35.91744614
231,"BURTON MI",11,2,1,0,1,2,-83.59590912,43.02775955
231,"BUSHNELL FL",11,4,1,1,2,4,-82.11235809,28.66544533
231,"BYRAM MS",11,1,0,0,1,1,-90.25419617,32.18321609
231,"BYRON GA",11,1,1,0,0,1,-83.75946808,32.65393066
231,"BYRON WY",11,2,1,0,1,2,-108.5082169,44.79620361
231,"CADILLAC MI",11,1,0,0,1,1,-85.401474,44.25179291
231,"CADIZ KY",11,1,1,0,0,1,-87.83547211,36.86511612
231,"CAHOKIA IL",11,6,1,3,2,6,-90.19016266,38.57118225
231,"CAIRO GA",11,28,8,4,16,28,-84.20102692,30.87791824
231,"CALABASAS CA",11,30,6,5,19,30,-118.6473236,34.1558876
231,"CALDWELL ID",11,3,1,1,1,3,-116.6891098,43.66285324
231,"CALDWELL NJ",11,1,0,1,0,1,-74.27587128,40.83979797
231,"CALDWELL TX",11,1,0,1,0,1,-96.69367218,30.53148842
231,"CALERA AL",11,2,1,1,0,2,-86.75354004,33.10300064
231,"CALHOUN GA",11,3,2,1,0,3,-84.95102692,34.50297165
231,"CALIFORNIA MO",11,2,1,0,1,2,-92.56713104,38.62768555
231,"CALUMET CITY IL",11,2,0,1,1,2,-87.5293045,41.61571884
231,"CAMARILLO CA",11,45,12,12,21,45,-119.0400391,34.21628952
231,"CAMAS WA",11,3,0,2,1,3,-122.4054489,45.58965683
231,"CAMBRIDGE MA",11,332,103,95,134,332,-71.10369873,42.36532593
231,"CAMBRIDGE MD",11,1,0,0,1,1,-76.07826996,38.56329346
231,"CAMBRIDGE OH",11,28,6,9,13,28,-81.58615875,40.02525711
231,"CAMBRIDGE SPRINGS PA",11,4,2,0,2,4,-80.05628204,41.80366135
231,"CAMBRIDGE WI",11,1,0,0,1,1,-89.01670074,43.00352097
231,"CAMDEN AR",11,2,0,1,1,2,-92.83481598,33.58491898
231,"CAMDEN NJ",11,51,10,13,28,51,-75.118927,39.92608261
231,"CAMDEN TN",11,2,0,1,1,2,-88.09780121,36.05930328
231,"CAMDENTON MO",11,4,0,0,4,4,-92.74469757,38.00836182
231,"CAMERON SC",11,1,0,1,0,1,-80.71407318,33.5581665
231,"CAMILLA GA",11,2,0,0,2,2,-84.21003723,31.23182297
231,"CAMP HILL PA",11,2,2,0,0,2,-76.9335022,40.24120331
231,"CAMPBELL CA",11,12,4,4,4,12,-121.951973,37.287117
231,"CANAL WINCHESTER OH",11,3,0,2,1,3,-82.80456543,39.84274673
231,"CANANDAIGUA NY",11,10,4,3,3,10,-77.28107452,42.88830948
231,"CANBY OR",11,1,0,1,0,1,-122.6948166,45.26276779
231,"CANONSBURG PA",11,1,0,0,1,1,-80.1868515,40.26278687
231,"CANTON GA",11,7,2,3,2,7,-84.48571014,34.23356628
231,"CANTON MA",11,2,0,1,1,2,-71.14385986,42.15875626
231,"CANTON NC",11,1,0,1,0,1,-82.83691406,35.53314209
231,"CANTON OH",11,36,7,17,12,36,-81.37824249,40.79906845
231,"CANYON TX",11,2,0,0,2,2,-101.9192429,34.98051834
231,"CAPE CANAVERAL FL",11,6,3,2,1,6,-80.60503387,28.4044838
231,"CAPE CORAL FL",11,14,2,7,5,14,-81.9491806,26.56343079
231,"CAPE GIRARDEAU MO",11,142,47,36,59,142,-89.51838684,37.30613327
231,"CAPITAN NM",11,2,0,0,2,2,-105.5767288,33.58862686
231,"CAPITOL HEIGHTS MD",11,14,1,8,5,14,-76.91506195,38.88552475
231,"CARBONDALE CO",11,2,0,1,1,2,-107.2127838,39.4022522
231,"CARBONDALE IL",11,38,13,7,18,38,-89.2168808,37.7274704
231,"CARENCRO LA",11,2,0,2,0,2,-92.04903412,30.31741714
231,"CARLISLE IA",11,2,1,0,1,2,-93.48899078,41.50154495
231,"CARLISLE PA",11,10,4,3,3,10,-77.18848419,40.20173264
231,"CARLSBAD CA",11,30,9,6,15,30,-117.3528137,33.1580162
231,"CARLSBAD NM",11,5,1,3,1,5,-104.2350617,32.41680527
231,"CARMEL IN",11,6,2,1,3,6,-86.12607574,39.97961426
231,"CARMEL NY",11,2,1,0,1,2,-73.67949677,41.43042755
231,"CARNEGIE PA",11,1,0,0,1,1,-80.0830307,40.40876007
231,"CAROLINA BEACH NC",11,2,0,0,2,2,-77.89279175,34.03543472
231,"CARPINTERIA CA",11,2,0,2,0,2,-119.5201263,34.39894485
231,"CARRBORO NC",11,23,10,5,8,23,-79.07286835,35.91213989
231,"CARROLLTON GA",11,4,0,1,3,4,-85.07631683,33.58019638
231,"CARROLLTON TX",11,12,5,1,6,12,-96.89080811,32.95380783
231,"CARROLLTOWN PA",11,1,0,0,1,1,-78.70822144,40.60308075
231,"CARSON CA",11,52,13,18,21,52,-118.2837448,33.8312645
231,"CARSON CITY NV",11,13,3,3,7,13,-119.7687988,39.16352844
231,"CARTERET NJ",11,8,1,3,4,8,-74.2276535,40.57754135
231,"CARTERSVILLE GA",11,11,4,0,7,11,-84.79982758,34.1654892
231,"CARTHAGE MO",11,3,1,1,1,3,-94.31087494,37.17650223
231,"CARTHAGE TX",11,1,0,1,0,1,-94.33757019,32.15785217
231,"CARY IL",11,1,1,0,0,1,-88.23856354,42.21179962
231,"CARY NC",11,69,14,21,34,69,-78.78055573,35.79200745
231,"CASA GRANDE AZ",11,17,6,4,7,17,-111.7590179,32.87965393
231,"CASCADE LOCKS OR",11,5,1,2,2,5,-121.8928452,45.66971588
231,"CASPER WY",11,8,1,2,5,8,-106.3147507,42.86667633
231,"CASSVILLE MO",11,2,0,1,1,2,-93.86898804,36.67718124
231,"CASTALIA OH",11,1,0,1,0,1,-82.80828857,41.40028
231,"CASTILE NY",11,2,0,1,1,2,-78.05419922,42.6289978
231,"CASTLE HILLS TX",11,1,1,0,0,1,-98.51991272,29.52467346
231,"CASTLE ROCK CO",11,14,2,4,8,14,-104.857811,39.37207031
231,"CATHEDRAL CITY CA",11,5,2,1,2,5,-116.4663467,33.77960205
231,"CATLETTSBURG KY",11,1,0,0,1,1,-82.59997559,38.40486908
231,"CATSKILL NY",11,2,1,0,1,2,-73.86399841,42.21760178
231,"CAVE CREEK AZ",11,5,0,1,4,5,-111.9523544,33.83345795
231,"CAYCE SC",11,1,1,0,0,1,-81.05870819,33.97318649
231,"CAZENOVIA NY",11,1,0,0,1,1,-75.85186005,42.93000031
231,"CEDAR CITY UT",11,8,1,1,6,8,-113.0635757,37.67730713
231,"CEDAR FALLS IA",11,12,2,2,8,12,-92.44594574,42.52773285
231,"CEDAR HILL TX",11,4,0,1,1,2,-99.08098985,33.36628723
231,"CEDAR PARK TX",11,5,1,2,2,5,-97.82061005,30.50554466
231,"CEDAR RAPIDS IA",11,69,11,27,31,69,-91.66259766,41.98337555
231,"CEDARBURG WI",11,4,2,1,1,4,-87.9877243,43.29684067
231,"CELINA TX",11,1,0,1,0,1,-96.78490448,33.32471085
231,"CENTER LINE MI",11,1,0,0,1,1,-83.02747345,42.48490524
231,"CENTER POINT AL",11,2,0,2,0,2,-86.68362427,33.64584732
231,"CENTERVILLE IA",11,3,2,1,0,3,-92.87467957,40.73418045
231,"CENTERVILLE OH",11,1,0,0,1,1,-84.15953064,39.6285553
231,"CENTRAL CITY CO",11,1,0,1,0,1,-105.5155487,39.80203629
231,"CENTRAL SC",11,2,1,1,0,2,-82.78075409,34.72467041
231,"CENTRALIA WA",11,5,2,3,0,5,-122.9679337,46.71740723
231,"CENTRE AL",11,1,1,0,0,1,-85.67890167,34.15224838
231,"CENTREVILLE IL",11,2,1,0,1,2,-90.12549591,38.58330154
231,"CENTREVILLE MD",11,1,0,1,0,1,-76.06595612,39.04180145
231,"CERES CA",11,2,1,1,0,2,-120.9599075,37.59457016
231,"CERRITOS CA",11,6,1,1,4,6,-118.0665054,33.85832214
231,"CHADRON NE",11,2,0,2,0,2,-102.9998169,42.83535004
231,"CHAMBERSBURG PA",11,1,1,0,0,1,-77.66046906,39.93768692
231,"CHAMPAIGN IL",11,122,32,32,58,122,-88.24346161,40.11659622
231,"CHANDLER AZ",11,93,25,26,42,93,-111.8428345,33.3062439
231,"CHANDLER OK",11,5,0,4,1,5,-96.88135529,35.70169067
231,"CHANUTE KS",11,1,0,1,0,1,-95.45789337,37.67946243
231,"CHAPEL HILL NC",11,174,53,39,82,174,-79.05697632,35.91110611
231,"CHAPEL HILL TN",11,1,0,0,1,1,-86.76481628,35.60889816
231,"CHAPIN SC",11,1,0,1,0,1,-81.34924316,34.16627884
231,"CHARITON IA",11,2,0,0,2,2,-93.31124878,41.01361847
231,"CHARLES TOWN WV",11,1,0,0,1,1,-77.86264038,39.29033279
231,"CHARLESTON IL",11,1,0,0,1,1,-88.17610931,39.49612045
231,"CHARLESTON SC",11,357,95,99,163,357,-79.93032074,32.77671814
231,"CHARLESTON WV",11,208,44,50,114,208,-81.63149261,38.34872055
231,"CHARLOTTE NC",11,1443,364,372,707,1443,-80.84257507,35.22746277
231,"CHARLOTTESVILLE VA",11,182,53,49,80,182,-78.49123383,38.03798676
231,"CHASKA MN",11,2,1,0,1,2,-93.60231781,44.78918457
231,"CHATHAM IL",11,6,2,3,1,6,-89.70467377,39.67619324
231,"CHATHAM NY",11,5,1,1,3,5,-73.59416199,42.3643074
231,"CHATTANOOGA TN",11,169,43,46,80,169,-85.30583954,35.04058456
231,"CHECOTAH OK",11,4,2,1,1,4,-95.52338409,35.47038651
231,"CHEEKTOWAGA NY",11,2,0,1,1,2,-78.75413513,42.90357208
231,"CHELAN WA",11,3,0,2,1,3,-120.0186539,47.84073639
231,"CHELSEA AL",11,5,4,0,1,5,-86.63014984,33.34026718
231,"CHELSEA MA",11,4,3,1,0,4,-71.03151703,42.39189529
231,"CHELTENHAM PA",11,2,0,0,2,2,-75.09356689,40.06132126
231,"CHENEY KS",11,1,1,0,0,1,-97.78330994,37.6300087
231,"CHENEY WA",11,3,2,0,1,3,-117.5782547,47.48730087
231,"CHERRY HILL NJ",11,25,8,6,11,25,-75.03024292,39.93510437
231,"CHESAPEAKE BEACH MD",11,12,2,2,8,12,-76.53400421,38.68645096
231,"CHESAPEAKE VA",11,83,26,20,37,83,-76.27422333,36.81948853
231,"CHESHIRE CT",11,4,1,2,1,4,-72.89962006,41.50049591
231,"CHESTER IL",11,1,0,1,0,1,-89.82231903,37.91368103
231,"CHESTER NJ",11,1,0,0,1,1,-74.69606018,40.78449631
231,"CHESTER PA",11,18,2,5,11,18,-75.35475159,39.84973145
231,"CHESTER SC",11,10,3,4,3,10,-81.2141037,34.7049675
231,"CHESTERFIELD MO",11,34,13,8,13,34,-90.5772934,38.6631279
231,"CHESTERTOWN MD",11,4,1,0,3,4,-76.0662384,39.20907593
231,"CHETEK WI",11,1,1,0,0,1,-91.65122986,45.31412888
231,"CHEVERLY MD",11,5,0,1,4,5,-76.91530609,38.92858505
231,"CHEVY CHASE MD",11,14,1,5,8,14,-77.07595825,38.97138977
231,"CHEWELAH WA",11,1,0,0,1,1,-117.7169418,48.27609634
231,"CHEYENNE WY",11,17,3,5,9,17,-104.8183899,41.13345718
231,"CHICAGO HEIGHTS IL",11,5,2,0,3,5,-87.63541412,41.506073
231,"CHICAGO IL",11,5758,1481,1553,2724,5758,-87.6503067,41.85000992
231,"CHICAGO RIDGE IL",11,4,1,2,1,4,-87.77906036,41.70148849
231,"CHICKAMAUGA GA",11,2,1,0,1,2,-85.29045105,34.87113571
231,"CHICKASHA OK",11,1,0,0,1,1,-97.93728638,35.05269241
231,"CHICO CA",11,209,54,58,97,209,-121.839447,39.72846222
231,"CHICOPEE MA",11,5,3,0,2,5,-72.60691071,42.14902496
231,"CHILDRESS TX",11,1,0,0,1,1,-100.2050476,34.42647171
231,"CHILLICOTHE MO",11,4,1,1,2,4,-93.55298615,39.79542542
231,"CHILLICOTHE OH",11,7,1,4,2,7,-82.98206329,39.33310699
231,"CHINA GROVE NC",11,7,1,3,3,7,-80.58115387,35.56945801
231,"CHINO CA",11,8,1,7,0,8,-117.6906662,34.0121727
231,"CHIPLEY FL",11,1,0,0,1,1,-85.53816223,30.78241539
231,"CHIPPEWA FALLS WI",11,1,0,0,1,1,-91.3935318,44.93660736
231,"CHISHOLM MN",11,3,0,2,1,3,-92.88430023,47.4890976
231,"CHOWCHILLA CA",11,5,1,2,2,5,-120.2619934,37.12313843
231,"CHRISTIANSBURG VA",11,7,5,1,1,7,-80.40843201,37.1302948
231,"CHRISTOPHER IL",11,2,2,0,0,2,-89.05361938,37.97265244
231,"CHULA VISTA CA",11,30,10,5,15,30,-117.0857468,32.64037704
231,"CHURCH HILL TN",11,1,1,0,0,1,-82.71310425,36.52270126
231,"CICERO IL",11,5,2,2,1,5,-87.75395203,41.84553909
231,"CICERO IN",11,1,1,0,0,1,-86.01347351,40.12386703
231,"CINCINNATI OH",11,547,148,163,236,547,-84.51939392,39.10413742
231,"CINNAMINSON NJ",11,1,0,0,1,1,-74.99165344,39.9969101
231,"CLAREMONT CA",11,28,7,9,12,28,-117.7214508,34.09675217
231,"CLAREMONT NH",11,6,2,1,3,6,-72.33439636,43.37068939
231,"CLARKS SUMMIT PA",11,5,2,1,2,5,-75.70759583,41.48881531
231,"CLARKSBURG WV",11,2,0,1,1,2,-80.34414673,39.28092575
231,"CLARKSDALE MS",11,1,0,1,0,1,-90.57128143,34.20030212
231,"CLARKSTON GA",11,1,0,0,1,1,-84.2394104,33.80961227
231,"CLARKSTON WA",11,4,1,1,2,4,-117.0472336,46.41588593
231,"CLARKSVILLE TN",11,40,11,15,14,40,-87.35944366,36.52993011
231,"CLAYTON CA",11,1,0,1,0,1,-121.938057,37.94074249
231,"CLAYTON DE",11,1,0,1,0,1,-75.63150787,39.29172897
231,"CLAYTON MO",11,4,2,1,1,4,-90.32382965,38.64260101
231,"CLE ELUM WA",11,2,0,0,2,2,-120.9416733,47.19517517
231,"CLEAR LAKE SHORES TX",11,60,15,19,26,60,-95.03226471,29.54773712
231,"CLEARWATER FL",11,49,19,11,19,49,-82.79984283,27.9665451
231,"CLEARWATER KS",11,1,0,1,0,1,-97.50491333,37.50294876
231,"CLEBURNE TX",11,2,2,0,0,2,-97.38722992,32.34804535
231,"CLEMMONS NC",11,4,0,3,1,4,-80.38154602,36.02172089
231,"CLEMSON SC",11,10,3,1,6,10,-82.83683014,34.68382645
231,"CLEVELAND HEIGHTS OH",11,25,7,10,8,25,-81.55568695,41.52017975
231,"CLEVELAND OH",11,1560,394,474,692,1560,-81.69516754,41.49978256
231,"CLEVELAND TN",11,8,2,3,3,8,-84.87675476,35.15940094
231,"CLEVER MO",11,1,1,0,0,1,-93.47362518,37.0306015
231,"CLEWISTON FL",11,2,0,1,1,2,-80.93336487,26.75513649
231,"CLIFTON NJ",11,2,1,1,0,2,-74.16278076,40.85860062
231,"CLIFTON PARK NY",11,6,4,2,0,6,-73.76983643,42.8658638
231,"CLIFTON SPRINGS NY",11,3,1,2,0,3,-77.13955688,42.96201324
231,"CLINTON IA",11,2,1,0,1,2,-90.19799042,41.84345627
231,"CLINTON MO",11,4,0,3,1,4,-93.7784729,38.36861038
231,"CLINTON MS",11,3,0,3,0,3,-90.33226776,32.34069061
231,"CLINTON SC",11,2,0,1,1,2,-81.88014984,34.47286224
231,"CLINTON TN",11,5,0,1,4,5,-84.13148499,36.10355759
231,"CLIVE IA",11,1,0,0,1,1,-93.72477722,41.60302734
231,"CLOQUET MN",11,1,1,0,0,1,-92.4598465,46.72146988
231,"CLOVERDALE CA",11,1,0,0,1,1,-123.0192032,38.80516052
231,"CLOVIS CA",11,6,0,2,4,6,-119.7047043,36.82522583
231,"CLOVIS NM",11,4,1,0,3,4,-103.2067108,34.40181732
231,"CLUTE TX",11,2,0,1,1,2,-95.39927673,29.02498436
231,"CLYDE OH",11,1,0,0,1,1,-82.97480774,41.30446243
231,"COACHELLA CA",11,4,0,2,2,4,-116.1753616,33.68059158
231,"COAL CITY IL",11,1,1,0,0,1,-88.28557587,41.28782272
231,"COATESVILLE PA",11,4,1,3,0,4,-75.82329559,39.98334885
231,"COATS NC",11,1,0,0,1,1,-78.6716156,35.40827179
231,"COCOA BEACH FL",11,68,14,18,36,68,-80.6068573,28.3203907
231,"COCOA FL",11,1,0,0,1,1,-80.74181366,28.38667297
231,"COEBURN VA",11,1,0,0,1,1,-82.46360016,36.94399643
231,"COEUR D'ALENE ID",11,2,0,0,2,2,-116.781929,47.67768478
231,"COFFEYVILLE KS",11,1,0,0,1,1,-95.61667633,37.03759766
231,"COHASSET MA",11,5,0,3,2,5,-70.8026123,42.24186325
231,"COKER AL",11,14,6,6,2,14,-87.68799591,33.2463913
231,"COLD SPRING KY",11,2,1,0,1,2,-84.43971252,39.02180862
231,"COLDSPRING TX",11,4,1,1,2,4,-95.12992096,30.5929203
231,"COLFAX CA",11,1,0,1,0,1,-120.9551468,39.10037994
231,"COLFAX IA",11,1,0,1,0,1,-93.2455368,41.6778717
231,"COLLEGE PARK GA",11,34,7,12,15,34,-84.44933319,33.65347672
231,"COLLEGE PARK MD",11,328,75,79,174,328,-76.93619537,38.98080444
231,"COLLEGE STATION TX",11,91,14,25,52,91,-96.33758545,30.62316895
231,"COLLEGEVILLE PA",11,1,1,0,0,1,-75.4506073,40.18598557
231,"COLLEYVILLE TX",11,2,0,0,2,2,-97.15543365,32.88101959
231,"COLLIERVILLE TN",11,2,1,0,1,2,-89.66448212,35.0423317
231,"COLLINGDALE PA",11,1,1,0,0,1,-75.27611542,39.91185379
231,"COLLINGSWOOD NJ",11,9,2,2,5,9,-75.07028961,39.9186058
231,"COLLINSVILLE IL",11,9,1,3,5,9,-89.98478699,38.67050171
231,"COLMA CA",11,11,3,2,6,11,-122.4610977,37.67665482
231,"COLORADO SPRINGS CO",11,209,59,56,94,209,-104.8225174,38.83369446
231,"COLTON CA",11,6,1,5,0,6,-117.3153687,34.0738945
231,"COLUMBIA FALLS MT",11,1,1,0,0,1,-114.1933212,48.36879349
231,"COLUMBIA IL",11,2,0,1,1,2,-90.20130157,38.44375992
231,"COLUMBIA MO",11,277,79,68,130,277,-92.33429718,38.95169067
231,"COLUMBIA PA",11,1,0,1,0,1,-76.50388336,40.03407669
231,"COLUMBIA SC",11,441,115,132,194,441,-81.04045105,34.00138855
231,"COLUMBIA TN",11,102,23,49,30,102,-87.03533173,35.61502457
231,"COLUMBUS GA",11,44,13,15,16,44,-84.98313141,32.46828842
231,"COLUMBUS IN",11,2,1,0,1,2,-85.92284393,39.20959473
231,"COLUMBUS MS",11,2,0,0,2,2,-88.42742157,33.49581909
231,"COLUMBUS NC",11,1,0,0,1,1,-82.19678497,35.25350189
231,"COLUMBUS NE",11,1,0,1,0,1,-97.36936188,41.42973709
231,"COLUMBUS OH",11,1390,351,377,662,1390,-82.99890137,39.96136475
231,"COLUMBUS WI",11,5,1,3,1,5,-89.01557922,43.33828735
231,"COMMERCE CITY CO",11,1,1,0,0,1,-104.9268341,39.81377792
231,"COMMERCE GA",11,2,1,0,1,2,-83.46348572,34.20763397
231,"COMMERCE TX",11,3,0,0,3,3,-95.90060425,33.24729538
231,"COMO MS",11,1,0,0,1,1,-89.94004822,34.51066208
231,"COMPTON CA",11,88,25,34,29,88,-118.2218704,33.89606857
231,"CONCORD CA",11,9,2,2,5,9,-122.0333328,37.97780228
231,"CONCORD GA",11,1,1,0,0,1,-84.43733978,33.09128189
231,"CONCORD MA",11,1,0,0,1,1,-71.34809113,42.46035004
231,"CONCORD NC",11,32,5,6,21,32,-80.57880402,35.4092598
231,"CONCORD NH",11,8,2,4,2,8,-71.53688812,43.20820999
231,"CONCORDIA MO",11,4,2,1,1,4,-93.56906128,38.98339462
231,"CONNEAUT OH",11,2,0,2,0,2,-80.55375671,41.94755936
231,"CONOVER NC",11,19,4,7,8,19,-81.21835327,35.70663834
231,"CONROE TX",11,19,2,9,8,19,-95.45646667,30.31249237
231,"CONVOY OH",11,1,0,0,1,1,-84.70248413,40.91695404
231,"CONWAY AR",11,17,4,6,7,17,-92.4426651,35.08877563
231,"CONWAY SC",11,3,1,0,2,3,-79.04202271,33.83802795
231,"CONYERS GA",11,10,3,2,5,10,-84.0175705,33.66764832
231,"COOKEVILLE TN",11,9,4,2,3,9,-85.50189972,36.16290665
231,"COON RAPIDS MN",11,1,0,0,1,1,-93.32348633,45.16527176
231,"COOPERSTOWN NY",11,15,6,1,8,15,-74.9236908,42.70100784
231,"COOS BAY OR",11,2,0,1,1,2,-124.219841,43.36757278
231,"COPPELL TX",11,1,0,0,1,1,-97.01548004,32.95487213
231,"CORAL GABLES FL",11,9,5,2,2,9,-80.26779938,25.72242165
231,"CORALVILLE IA",11,4,0,2,2,4,-91.58083344,41.6765976
231,"CORBIN KY",11,1,0,1,0,1,-84.09648132,36.94906235
231,"CORDOVA AL",11,6,2,2,2,6,-87.18320465,33.75994492
231,"CORINTH KY",11,2,0,0,1,1,-85.683769225,37.64306259
231,"CORINTH MS",11,7,2,3,2,7,-88.52302551,34.93960571
231,"CORINTH TX",11,3,1,2,0,3,-99.87008667,32.85448456
231,"CORNELIUS NC",11,1,0,1,0,1,-80.85160828,35.48339462
231,"CORNERSVILLE TN",11,1,0,0,1,1,-86.83959198,35.36151505
231,"CORNING NY",11,2,0,1,1,2,-77.05406189,42.14312744
231,"CORONA CA",11,41,12,7,22,41,-117.5688171,33.87516785
231,"CORONADO CA",11,12,4,1,7,12,-117.1846619,32.6861763
231,"CORPUS CHRISTI TX",11,60,13,17,30,60,-97.42076874,27.77859879
231,"CORRALES NM",11,2,0,0,2,2,-106.6080399,35.23794174
231,"CORSICANA TX",11,2,1,1,0,2,-96.46954346,32.09554291
231,"CORTLAND NY",11,8,5,1,2,8,-76.17972565,42.60138702
231,"CORTLAND OH",11,1,0,0,1,1,-80.72497559,41.3302803
231,"CORVALLIS OR",11,73,19,16,38,73,-123.2646637,44.56417084
231,"COSTA MESA CA",11,18,3,3,12,18,-117.9204407,33.64131927
231,"COTATI CA",11,25,3,8,14,25,-122.7091904,38.32655334
231,"COTTAGE GROVE MN",11,1,0,0,1,1,-92.88017273,44.842556
231,"COTTONWOOD AZ",11,4,1,3,0,4,-112.0110779,34.739048
231,"COTTONWOOD FALLS KS",11,4,1,2,1,4,-96.54312897,38.37212372
231,"COTTONWOOD ID",11,1,1,0,0,1,-116.3517075,46.0481987
231,"COUNCIL BLUFFS IA",11,9,2,4,3,9,-95.86154938,41.26196289
231,"COUNCIL GROVE KS",11,24,9,6,9,24,-96.49236298,38.66096115
231,"COUNTRY CLUB HILLS IL",11,3,2,1,0,3,-87.72031403,41.56811142
231,"COVINA CA",11,5,1,2,2,5,-117.8919067,34.09014511
231,"COVINGTON GA",11,5,0,2,3,5,-83.86009216,33.59708405
231,"COVINGTON IN",11,1,0,1,0,1,-87.39381409,40.13796234
231,"COVINGTON KY",11,17,7,3,7,17,-84.50816345,39.08356476
231,"COVINGTON LA",11,2,0,1,1,2,-90.10121918,30.475914
231,"COVINGTON OH",11,1,0,0,1,1,-84.35377502,40.12005997
231,"COXSACKIE NY",11,3,1,1,1,3,-73.80188751,42.35128403
231,"CRANDALL TX",11,1,0,0,1,1,-96.45626068,32.62812042
231,"CRANSTON RI",11,13,1,4,8,13,-71.43634033,41.77997971
231,"CRAWFORDSVILLE IN",11,1,0,0,1,1,-86.89406586,40.04439926
231,"CRESTON IA",11,2,0,0,2,2,-94.3616333,41.05845642
231,"CRESTVIEW KY",11,7,3,1,3,7,-84.41716003,39.02523804
231,"CRESTWOOD KY",11,1,0,0,1,1,-85.47231293,38.32429123
231,"CREVE COEUR MO",11,11,3,3,5,11,-90.42288971,38.66108322
231,"CROSSVILLE TN",11,10,3,4,3,10,-85.0270462,35.9490509
231,"CROTON-ON-HUDSON NY",11,12,2,2,8,12,-73.89041901,41.2085762
231,"CROWN POINT IN",11,1,0,0,1,1,-87.36541748,41.41695023
231,"CRYSTAL CITY TX",11,1,0,1,0,1,-99.82878113,28.67775726
231,"CRYSTAL LAKE IL",11,16,4,3,9,16,-88.3161087,42.2411499
231,"CRYSTAL MN",11,9,1,4,4,9,-93.36638641,45.05664063
231,"CRYSTAL RIVER FL",11,2,2,0,0,2,-82.59243011,28.90281487
231,"CUBA MO",11,1,0,1,0,1,-91.40387726,38.06311035
231,"CUERO TX",11,2,1,1,0,2,-97.28947449,29.09457397
231,"CULLMAN AL",11,5,1,1,3,5,-86.84370422,34.17510605
231,"CULPEPER VA",11,1,1,0,0,1,-77.99610901,38.47347641
231,"CUMBERLAND MD",11,4,0,2,2,4,-78.76217651,39.65284729
231,"CUMMING GA",11,8,3,1,4,8,-84.1401825,34.2074852
231,"CUPERTINO CA",11,32,8,6,18,32,-122.0342026,37.32306671
231,"CUYAHOGA FALLS OH",11,73,18,13,42,73,-81.48397064,41.1338768
231,"CYPRESS CA",11,4,0,1,3,4,-118.0384903,33.81704712
231,"DACULA GA",11,9,2,4,3,9,-83.89762878,33.9887352
231,"DADEVILLE AL",11,4,0,1,3,4,-85.76355743,32.83142853
231,"DALLAS GA",11,7,3,1,3,7,-84.84075165,33.92391586
231,"DALLAS NC",11,1,0,1,0,1,-81.17551422,35.31675339
231,"DALLAS PA",11,2,0,1,1,2,-75.96231842,41.33643723
231,"DALLAS TX",11,2881,721,834,1326,2881,-96.80088043,32.78369904
231,"DALTON GA",11,28,5,10,13,28,-84.97008514,34.76976776
231,"DALY CITY CA",11,44,14,9,21,44,-122.4645081,37.70376968
231,"DANBURY CT",11,5,0,3,2,5,-73.45310974,41.39499664
231,"DANDRIDGE TN",11,3,0,2,1,3,-83.41452026,36.0157814
231,"DANFORTH ME",11,6,2,2,2,6,-67.86733246,45.66029358
231,"DANVERS MA",11,3,1,0,2,3,-70.92879486,42.57507324
231,"DANVILLE CA",11,4,1,1,2,4,-122.0023193,37.82156754
231,"DANVILLE IL",11,9,2,3,4,9,-87.62978363,40.12442398
231,"DANVILLE IN",11,1,0,0,1,1,-86.52632904,39.76076126
231,"DANVILLE VA",11,21,5,6,10,21,-79.39437866,36.58641434
231,"DAPHNE AL",11,7,5,0,2,7,-87.90383148,30.60381317
231,"DARIEN CT",11,3,2,1,0,3,-73.46835327,41.0790329
231,"DARLINGTON SC",11,1,0,0,1,1,-79.86645508,34.30082321
231,"DAVENPORT IA",11,26,8,12,6,26,-90.57814026,41.52380753
231,"DAVIDSON NC",11,1,1,0,0,1,-80.8433075,35.49843216
231,"DAVIE FL",11,22,4,9,9,22,-80.23148346,26.0657177
231,"DAVIS CA",11,74,17,19,38,74,-121.7421722,38.54467773
231,"DAVISON MI",11,1,1,0,0,1,-83.51786804,43.0346489
231,"DAYTON KY",11,3,1,1,1,3,-84.47278595,39.11274338
231,"DAYTON OH",11,305,72,77,156,305,-84.19126892,39.75915146
231,"DAYTON TN",11,1,0,0,1,1,-85.01251221,35.49424744
231,"DAYTON TX",11,1,0,1,0,1,-94.8854599,30.04724884
231,"DAYTONA BEACH FL",11,46,13,12,21,46,-81.02253723,29.21147537
231,"DE PERE WI",11,2,0,1,1,2,-88.06053925,44.4486618
231,"DE SOTO KS",11,8,1,4,3,8,-94.96877289,38.97918701
231,"DE SOTO MO",11,2,2,0,0,2,-90.55529022,38.13964462
231,"DEARBORN MI",11,15,7,2,6,15,-83.1758728,42.32239914
231,"DEBARY FL",11,2,0,1,1,2,-81.30838776,28.88345909
231,"DECATUR AL",11,26,4,15,7,26,-86.98355103,34.60622406
231,"DECATUR GA",11,103,36,30,37,103,-84.29631805,33.77489471
231,"DECATUR IL",11,14,2,6,6,14,-88.95516968,39.84060287
231,"DECATUR TX",11,1,0,1,0,1,-97.58672333,33.23470306
231,"DECORAH IA",11,1,0,1,0,1,-91.78575134,43.30333328
231,"DEDHAM MA",11,5,2,1,2,5,-71.16512299,42.24193954
231,"DEER CREEK OK",11,8,2,3,3,8,-97.51993561,36.80317307
231,"DEER PARK TX",11,1,0,0,1,1,-95.1242981,29.70559502
231,"DEER PARK WA",11,3,0,1,2,3,-117.4789734,47.95389938
231,"DEERFIELD BEACH FL",11,8,3,2,3,8,-80.09928131,26.31905365
231,"DEERFIELD IL",11,7,0,3,4,7,-87.84490204,42.17103577
231,"DEFIANCE OH",11,1,0,1,0,1,-84.35565948,41.28461838
231,"DEL MAR CA",11,1,0,0,1,1,-117.2663345,32.95969391
231,"DEL RIO TX",11,3,2,0,1,3,-100.8970642,29.36329842
231,"DELANO CA",11,1,1,0,0,1,-119.2488785,35.76877975
231,"DELAWARE OH",11,8,2,4,2,8,-83.06757355,40.29886627
231,"DELMONT SD",11,1,0,0,1,1,-98.16448212,43.26812363
231,"DELRAY BEACH FL",11,26,7,9,10,26,-80.07209778,26.46233368
231,"DELTA CO",11,3,1,0,2,3,-108.0698395,38.74222946
231,"DELTONA FL",11,4,1,0,3,4,-81.25521088,28.90277863
231,"DEMING NM",11,4,0,2,2,4,-107.7599793,32.26507187
231,"DENHAM SPRINGS LA",11,2,1,1,0,2,-90.95632935,30.4871006
231,"DENISON TX",11,1,0,0,1,1,-96.53727722,33.75577164
231,"DENTON NC",11,2,0,1,1,2,-80.1153183,35.63389587
231,"DENTON TX",11,159,45,50,64,159,-97.13349915,33.21514893
231,"DENVER CO",11,1806,474,504,828,1806,-104.9853745,39.73901749
231,"DEPEW NY",11,6,0,3,3,6,-78.69154358,42.90420532
231,"DERBY KS",11,17,2,7,8,17,-97.26980591,37.54567719
231,"DERRY NH",11,5,1,3,1,5,-71.32653809,42.88068008
231,"DES MOINES IA",11,225,69,70,86,225,-93.6210022,41.59817123
231,"DES MOINES WA",11,5,0,2,3,5,-122.3266525,47.40114594
231,"DES PERES MO",11,2,1,0,1,2,-90.43345642,38.60096741
231,"DES PLAINES IL",11,12,4,3,5,12,-87.8833847,42.03343964
231,"DESERT HOT SPRINGS CA",11,2,0,1,1,2,-116.5035934,33.96113586
231,"DESTIN FL",11,14,1,4,9,14,-86.49551392,30.39405632
231,"DETROIT MI",11,1255,316,335,604,1255,-83.04567719,42.33172226
231,"DETROIT TX",11,2,0,1,1,2,-95.26699829,33.66192245
231,"DEXTER MI",11,2,1,0,1,2,-83.88848114,42.33824158
231,"DEXTER MO",11,4,2,1,1,4,-89.95834351,36.79595947
231,"DIAMOND BAR CA",11,3,2,0,1,3,-117.8404999,33.97759247
231,"DIBOLL TX",11,1,0,1,0,1,-94.78146362,31.18740463
231,"DICKINSON ND",11,4,0,2,2,4,-102.7891007,46.87979889
231,"DICKINSON TX",11,2,0,0,2,2,-95.05158234,29.46142769
231,"DICKSON TN",11,2,0,1,1,2,-87.38776398,36.07693863
231,"DIKE IA",11,1,0,0,1,1,-92.62843323,42.46409607
231,"DINUBA CA",11,1,0,0,1,1,-119.3888931,36.543293
231,"DISTRICT HEIGHTS MD",11,17,3,2,12,17,-76.88869476,38.85776138
231,"DIXON CA",11,5,1,1,3,5,-121.8243713,38.44569778
231,"DIXON IL",11,1,1,0,0,1,-89.4799881,41.83919907
231,"DOBBS FERRY NY",11,1,1,0,0,1,-73.87168121,41.01457977
231,"DODGE CITY KS",11,1,0,0,1,1,-100.0181732,37.75279617
231,"DODGEVILLE WI",11,1,0,1,0,1,-90.13021088,42.96014023
231,"DOLORES CO",11,2,1,0,1,2,-108.5061646,37.47371292
231,"DONIPHAN MO",11,41,13,14,14,41,-90.82394409,36.62110138
231,"DONNA TX",11,1,0,1,0,1,-98.05448914,26.17434883
231,"DONORA PA",11,1,0,1,0,1,-79.85721588,40.17367935
231,"DOTHAN AL",11,10,3,1,6,10,-85.39019775,31.22351265
231,"DOUGLAS GA",11,15,2,6,7,15,-82.84980011,31.50903511
231,"DOUGLASVILLE GA",11,7,1,1,5,7,-84.74777222,33.75165939
231,"DOUSMAN WI",11,1,0,1,0,1,-88.4726944,43.01404572
231,"DOVER DE",11,40,11,12,17,40,-75.52090454,39.15853882
231,"DOVER NH",11,12,4,5,3,12,-70.88840485,43.2059021
231,"DOVER OH",11,4,0,3,1,4,-81.4782486,40.51688766
231,"DOYLESTOWN PA",11,14,3,2,9,14,-75.1292038,40.31054688
231,"DRAPER UT",11,1,0,1,0,1,-111.8741074,40.5280838
231,"DREW MS",11,2,0,0,2,2,-90.53083038,33.81049728
231,"DRIPPING SPRINGS TX",11,6,0,0,6,6,-98.08734131,30.19070816
231,"DRY PRONG LA",11,1,1,0,0,1,-92.53327179,31.58175659
231,"DU QUOIN IL",11,3,0,1,2,3,-89.2414856,38.01353455
231,"DUARTE CA",11,1,0,0,1,1,-117.9786072,34.13949966
231,"DUBLIN CA",11,47,13,14,20,47,-121.9383392,37.70181274
231,"DUBLIN GA",11,1,0,1,0,1,-82.90332794,32.540802
231,"DUBLIN VA",11,2,0,0,2,2,-80.68517303,37.10611343
231,"DUBUQUE IA",11,18,6,6,6,18,-90.67155457,42.51130295
231,"DULUTH MN",11,21,8,4,9,21,-92.10697174,46.78300858
231,"DUNBAR PA",11,5,2,2,1,5,-79.61539459,39.97570801
231,"DUNBAR WV",11,1,1,0,0,1,-81.73683167,38.36086655
231,"DUNCANVILLE TX",11,4,0,1,3,4,-96.9091568,32.65229034
231,"DUNEDIN FL",11,29,8,11,10,29,-82.77127838,28.02050591
231,"DUNMORE PA",11,3,0,0,3,3,-75.63155365,41.42010117
231,"DUNNELLON FL",11,2,0,2,0,2,-82.46072388,29.04970551
231,"DUNWOODY GA",11,2,0,1,1,2,-84.33460236,33.94631958
231,"DURANGO CO",11,21,5,7,9,21,-107.8810043,37.27463913
231,"DURANT OK",11,1,0,1,0,1,-96.37478638,33.99116135
231,"DURHAM NC",11,881,218,237,426,881,-78.89787292,35.99412918
231,"DURHAM NH",11,2,0,1,1,2,-70.92732239,43.13511276
231,"EAGAN MN",11,18,4,7,7,18,-93.16746521,44.80387878
231,"EAGLE CO",11,1,1,0,0,1,-106.8298264,39.655159
231,"EAGLE LAKE MN",11,2,2,0,0,2,-93.88172913,44.16489792
231,"EAGLE PASS TX",11,2,0,1,1,2,-100.5002899,28.70978737
231,"EAGLE RIVER WI",11,9,2,1,6,9,-89.24466705,45.91718674
231,"EARLY TX",11,1,1,0,0,1,-98.94454956,31.74184799
231,"EASLEY SC",11,1,0,0,1,1,-82.60394287,34.82990646
231,"EAST CHICAGO IN",11,2,1,0,1,2,-87.44509125,41.64970398
231,"EAST GREENWICH RI",11,2,0,1,1,2,-71.45487976,41.66058731
231,"EAST HAMPTON NY",11,1,0,1,0,1,-72.18353271,40.96551895
231,"EAST HARTFORD CT",11,29,10,10,9,29,-72.64693451,41.77160263
231,"EAST LANSING MI",11,107,30,29,48,107,-84.48403931,42.73703384
231,"EAST LIVERPOOL OH",11,1,0,0,1,1,-80.57673645,40.61891556
231,"EAST MCKEESPORT PA",11,6,1,1,4,6,-79.80618286,40.38326645
231,"EAST MOLINE IL",11,1,0,0,1,1,-90.44459534,41.50070953
231,"EAST ORANGE NJ",11,78,25,16,37,78,-74.21418762,40.76618958
231,"EAST PALO ALTO CA",11,2,0,0,2,2,-122.143013,37.46857452
231,"EAST PEORIA IL",11,1,0,0,1,1,-89.58027649,40.66614151
231,"EAST POINT GA",11,18,0,7,11,18,-84.43933868,33.67996979
231,"EAST PROVIDENCE RI",11,4,2,0,2,4,-71.36916351,41.81398392
231,"EAST ROCHESTER NY",11,1,0,1,0,1,-77.48701477,43.1086731
231,"EASTLAKE OH",11,2,0,1,1,2,-81.45001984,41.65415955
231,"EASTMAN GA",11,8,2,1,5,8,-83.17722321,32.19805527
231,"EASTON MD",11,4,2,1,1,4,-76.07592773,38.77448654
231,"EASTON PA",11,12,4,4,4,12,-75.21966553,40.68871689
231,"EATON OH",11,1,0,0,1,1,-84.6366806,39.74417877
231,"EATONTOWN NJ",11,1,0,0,1,1,-74.05027008,40.29634094
231,"EATONVILLE WA",11,4,0,1,3,4,-122.2686615,46.86676407
231,"EAU CLAIRE WI",11,11,2,3,6,11,-91.49876404,44.81137466
231,"EDEN NC",11,1,0,0,1,1,-79.76634216,36.48883438
231,"EDEN PRAIRIE MN",11,33,9,6,18,33,-93.48716736,44.85310745
231,"EDGAR SPRINGS MO",11,1,1,0,0,1,-91.86699677,37.70466232
231,"EDINA MN",11,4,1,2,1,4,-93.34928131,44.91236496
231,"EDINA MO",11,2,0,0,2,2,-92.1732254,40.16763306
231,"EDINBORO PA",11,23,9,3,11,23,-80.13100433,41.87437439
231,"EDINBURG TX",11,24,5,8,11,24,-98.16417694,26.30259705
231,"EDMOND OK",11,28,9,6,13,28,-97.48453522,35.65326309
231,"EDMONDS WA",11,214,55,55,104,214,-122.3799057,47.81037521
231,"EDWARDSVILLE IL",11,139,36,38,65,139,-89.95322418,38.8115654
231,"EFFINGHAM IL",11,1,0,1,0,1,-88.54359436,39.12008667
231,"EL CENTRO CA",11,2,0,0,2,2,-115.5646057,32.79199982
231,"EL CERRITO CA",11,39,13,4,22,39,-122.3142548,37.91544342
231,"EL DORADO AR",11,2,0,1,1,2,-92.66680908,33.20800018
231,"EL DORADO KS",11,3,1,1,1,3,-96.86262512,37.81741714
231,"EL LAGO TX",11,18,8,4,6,18,-95.04547119,29.56394196
231,"EL MIRAGE AZ",11,1,0,1,0,1,-112.3263016,33.61337662
231,"EL MONTE CA",11,25,6,7,12,25,-118.0298996,34.06880569
231,"EL PASO TX",11,214,53,65,96,214,-106.4620514,31.78388405
231,"EL RENO OK",11,5,1,1,3,5,-97.95549011,35.53218842
231,"EL SEGUNDO CA",11,8,1,4,3,8,-118.4185257,33.91943741
231,"ELAINE AR",11,3,0,1,2,3,-90.85227966,34.30869293
231,"ELBA AL",11,3,0,1,2,3,-86.06761169,31.41489601
231,"ELBERTON GA",11,1,0,1,0,1,-82.86587524,34.11487579
231,"ELGIN IL",11,5,0,2,3,5,-88.28123474,42.03733444
231,"ELGIN SC",11,5,1,4,0,5,-80.79399872,34.17118073
231,"ELGIN TX",11,1,1,0,0,1,-97.37094879,30.34980202
231,"ELIZABETH CITY NC",11,7,0,5,2,7,-76.22274017,36.3025322
231,"ELIZABETH NJ",11,10,3,2,5,10,-74.21881866,40.66823578
231,"ELIZABETHTOWN KY",11,4,1,2,1,4,-85.85932159,37.69418716
231,"ELIZABETHTOWN PA",11,2,0,1,1,2,-76.60209656,40.15314865
231,"ELK GROVE CA",11,518,139,141,238,518,-121.3743591,38.40848923
231,"ELK POINT SD",11,5,0,2,3,5,-96.68419647,42.68325424
231,"ELK RAPIDS MI",11,1,0,0,1,1,-85.41677856,44.89548111
231,"ELKHART IN",11,8,2,3,3,8,-85.97689056,41.68212128
231,"ELKHART TX",11,1,1,0,0,1,-95.58008575,31.62545013
231,"ELKINS WV",11,1,1,0,0,1,-79.85980225,38.92602921
231,"ELKO NV",11,11,0,5,6,11,-115.7643967,40.83226395
231,"ELKTON MD",11,2,0,0,2,2,-75.83261108,39.60694122
231,"ELLENSBURG WA",11,3,0,0,3,3,-120.5507507,46.99611664
231,"ELLETTSVILLE IN",11,8,3,2,3,8,-86.62473297,39.23396301
231,"ELLWOOD CITY PA",11,1,0,0,1,1,-80.28616333,40.86182404
231,"ELMHURST IL",11,14,3,1,10,14,-87.9407196,41.89970398
231,"ELMIRA NY",11,4,0,2,2,4,-76.80737305,42.08998108
231,"ELMWOOD PARK NJ",11,9,1,3,5,9,-74.1175766,40.90429306
231,"ELOY AZ",11,2,0,1,1,2,-111.5559692,32.75610733
231,"ELSA TX",11,1,0,0,1,1,-97.99377441,26.29435349
231,"ELY NV",11,1,0,0,1,1,-114.8907013,39.24752045
231,"ELYRIA OH",11,18,9,6,3,18,-82.10734558,41.36825562
231,"EMERYVILLE CA",11,1,1,0,0,1,-122.2871475,37.83127975
231,"EMMAUS PA",11,2,0,0,2,2,-75.49610138,40.53958893
231,"EMPORIA KS",11,2,1,0,1,2,-96.18218994,38.40393448
231,"EMPORIA VA",11,2,0,1,1,2,-77.54174805,36.68619919
231,"ENCINITAS CA",11,7,0,3,4,7,-117.2937012,33.0371666
231,"ENGLEWOOD CO",11,3,1,1,1,3,-104.9884491,39.6479187
231,"ENGLEWOOD NJ",11,2,1,0,1,2,-73.97172546,40.8928833
231,"ENID OK",11,3,0,2,1,3,-97.87895203,36.39573288
231,"ENTERPRISE AL",11,7,2,1,4,7,-85.85494995,31.31528282
231,"ENUMCLAW WA",11,1,0,0,1,1,-121.9936066,47.20384598
231,"EPHRATA PA",11,1,0,1,0,1,-76.17801666,40.17980194
231,"EPPING NH",11,1,0,0,1,1,-71.08043671,43.03881454
231,"ERIE CO",11,2,0,1,1,2,-105.0506516,40.0500946
231,"ERIE PA",11,83,20,21,42,83,-80.08492279,42.12926483
231,"ERLANGER KY",11,1,0,0,1,1,-84.60089111,39.01673508
231,"ERWIN TN",11,4,1,2,1,4,-82.41162109,36.15189362
231,"ESCONDIDO CA",11,6,2,1,3,6,-117.0886231,33.11952591
231,"ESSEX JUNCTION VT",11,5,1,3,1,5,-73.11017609,44.49057007
231,"ESSEXVILLE MI",11,1,0,1,0,1,-83.84166718,43.61558151
231,"ESTERO FL",11,4,0,2,2,4,-81.80654144,26.43899536
231,"EUGENE OR",11,356,92,94,170,356,-123.0898361,44.05194855
231,"EULESS TX",11,23,5,4,14,23,-97.08273315,32.83728409
231,"EUNICE LA",11,1,0,0,1,1,-92.41770172,30.49472046
231,"EUPORA MS",11,1,1,0,0,1,-89.26713562,33.54109192
231,"EUREKA CA",11,10,2,3,5,10,-124.1653366,40.80156708
231,"EUREKA MO",11,5,0,0,5,5,-90.62799835,38.50252533
231,"EUREKA MT",11,1,0,0,1,1,-115.0545731,48.88105392
231,"EUREKA SPRINGS AR",11,1,1,0,0,1,-93.73842621,36.40146255
231,"EUTAW AL",11,1,0,0,1,1,-87.88775635,32.84085083
231,"EVANS CO",11,4,1,2,1,4,-104.6938095,40.37656403
231,"EVANSTON IL",11,66,12,20,34,66,-87.69037628,42.04132843
231,"EVANSTON WY",11,6,2,2,2,6,-110.9652634,41.26803589
231,"EVANSVILLE IN",11,142,43,30,69,142,-87.56850433,37.97795486
231,"EVERETT MA",11,16,6,5,5,16,-71.05252075,42.40878296
231,"EVERETT WA",11,51,11,15,25,51,-122.2045441,47.97843552
231,"EVERGREEN PARK IL",11,1,0,1,0,1,-87.70169067,41.72086334
231,"EXCELSIOR SPRINGS MO",11,1,0,1,0,1,-94.22633362,39.33908463
231,"EXETER NH",11,4,1,2,1,4,-70.95800781,42.98471451
231,"FABIUS NY",11,1,0,0,1,1,-75.98513794,42.83499908
231,"FAIR GROVE MO",11,1,0,0,1,1,-93.15155792,37.38409424
231,"FAIR HAVEN NJ",11,55,14,13,28,55,-74.03659821,40.35977936
231,"FAIRBANKS AK",11,40,6,14,20,40,-147.7185669,64.83367157
231,"FAIRBORN OH",11,1,0,1,0,1,-84.01902771,39.82121658
231,"FAIRFAX CA",11,1,0,1,0,1,-122.5909805,37.98677063
231,"FAIRFAX MO",11,1,0,1,0,1,-95.39389038,40.3384285
231,"FAIRFAX VA",11,64,17,17,30,64,-77.30588531,38.84661865
231,"FAIRFIELD CA",11,10,4,1,5,10,-122.0420914,38.24917603
231,"FAIRFIELD CT",11,5,1,3,1,5,-73.26300049,41.14122772
231,"FAIRFIELD IA",11,4,1,1,2,4,-91.96311188,41.00863266
231,"FAIRFIELD OH",11,1,1,0,0,1,-84.56064606,39.34600449
231,"FAIRHAVEN MA",11,3,0,0,3,3,-70.902565,41.63794327
231,"FAIRHOPE AL",11,1,0,0,1,1,-87.90351105,30.52334213
231,"FAIRMONT CITY IL",11,2,0,1,1,2,-90.09365845,38.65008545
231,"FAIRMONT WV",11,3,1,1,1,3,-80.14244843,39.48347473
231,"FAIRMOUNT GA",11,3,0,0,3,3,-84.69966888,34.43648911
231,"FAIRVIEW PA",11,2,1,0,1,2,-80.25499725,42.03170013
231,"FAIRVIEW PARK OH",11,1,0,1,0,1,-81.86431885,41.44171524
231,"FALFURRIAS TX",11,1,0,1,0,1,-98.14491272,27.2275238
231,"FALKVILLE AL",11,1,0,0,1,1,-86.90859222,34.36846542
231,"FALL RIVER MA",11,7,0,5,2,7,-71.15414429,41.70151138
231,"FALLON NV",11,9,1,2,6,9,-118.7788696,39.47320557
231,"FALLS CHURCH VA",11,29,10,6,13,29,-77.17056274,38.88268661
231,"FALMOUTH MA",11,4,0,1,3,4,-70.61294556,41.56003571
231,"FARGO ND",11,59,14,17,28,59,-96.79805756,46.87498474
231,"FARMERS BRANCH TX",11,3,0,3,0,3,-96.89679718,32.92665482
231,"FARMINGDALE NY",11,3,2,0,1,3,-73.44436646,40.73298645
231,"FARMINGTON HILLS MI",11,20,7,7,6,20,-83.3771286,42.48558807
231,"FARMINGTON MI",11,8,2,1,5,8,-83.37620544,42.46465302
231,"FARMINGTON MN",11,3,1,0,2,3,-93.14386749,44.64002991
231,"FARMINGTON MO",11,4,1,1,2,4,-90.4220047,37.78110504
231,"FARMINGTON NH",11,3,1,1,1,3,-71.07139587,43.38951111
231,"FARMVILLE VA",11,1,1,0,0,1,-78.39121246,37.30234909
231,"FAYETTE MO",11,1,0,1,0,1,-92.68386078,39.14609146
231,"FAYETTEVILLE AR",11,52,10,12,30,52,-94.15759277,36.06256104
231,"FAYETTEVILLE GA",11,3,0,2,1,3,-84.45489502,33.44916916
231,"FAYETTEVILLE NC",11,111,27,30,54,111,-78.87771606,35.05313873
231,"FAYETTEVILLE NY",11,2,1,0,1,2,-76.0059433,43.02997971
231,"FAYETTEVILLE WV",11,1,1,0,0,1,-81.10643005,38.05362701
231,"FEDERAL WAY WA",11,43,17,11,15,43,-122.314415,47.32177734
231,"FEDERALSBURG MD",11,2,1,0,1,2,-75.77262115,38.69446945
231,"FENTON MI",11,2,0,1,1,2,-83.70490265,42.79768372
231,"FENTON MO",11,64,17,19,28,64,-90.43593597,38.51305771
231,"FERGUS FALLS MN",11,1,0,0,1,1,-96.07798004,46.28308868
231,"FERGUSON MO",11,129,42,39,48,129,-90.306633,38.74429321
231,"FERNANDINA BEACH FL",11,3,1,1,1,3,-81.46240234,30.66996193
231,"FERNDALE MI",11,73,17,15,41,73,-83.13441467,42.46089172
231,"FESTUS MO",11,7,1,3,3,7,-90.39609528,38.22088623
231,"FINDLAY OH",11,8,3,1,4,8,-83.64990997,41.04424286
231,"FISHERS IN",11,23,10,7,6,23,-86.0140152,39.95565414
231,"FITCHBURG MA",11,1,0,0,1,1,-71.79621124,42.58549881
231,"FITZGERALD GA",11,2,0,0,2,2,-83.25261688,31.71505928
231,"FLAGLER BEACH FL",11,3,0,1,2,3,-81.12680054,29.47527695
231,"FLAGSTAFF AZ",11,49,10,13,26,49,-111.6533051,35.19802475
231,"FLAT ROCK MI",11,1,0,0,1,1,-83.29182434,42.09670639
231,"FLATWOODS KY",11,3,1,2,0,3,-82.71713257,38.52272797
231,"FLATWOODS WV",11,2,1,0,1,2,-80.64941406,38.7231369
231,"FLETCHER NC",11,1,0,1,0,1,-82.501091,35.43087387
231,"FLINT MI",11,161,41,41,79,161,-83.68744659,43.01246643
231,"FLORAL PARK NY",11,1,0,1,0,1,-73.70424652,40.72377777
231,"FLORENCE AL",11,32,5,15,12,32,-87.67726898,34.7997818
231,"FLORENCE AZ",11,1,1,0,0,1,-111.3891525,33.0316925
231,"FLORENCE CO",11,36,12,9,15,36,-105.119751,38.39019012
231,"FLORENCE KY",11,5,1,2,2,5,-84.62657166,38.99923706
231,"FLORENCE OR",11,3,1,1,1,3,-124.1027145,43.98227692
231,"FLORENCE SC",11,54,12,17,25,54,-79.76351166,34.19935226
231,"FLORESVILLE TX",11,2,0,2,0,2,-98.15641022,29.13393784
231,"FLORHAM PARK NJ",11,1,0,1,0,1,-74.38710785,40.7882309
231,"FLORIDA CITY FL",11,1,0,0,1,1,-80.47893524,25.44846153
231,"FLORISSANT MO",11,115,40,20,55,115,-90.32299042,38.78946304
231,"FLOSSMOOR IL",11,3,1,1,1,3,-87.68474579,41.54309845
231,"FLOYD VA",11,51,14,21,16,51,-80.31944275,36.91149902
231,"FLUSHING MI",11,13,4,3,6,13,-83.85099792,43.06319427
231,"FOND DU LAC WI",11,36,7,13,16,36,-88.44734955,43.77285004
231,"FONTANA CA",11,16,2,7,7,16,-117.4363785,34.09202576
231,"FOREST CITY IA",11,1,0,0,1,1,-93.63772583,43.26252365
231,"FOREST GROVE OR",11,26,4,8,14,26,-123.1123581,45.51952362
231,"FOREST HILL TX",11,3,1,2,0,3,-97.26972198,32.67246246
231,"FOREST PARK GA",11,1,0,0,1,1,-84.36103058,33.62044144
231,"FOREST PARK IL",11,1,0,1,0,1,-87.81355286,41.87948608
231,"FOREST PARK OH",11,2,0,1,1,2,-84.50376892,39.2902565
231,"FORNEY TX",11,2,0,0,2,2,-96.47270966,32.74848175
231,"FORREST CITY AR",11,1,0,0,1,1,-90.79021454,35.00848389
231,"FORT COLLINS CO",11,279,75,88,116,279,-105.0858688,40.58546066
231,"FORT DODGE IA",11,3,1,2,0,3,-94.18049622,42.50019073
231,"FORT LAUDERDALE FL",11,245,60,66,119,245,-80.14283752,26.12309074
231,"FORT LEE NJ",11,3,0,0,3,3,-73.96900177,40.85113907
231,"FORT LUPTON CO",11,4,3,1,0,4,-104.8086929,40.07614517
231,"FORT MILL SC",11,10,4,2,4,10,-80.94496155,35.00762558
231,"FORT MITCHELL KY",11,2,0,1,1,2,-84.54763031,39.05939865
231,"FORT MYERS FL",11,25,8,6,11,25,-81.87184143,26.64133644
231,"FORT PAYNE AL",11,1,0,1,0,1,-85.71984863,34.44424438
231,"FORT PIERCE FL",11,8,3,3,2,8,-80.32531738,27.44716644
231,"FORT SCOTT KS",11,3,1,1,1,3,-94.70889282,37.83989716
231,"FORT SMITH AR",11,12,3,4,5,12,-94.39919281,35.3862114
231,"FORT VALLEY GA",11,1,0,0,1,1,-83.88742828,32.5541687
231,"FORT WALTON BEACH FL",11,8,2,2,4,8,-86.61834717,30.40767479
231,"FORT WAYNE IN",11,59,14,18,27,59,-85.13967896,41.07278061
231,"FORT WHITE FL",11,1,1,0,0,1,-82.71363068,29.92387581
231,"FORT WORTH TX",11,512,105,145,262,512,-97.32135773,32.72562027
231,"FOSTER CITY CA",11,2,0,0,2,2,-122.2733917,37.55817413
231,"FOUNTAIN INN SC",11,2,1,0,1,2,-82.20529175,34.69663239
231,"FOUNTAIN VALLEY CA",11,1,0,0,1,1,-117.9555054,33.70910645
231,"FRAMINGHAM MA",11,10,2,1,7,10,-71.41543579,42.27958298
231,"FRANKFORT IL",11,1,0,0,1,1,-87.8484726,41.49582291
231,"FRANKFORT KY",11,32,10,9,13,32,-84.87322235,38.20124054
231,"FRANKLIN IN",11,9,4,1,4,9,-86.05474854,39.48073578
231,"FRANKLIN KY",11,1,0,0,1,1,-86.57696533,36.72238159
231,"FRANKLIN TN",11,35,8,10,17,35,-86.87760162,35.92164993
231,"FRANKLIN WI",11,2,0,1,0,1,-89.581264495,43.550542835
231,"FREDERICK MD",11,53,11,14,28,53,-77.40981293,39.41444397
231,"FREDERICKSBURG TX",11,1,0,0,1,1,-98.87243652,30.27570152
231,"FREDERICKSBURG VA",11,16,2,5,9,16,-77.45996094,38.30348969
231,"FREDERICKTOWN MO",11,3,2,1,0,3,-90.29403687,37.5598793
231,"FREDONIA NY",11,6,2,3,1,6,-79.33128357,42.4403038
231,"FREEDOM PA",11,1,0,0,1,1,-80.25327301,40.68782806
231,"FREEHOLD NJ",11,1,0,1,0,1,-74.27283478,40.26020432
231,"FREEPORT IL",11,3,1,1,1,3,-89.62126923,42.29691696
231,"FREEPORT NY",11,1,0,1,0,1,-73.58229065,40.65803146
231,"FREMONT CA",11,82,30,15,37,82,-121.9740372,37.55101776
231,"FREMONT IN",11,1,1,0,0,1,-84.93248749,41.73084641
231,"FRESNO CA",11,208,54,49,105,208,-119.7739868,36.74755478
231,"FRIDLEY MN",11,7,2,2,3,7,-93.2636261,45.08617401
231,"FRIENDSWOOD TX",11,3,0,1,2,3,-95.20127106,29.53010368
231,"FRISCO CO",11,1,1,0,0,1,-106.0990143,39.57444763
231,"FRISCO TX",11,62,17,14,31,62,-96.82434082,33.15098572
231,"FRONT ROYAL VA",11,7,3,4,0,7,-78.19395447,38.91853714
231,"FROSTBURG MD",11,7,0,1,6,7,-78.92780304,39.65832138
231,"FRUITLAND PARK FL",11,1,0,0,1,1,-81.90615082,28.8618412
231,"FULLERTON CA",11,44,10,9,25,44,-117.9268646,33.87014771
231,"FULTON MO",11,1,0,0,1,1,-91.94814301,38.84679031
231,"GADSDEN AL",11,25,4,7,14,25,-86.00675201,34.01457596
231,"GAFFNEY SC",11,32,12,10,10,32,-81.64937592,35.07206345
231,"GAHANNA OH",11,1,0,1,0,1,-82.87860107,40.02072525
231,"GAINESVILLE FL",11,167,40,55,72,167,-82.32462311,29.65203285
231,"GAINESVILLE GA",11,7,0,4,3,7,-83.82389832,34.29787827
231,"GAINESVILLE TX",11,1,0,1,0,1,-97.13391113,33.62611008
231,"GAITHERSBURG MD",11,37,10,9,18,37,-77.20072174,39.14352417
231,"GALAX VA",11,1,0,0,1,1,-80.92372894,36.66142654
231,"GALESBURG IL",11,25,6,10,9,25,-90.37152863,40.9480629
231,"GALETON PA",11,1,0,0,1,1,-77.64122772,41.733181
231,"GALLATIN TN",11,9,2,3,4,9,-86.44691467,36.38848495
231,"GALLUP NM",11,2,0,1,1,2,-108.7434387,35.52494812
231,"GALT CA",11,2,0,0,2,2,-121.3024445,38.25453568
231,"GALVESTON IN",11,1,1,0,0,1,-86.19012451,40.57881165
231,"GALVESTON TX",11,21,5,5,11,21,-94.79576111,29.30070114
231,"GARDEN CITY KS",11,2,0,2,0,2,-100.8735352,37.97177505
231,"GARDEN CITY MI",11,1,1,0,0,1,-83.33091736,42.32582092
231,"GARDEN CITY MO",11,4,0,1,3,4,-94.19150543,38.56124496
231,"GARDEN GROVE CA",11,53,15,17,21,53,-117.943718,33.77397156
231,"GARDENA CA",11,6,4,2,0,6,-118.3105164,33.88837814
231,"GARDINER ME",11,2,0,1,1,2,-69.77404785,44.23034286
231,"GARDNER KS",11,10,2,4,4,10,-94.92789459,38.81066132
231,"GARDNER MA",11,1,0,1,0,1,-71.99727631,42.57534027
231,"GARLAND TX",11,23,9,8,6,23,-96.63926697,32.91297531
231,"GARNER NC",11,3,0,3,0,3,-78.61359406,35.71166992
231,"GARRETT IN",11,20,4,6,10,20,-85.13555908,41.3495636
231,"GARY IN",11,16,3,6,7,16,-87.33873749,41.59325409
231,"GAS CITY IN",11,1,0,0,1,1,-85.61326599,40.48720932
231,"GASSAWAY WV",11,1,0,1,0,1,-80.77455902,38.67528152
231,"GASTON OR",11,1,0,0,1,1,-123.141571,45.43574142
231,"GASTONIA NC",11,23,6,9,8,23,-81.18706512,35.26216507
231,"GATES MILLS OH",11,3,1,2,0,3,-81.40299225,41.51760483
231,"GATESVILLE TX",11,5,2,3,0,5,-97.74459839,31.43569565
231,"GAYLORD MI",11,3,0,2,1,3,-84.67483521,45.02762222
231,"GENEVA IL",11,5,1,1,3,5,-88.30541992,41.8876915
231,"GENEVA NY",11,3,1,1,1,3,-76.97723389,42.86890793
231,"GENOA CITY WI",11,2,1,1,0,2,-88.32978821,42.49824905
231,"GEORGETOWN CO",11,1,0,0,1,1,-105.6985626,39.70604706
231,"GEORGETOWN KY",11,4,0,2,2,4,-84.55860138,38.21012115
231,"GEORGETOWN SC",11,2,1,1,0,2,-79.28886414,33.37522888
231,"GEORGETOWN TX",11,21,4,10,7,21,-97.67801666,30.6329689
231,"GERMANTOWN TN",11,2,1,1,0,2,-89.80731201,35.08958817
231,"GERMANTOWN WI",11,8,0,3,5,8,-88.1105423,43.22859573
231,"GETTYSBURG PA",11,24,7,10,7,24,-77.23023224,39.83097076
231,"GIG HARBOR WA",11,43,8,17,18,43,-122.590683,47.32983398
231,"GILBERT AZ",11,32,13,7,12,32,-111.7899933,33.35302353
231,"GILBERT WV",11,1,0,0,1,1,-81.86518097,37.61510086
231,"GILLESPIE IL",11,1,1,0,0,1,-89.81998444,39.12971115
231,"GILROY CA",11,3,0,0,3,3,-121.570343,37.00583267
231,"GIRARD IL",11,2,0,1,1,2,-89.78087616,39.44666672
231,"GIRARD KS",11,1,0,0,1,1,-94.83834076,37.51137161
231,"GLADSTONE MO",11,11,6,3,2,11,-94.55509186,39.20398331
231,"GLASGOW KY",11,23,6,13,4,23,-85.91189575,36.99584961
231,"GLASSBORO NJ",11,13,6,3,4,13,-75.11103058,39.70306778
231,"GLASSPORT PA",11,4,1,2,1,4,-79.89176941,40.32497025
231,"GLEN ALPINE NC",11,1,0,0,1,1,-81.77864838,35.729496
231,"GLEN ROCK PA",11,2,0,0,2,2,-76.7299118,39.79356384
231,"GLENCOE MN",11,2,0,0,2,2,-94.15203094,44.76893234
231,"GLENDALE AZ",11,35,6,17,12,35,-112.1871796,33.5386467
231,"GLENDALE CA",11,83,13,19,51,83,-118.2566681,34.1423645
231,"GLENDALE HEIGHTS IL",11,1,0,1,0,1,-88.07187653,41.91030502
231,"GLENDIVE MT",11,2,1,1,0,2,-104.7115021,47.11004257
231,"GLENDORA CA",11,10,0,8,2,10,-117.8665314,34.13615417
231,"GLOUCESTER CITY NJ",11,1,0,0,1,1,-75.11563873,39.89209747
231,"GLOUCESTER MA",11,3,1,1,1,3,-70.66117096,42.61589432
231,"GLOVERSVILLE NY",11,1,0,0,1,1,-74.34265137,43.05316925
231,"GODFREY IL",11,6,3,2,1,6,-90.18669891,38.95780182
231,"GOLDEN CO",11,4,3,0,1,4,-105.2226791,39.75567627
231,"GOLDEN MS",11,2,0,0,2,2,-88.1887207,34.48841095
231,"GOLDEN VALLEY MN",11,15,5,2,8,15,-93.33234406,44.98583603
231,"GOLDENDALE WA",11,2,0,2,0,2,-120.8248444,45.82035828
231,"GOLDSBORO NC",11,2,0,0,2,2,-77.99216461,35.38506317
231,"GOLETA CA",11,1,0,1,0,1,-119.8299332,34.43574142
231,"GONZALES LA",11,1,0,0,1,1,-90.92044067,30.23900986
231,"GOODLAND KS",11,5,3,0,2,5,-101.7115326,39.35073471
231,"GOODRICH TX",11,16,5,4,7,16,-94.9467926,30.60574341
231,"GOOSE CREEK SC",11,5,0,1,4,5,-80.03201294,32.98114395
231,"GOSHEN IN",11,9,1,3,5,9,-85.8345871,41.58250046
231,"GOWRIE IA",11,2,1,1,0,2,-94.29121399,42.28058243
231,"GRAFTON WI",11,1,0,0,1,1,-87.95385742,43.31965637
231,"GRAHAM NC",11,3,0,2,1,3,-79.39993286,36.06936646
231,"GRANBURY TX",11,7,0,4,3,7,-97.79492187,32.44239044
231,"GRAND BLANC MI",11,3,0,0,3,3,-83.62955475,42.92750168
231,"GRAND FORKS ND",11,69,7,34,28,69,-97.03855133,47.92044067
231,"GRAND HAVEN MI",11,1,0,1,0,1,-86.22866058,43.06328964
231,"GRAND ISLAND NE",11,1,0,1,0,1,-98.34256744,40.92502213
231,"GRAND JUNCTION CO",11,20,5,8,7,20,-108.5520706,39.06374741
231,"GRAND MARAIS MN",11,1,0,1,0,1,-90.33486176,47.75009918
231,"GRAND PRAIRIE TX",11,64,23,17,24,64,-96.99823761,32.74625015
231,"GRAND RAPIDS MI",11,239,63,80,96,239,-85.66797638,42.96317291
231,"GRAND RAPIDS MN",11,1,1,0,0,1,-93.53067017,47.23724747
231,"GRAND RAPIDS OH",11,1,0,0,1,1,-83.864151,41.41199875
231,"GRANDVILLE MI",11,8,2,2,4,8,-85.76309204,42.90962982
231,"GRANGER WA",11,2,0,1,1,2,-120.1894989,46.34181976
231,"GRANITE CITY IL",11,78,21,24,33,78,-90.14891815,38.70147705
231,"GRANITE FALLS WA",11,1,1,0,0,1,-121.9720459,48.08432007
231,"GRANTHAM NH",11,3,2,0,1,3,-72.13131714,43.47785568
231,"GRANTS PASS OR",11,6,0,3,3,6,-123.3306351,42.43851471
231,"GRANVILLE OH",11,1,0,0,1,1,-82.51766205,40.06572723
231,"GRAPEVINE TX",11,34,6,9,19,34,-97.07859802,32.93464279
231,"GRAY GA",11,1,0,0,1,1,-83.53361511,33.00989532
231,"GRAYSLAKE IL",11,4,0,0,4,4,-88.04187775,42.34467697
231,"GREAT BEND KS",11,6,0,3,3,6,-98.76521301,38.36428452
231,"GREAT FALLS MT",11,4,0,1,3,4,-111.2823257,47.50692368
231,"GREAT NECK NY",11,1,0,0,1,1,-73.72780609,40.80078125
231,"GREECE NY",11,11,1,1,9,11,-77.69234467,43.21003342
231,"GREELEY CO",11,13,6,1,6,13,-104.7104645,40.42345047
231,"GREEN BAY WI",11,125,24,38,63,125,-88.01370239,44.51335907
231,"GREEN RIVER WY",11,1,0,0,1,1,-109.4680557,41.52866745
231,"GREEN TREE PA",11,2,0,0,1,1,-77.769512175,40.224866865
231,"GREENBELT MD",11,40,11,9,20,40,-76.87561035,39.00544357
231,"GREENBRIER AR",11,2,2,0,0,2,-92.38774872,35.2342453
231,"GREENEVILLE TN",11,3,0,0,3,3,-82.83133698,36.16376495
231,"GREENFIELD CA",11,1,0,0,1,1,-121.2459717,36.32072067
231,"GREENFIELD IN",11,4,1,1,2,4,-85.76914978,39.78491974
231,"GREENFIELD WI",11,1,0,0,1,1,-88.01258087,42.96144104
231,"GREENSBORO NC",11,226,57,64,105,226,-79.79152679,36.0729599
231,"GREENSBURG IN",11,1,0,0,1,1,-85.48336792,39.33731842
231,"GREENSBURG PA",11,17,3,2,12,17,-79.53821564,40.30168915
231,"GREENTOWN IN",11,1,1,0,0,1,-85.96633148,40.47829056
231,"GREENVILLE MI",11,2,0,0,2,2,-85.25269318,43.17775345
231,"GREENVILLE MS",11,112,14,39,59,112,-91.05704498,33.40253448
231,"GREENVILLE NC",11,31,6,10,15,31,-77.37215424,35.61170959
231,"GREENVILLE OH",11,5,1,2,2,5,-84.63294983,40.10294342
231,"GREENVILLE PA",11,8,2,4,2,8,-80.39095306,41.40464401
231,"GREENVILLE SC",11,415,111,116,188,415,-82.39870453,34.84753418
231,"GREENWICH CT",11,13,4,3,6,13,-73.62783051,41.02645111
231,"GREENWOOD AR",11,1,0,1,0,1,-94.2559433,35.21604156
231,"GREENWOOD IN",11,18,3,3,12,18,-86.10647583,39.61371994
231,"GREENWOOD MO",11,3,2,0,1,3,-94.34423828,38.85187912
231,"GREENWOOD MS",11,1,0,0,1,1,-90.17974091,33.51645279
231,"GREENWOOD SC",11,2,0,1,1,2,-82.16146088,34.19546509
231,"GREER SC",11,6,0,1,5,6,-82.22647095,34.9389267
231,"GRENADA MS",11,1,0,0,1,1,-89.80857849,33.76926804
231,"GRESHAM OR",11,17,1,4,12,17,-122.4333954,45.4980278
231,"GRETNA LA",11,3,0,1,2,3,-90.05435181,29.91518021
231,"GRIDLEY CA",11,1,0,0,1,1,-121.6955032,39.36335373
231,"GRIFFIN GA",11,4,0,2,2,4,-84.26403046,33.24713135
231,"GRIFFITH IN",11,5,1,1,3,5,-87.42803955,41.52181625
231,"GRIMES IA",11,1,1,0,0,1,-93.79144287,41.68823624
231,"GRINNELL IA",11,8,2,3,3,8,-92.72964478,41.7466507
231,"GROESBECK TX",11,2,0,0,2,2,-96.5342865,31.52480888
231,"GROSSE POINTE FARMS MI",11,1,0,0,1,1,-82.89137268,42.40936279
231,"GROSSE POINTE MI",11,1,0,0,1,1,-82.91183472,42.38628769
231,"GROTON CT",11,47,16,9,22,47,-72.07763672,41.3502121
231,"GROTON MA",11,1,0,0,1,1,-71.55770874,42.60856247
231,"GROVE CITY OH",11,9,1,5,3,9,-83.09304047,39.88161087
231,"GROVEPORT OH",11,1,0,1,0,1,-82.88549805,39.8524971
231,"GROVETOWN GA",11,1,0,0,1,1,-82.19797516,33.45065308
231,"GULF SHORES AL",11,8,3,2,3,8,-87.70103455,30.24625969
231,"GULFPORT FL",11,25,5,9,11,25,-82.70953369,27.74733734
231,"GULFPORT MS",11,89,20,30,39,89,-89.09369659,30.37276649
231,"GUNNISON CO",11,1,0,0,1,1,-106.9267273,38.54576874
231,"GUNTERSVILLE AL",11,9,1,4,4,9,-86.29457855,34.3585434
231,"GUNTOWN MS",11,1,0,0,1,1,-88.66011047,34.44345093
231,"GUSTINE CA",11,4,1,1,2,4,-121.001297,37.25769043
231,"GUTHRIE OK",11,1,0,0,1,1,-97.42609406,35.87893677
231,"GUYTON GA",11,2,2,0,0,2,-81.3910675,32.3367691
231,"GYPSUM CO",11,9,4,3,2,9,-106.9528198,39.64703369
231,"HACKENSACK NJ",11,4,3,1,0,4,-74.04291534,40.88635254
231,"HADDON HEIGHTS NJ",11,1,0,0,1,1,-75.06397247,39.87737656
231,"HADDONFIELD NJ",11,29,4,12,13,29,-75.03710937,39.89155197
231,"HAGERSTOWN MD",11,10,3,1,6,10,-77.71956635,39.641819
231,"HAHIRA GA",11,1,0,1,0,1,-83.37252808,30.99163818
231,"HAINES CITY FL",11,1,1,0,0,1,-81.61740875,28.1145668
231,"HAINESVILLE IL",11,2,0,0,2,2,-88.06796265,42.34496307
231,"HALF MOON BAY CA",11,10,4,2,4,10,-122.4299774,37.46336365
231,"HALLSTEAD PA",11,19,5,5,9,19,-75.74239349,41.96153259
231,"HALTOM CITY TX",11,1,0,0,1,1,-97.26971436,32.79956055
231,"HAMBURG NY",11,1,0,1,0,1,-78.82896423,42.71609879
231,"HAMDEN CT",11,16,3,4,9,16,-72.89596558,41.39611816
231,"HAMILTON NJ",11,7,2,0,5,7,-74.0803299,40.20712662
231,"HAMILTON NY",11,3,0,3,0,3,-75.54386902,42.82725906
231,"HAMILTON OH",11,6,0,1,5,6,-84.56098175,39.39949799
231,"HAMMOND IN",11,27,8,6,13,27,-87.50006104,41.58346558
231,"HAMMOND LA",11,12,1,4,7,12,-90.46140289,30.50458908
231,"HAMPSTEAD MD",11,3,3,0,0,3,-76.84955597,39.60499191
231,"HAMPTON VA",11,57,18,20,19,57,-76.34473419,37.03002548
231,"HAMTRAMCK MI",11,3,1,0,2,3,-83.04947662,42.39274597
231,"HANAHAN SC",11,1,0,0,1,1,-80.01743317,32.92184448
231,"HANFORD CA",11,6,0,3,3,6,-119.647934,36.32738113
231,"HANNIBAL MO",11,1,0,1,0,1,-91.35847473,39.70859146
231,"HANOVER NH",11,1,0,0,1,1,-72.28845215,43.70233917
231,"HANOVER PA",11,6,3,1,2,6,-76.98248291,39.80073929
231,"HAPEVILLE GA",11,1,0,1,0,1,-84.41027069,33.66032791
231,"HARBOR SPRINGS MI",11,14,5,4,5,14,-84.99181366,45.43172455
231,"HARDY AR",11,1,1,0,0,1,-91.48310089,36.31586838
231,"HARKER HEIGHTS TX",11,8,1,1,6,8,-97.66394806,31.08788109
231,"HARLAN KY",11,3,0,0,3,3,-83.32141113,36.84322739
231,"HARLINGEN TX",11,9,2,1,6,9,-97.69669342,26.19152069
231,"HARRISBURG NC",11,2,0,0,2,2,-80.65539551,35.32398224
231,"HARRISBURG PA",11,89,27,19,43,89,-76.88382721,40.27407455
231,"HARRISON NJ",11,9,1,3,5,9,-74.15542603,40.7465477
231,"HARRISONBURG VA",11,48,11,16,21,48,-78.86815643,38.44975281
231,"HARTFORD CT",11,113,29,42,42,113,-72.68445587,41.76383591
231,"HARTLAND WI",11,2,0,0,2,2,-88.34208679,43.1048317
231,"HARTSELLE AL",11,1,0,1,0,1,-86.93518066,34.44379425
231,"HARTSVILLE SC",11,46,15,10,21,46,-80.07303619,34.37445068
231,"HARTVILLE OH",11,1,0,1,0,1,-81.33060455,40.96377563
231,"HARVARD IL",11,1,0,1,0,1,-88.61376953,42.42207336
231,"HARVARD MA",11,1,0,1,0,1,-71.58187103,42.5003891
231,"HARVEY IL",11,6,0,4,2,6,-87.64677429,41.61020279
231,"HASTINGS-ON-HUDSON NY",11,1,0,1,0,1,-73.87804413,41.00286102
231,"HASTINGS MN",11,11,5,2,4,11,-92.85280609,44.7434082
231,"HASTINGS NE",11,5,1,1,3,5,-98.38917542,40.58628845
231,"HATTIESBURG MS",11,44,8,19,17,44,-89.29040527,31.32738686
231,"HAVANA IL",11,1,0,0,1,1,-90.06096649,40.30030823
231,"HAVELOCK NC",11,1,1,0,0,1,-76.90039825,34.87951279
231,"HAVERHILL MA",11,3,0,1,2,3,-71.07640076,42.77653122
231,"HAVRE MT",11,2,2,0,0,2,-109.6722336,48.55265808
231,"HAWKINSVILLE GA",11,2,0,0,2,2,-83.4718399,32.28422546
231,"HAWTHORNE CA",11,34,10,13,11,34,-118.3549194,33.91656113
231,"HAWTHORNE NJ",11,1,0,0,1,1,-74.15322876,40.94930649
231,"HAYDEN ID",11,1,0,1,0,1,-116.7890625,47.76594925
231,"HAYS KS",11,5,2,1,2,5,-99.32746887,38.87940598
231,"HAYWARD CA",11,50,11,12,27,50,-122.0832672,37.66890335
231,"HAZARD KY",11,1,0,0,1,1,-83.19326019,37.24993515
231,"HAZEL PARK MI",11,1,0,0,1,1,-83.10384369,42.46282196
231,"HAZELWOOD MO",11,5,3,0,2,5,-90.37133789,38.77171707
231,"HAZLET NJ",11,1,0,0,1,1,-74.19022369,40.41601563
231,"HEALDSBURG CA",11,6,1,5,0,6,-122.8713226,38.6101799
231,"HEARNE TX",11,5,2,1,2,5,-96.59375763,30.87876701
231,"HEAVENER OK",11,1,0,0,1,1,-94.60111237,34.88928986
231,"HEBRON IN",11,5,2,1,2,5,-87.20029449,41.31857681
231,"HEDGESVILLE WV",11,1,0,0,1,1,-77.99388123,39.55364609
231,"HELENA MT",11,42,10,15,17,42,-112.0374527,46.59269333
231,"HELLERTOWN PA",11,1,0,1,0,1,-75.3400116,40.57966995
231,"HELOTES TX",11,13,3,6,4,13,-98.69043732,29.57864761
231,"HEMET CA",11,1,1,0,0,1,-116.9736557,33.74770737
231,"HEMPSTEAD NY",11,5,1,0,4,5,-73.61798096,40.70619965
231,"HEMPSTEAD TX",11,2,0,0,2,2,-96.0789566,30.0979023
231,"HENDERSON KY",11,5,0,4,1,5,-87.58986664,37.8363266
231,"HENDERSON NC",11,1,0,0,1,1,-78.39831543,36.3300705
231,"HENDERSON NV",11,176,37,37,102,176,-114.9741058,36.03540421
231,"HENDERSON TN",11,1,1,0,0,1,-88.64147949,35.43937683
231,"HENDERSONVILLE NC",11,11,3,2,6,11,-82.46079254,35.31912994
231,"HENDERSONVILLE TN",11,5,2,0,3,5,-86.61997986,36.30472565
231,"HENRIETTA NY",11,6,1,1,4,6,-77.61167145,43.05939865
231,"HEPHZIBAH GA",11,1,0,0,1,1,-82.0966568,33.31433105
231,"HERCULANEUM MO",11,2,1,0,1,2,-90.38007355,38.26866531
231,"HERCULES CA",11,5,2,2,1,5,-122.2900772,38.01711655
231,"HERMISTON OR",11,2,1,0,1,2,-119.2915268,45.84025192
231,"HERMITAGE PA",11,1,0,1,0,1,-80.44813538,41.2335434
231,"HERMOSA BEACH CA",11,1,0,0,1,1,-118.401619,33.86245728
231,"HERNANDO MS",11,8,5,2,1,8,-89.99411774,34.82405853
231,"HERNDON VA",11,6,0,3,3,6,-77.38563538,38.96995544
231,"HESPERIA CA",11,2,0,2,0,2,-117.3026352,34.42634964
231,"HIALEAH FL",11,61,12,16,33,61,-80.27757263,25.85853386
231,"HIAWATHA KS",11,1,0,0,1,1,-95.53611755,39.85254669
231,"HICKORY NC",11,2,0,1,1,2,-81.34054565,35.72800827
231,"HIGH POINT NC",11,6,2,2,2,6,-80.00497437,35.95609665
231,"HIGHLAND CA",11,14,4,4,6,14,-117.2105789,34.12824631
231,"HIGHLAND HEIGHTS KY",11,1,0,0,1,1,-84.45198822,39.03324509
231,"HIGHLAND IL",11,1,0,1,0,1,-89.6713562,38.73976135
231,"HIGHLAND PARK IL",11,4,2,1,1,4,-87.80068207,42.18181992
231,"HIGHLAND PARK MI",11,1,0,0,1,1,-83.09667969,42.40581131
231,"HIGHLAND PARK NJ",11,5,0,4,1,5,-74.4232254,40.49617386
231,"HIGHLAND PARK TX",11,1,0,0,1,1,-96.80493164,32.8320961
231,"HILLIARD OH",11,2,0,2,0,2,-83.15856171,40.03361511
231,"HILLSBORO IL",11,4,0,1,3,4,-89.4937439,39.16139603
231,"HILLSBORO OH",11,1,1,0,0,1,-83.61119843,39.20261765
231,"HILLSBORO OR",11,85,24,26,35,85,-122.9927826,45.52270508
231,"HILLSBOROUGH NC",11,6,1,2,3,6,-79.09932709,36.07565308
231,"HILLSDALE IL",11,1,0,1,0,1,-90.17341614,41.61362839
231,"HILLSDALE MI",11,6,1,0,5,6,-84.63027191,41.91994095
231,"HILLSDALE NJ",11,1,0,0,1,1,-74.039711,41.00293732
231,"HILLSIDE NJ",11,2,0,0,2,2,-74.22960663,40.70137024
231,"HILTON HEAD ISLAND SC",11,1,0,0,1,1,-80.75251007,32.21665573
231,"HINESVILLE GA",11,9,2,2,5,9,-81.59757996,31.85308266
231,"HINSDALE IL",11,1,0,0,1,1,-87.9373703,41.80112076
231,"HINSDALE NH",11,1,0,0,1,1,-72.48535156,42.78657913
231,"HITCHCOCK TX",11,2,0,0,2,2,-95.01639557,29.34873009
231,"HOBART IN",11,4,0,1,3,4,-87.24478912,41.53391266
231,"HOBBS NM",11,2,1,0,1,2,-103.1330643,32.70048141
231,"HOBOKEN NJ",11,32,8,8,16,32,-74.0316925,40.7443428
231,"HOFFMAN ESTATES IL",11,2,0,1,1,2,-88.07968903,42.04299927
231,"HOKES BLUFF AL",11,1,1,0,0,1,-85.86613464,33.99843979
231,"HOLCOMB KS",11,1,1,0,0,1,-100.9902344,37.98623276
231,"HOLDEN MA",11,6,0,2,4,6,-71.86223602,42.35177994
231,"HOLLADAY UT",11,1,0,0,1,1,-111.8265915,40.66861343
231,"HOLLAND MI",11,23,6,7,10,23,-86.10916138,42.78744507
231,"HOLLIDAYSBURG PA",11,3,1,0,2,3,-78.38813782,40.42749405
231,"HOLLISTER CA",11,4,0,2,2,4,-121.4038849,36.85258865
231,"HOLLISTER MO",11,1,0,0,1,1,-93.21603394,36.62115479
231,"HOLLISTON MA",11,1,0,0,1,1,-71.42358398,42.2000885
231,"HOLLY SPRINGS MS",11,1,0,1,0,1,-89.44177246,34.77593994
231,"HOLLY SPRINGS NC",11,5,2,2,1,5,-78.83320618,35.65140915
231,"HOLLYWOOD FL",11,55,10,20,25,55,-80.14926147,26.01175499
231,"HOLYOKE MA",11,8,3,2,3,8,-72.61522675,42.20437241
231,"HOMER AK",11,1,1,0,0,1,-151.544632,59.64481735
231,"HOMER CITY PA",11,1,0,1,0,1,-79.16155243,40.54351425
231,"HOMESTEAD FL",11,10,4,1,5,10,-80.47710419,25.46927071
231,"HOMEWOOD AL",11,2,0,0,2,2,-86.80097961,33.47186661
231,"HOMEWOOD IL",11,1,1,0,0,1,-87.66596222,41.55735779
231,"HONEA PATH SC",11,1,0,1,0,1,-82.39147186,34.44694519
231,"HONEOYE FALLS NY",11,1,0,0,1,1,-77.58958435,42.95241547
231,"HOOD RIVER OR",11,13,4,3,6,13,-121.5108719,45.70785141
231,"HOPE MILLS NC",11,5,1,1,3,5,-78.94456482,34.97066498
231,"HOPEWELL VA",11,1,1,0,0,1,-77.28649139,37.30444336
231,"HOPKINS MN",11,1,0,0,1,1,-93.39242554,44.92610168
231,"HOPKINSVILLE KY",11,4,1,2,1,4,-87.48854828,36.86588287
231,"HOPKINTON MA",11,7,0,2,5,7,-71.52145386,42.22872543
231,"HOQUIAM WA",11,12,0,6,6,12,-123.8915939,46.98048782
231,"HORNELL NY",11,3,0,1,2,3,-77.66078949,42.3279686
231,"HORSHAM PA",11,1,0,0,1,1,-75.12754822,40.17853165
231,"HOT SPRINGS AR",11,43,12,14,17,43,-93.05556488,34.5039978
231,"HOUGHTON MI",11,6,2,3,1,6,-88.56951141,47.12665558
231,"HOUMA LA",11,5,2,0,3,5,-90.71982574,29.59630585
231,"HOUSTON MO",11,1,0,1,0,1,-91.95644379,37.3261528
231,"HOUSTON MS",11,1,0,0,1,1,-88.99927521,33.89876556
231,"HOUSTON PA",11,1,0,0,1,1,-80.21094513,40.24639511
231,"HOUSTON TX",11,4001,1023,1172,1806,4001,-95.36399841,29.76376343
231,"HUDSON MA",11,3,1,0,2,3,-71.57429504,42.39633942
231,"HUDSON OH",11,4,1,0,3,4,-81.44026947,41.2401619
231,"HUDSON WI",11,1,0,1,0,1,-92.75721741,44.97438431
231,"HUDSONVILLE MI",11,2,0,1,1,2,-85.86483002,42.87105942
231,"HUGO MN",11,1,0,1,0,1,-92.99368286,45.15986252
231,"HULBERT OK",11,1,0,1,0,1,-95.14168549,35.93264771
231,"HULL MA",11,1,0,1,0,1,-70.90122223,42.304142
231,"HUMBLE TX",11,10,2,2,6,10,-95.26166534,29.99774551
231,"HUNTERSVILLE NC",11,8,3,0,5,8,-80.83785248,35.41359711
231,"HUNTINGDON PA",11,1,0,0,1,1,-78.00988007,40.48491669
231,"HUNTINGTON BEACH CA",11,20,3,7,10,20,-118.0006027,33.66012955
231,"HUNTINGTON IN",11,2,1,0,1,2,-85.49169159,40.87822342
231,"HUNTINGTON NY",11,1,0,1,0,1,-73.42463684,40.86833191
231,"HUNTINGTON PARK CA",11,1,0,0,1,1,-118.2265549,33.98159409
231,"HUNTINGTON UT",11,1,0,1,0,1,-110.966156,39.32650757
231,"HUNTINGTON WV",11,49,11,18,20,49,-82.44620514,38.4181366
231,"HUNTSVILLE AL",11,274,77,84,113,274,-86.58609772,34.73073959
231,"HUNTSVILLE TX",11,16,2,7,7,16,-95.55122375,30.72374153
231,"HURST TX",11,2,1,0,1,2,-97.17115021,32.82357407
231,"HUTCHINSON KS",11,10,1,5,4,10,-97.93050385,38.06093216
231,"HUTTO TX",11,1,1,0,0,1,-97.54733276,30.54326057
231,"HYATTSVILLE MD",11,36,7,5,24,36,-76.94467163,38.95636749
231,"HYDE PARK NY",11,2,0,1,1,2,-73.93060303,41.79148865
231,"IDAHO FALLS ID",11,25,6,7,12,25,-112.035408,43.46630478
231,"IMPERIAL CA",11,13,2,3,8,13,-115.5716705,32.84782791
231,"INDEPENDENCE KY",11,3,1,2,0,3,-84.54380035,38.94332886
231,"INDEPENDENCE MO",11,36,7,11,18,36,-94.41611481,39.09104538
231,"INDEPENDENCE OH",11,2,0,1,1,2,-81.64063263,41.3945961
231,"INDEPENDENCE OR",11,6,3,2,1,6,-123.1894913,44.8509407
231,"INDEX WA",11,7,2,2,3,7,-121.5567322,47.82598877
231,"INDIAN ROCKS BEACH FL",11,2,1,1,0,2,-82.85096741,27.87600517
231,"INDIAN TRAIL NC",11,1,0,1,0,1,-80.66901398,35.07696915
231,"INDIANA PA",11,21,4,3,14,21,-79.15187073,40.6216507
231,"INDIANAPOLIS IN",11,857,226,235,396,857,-86.15828705,39.76844788
231,"INDIANOLA IA",11,1,0,1,0,1,-93.55815887,41.35812378
231,"INDIO CA",11,34,9,8,17,34,-116.2173004,33.72047043
231,"INGLESIDE TX",11,1,0,1,0,1,-97.21211243,27.87829399
231,"INGLEWOOD CA",11,80,20,24,36,80,-118.354805,33.96157074
231,"INKSTER MI",11,2,1,1,0,2,-83.31001282,42.29439926
231,"INTERLACHEN FL",11,1,0,0,1,1,-81.8901062,29.62431526
231,"INVER GROVE HEIGHTS MN",11,2,2,0,0,2,-93.02364349,44.85364151
231,"INVERNESS MS",11,1,0,0,1,1,-90.59259033,33.35402679
231,"IOWA CITY IA",11,165,41,59,65,165,-91.53023529,41.66130066
231,"IOWA FALLS IA",11,1,0,1,0,1,-93.26483917,42.51951218
231,"IPSWICH MA",11,3,1,1,1,3,-70.84001923,42.67964554
231,"IRMO SC",11,2,0,0,2,2,-81.18247223,34.08623123
231,"IRONDEQUOIT NY",11,3,0,2,1,3,-77.57932281,43.21369171
231,"IRONTON OH",11,4,2,2,0,4,-82.68261719,38.53668976
231,"IRVINE CA",11,91,29,26,36,91,-117.8243942,33.66952515
231,"IRVING TX",11,57,14,21,22,57,-96.94924927,32.81419754
231,"IRVINGTON NY",11,7,7,0,0,7,-73.86441803,41.03897858
231,"ISLE MN",11,4,1,2,1,4,-93.47118378,46.13795471
231,"ISLE OF PALMS SC",11,2,1,1,0,2,-79.79431152,32.78720093
231,"ISLIP NY",11,1,0,0,1,1,-73.20967102,40.7298851
231,"ISSAQUAH WA",11,6,2,2,2,6,-122.0345993,47.52977753
231,"ITHACA NY",11,153,47,42,64,153,-76.49575043,42.44075775
231,"JACINTO CITY TX",11,2,0,0,2,2,-95.23432159,29.76779175
231,"JACKSON MI",11,28,7,10,11,28,-84.40149689,42.24575043
231,"JACKSON MO",11,5,3,0,2,5,-89.66656494,37.38225174
231,"JACKSON MS",11,311,74,89,148,311,-90.19654846,32.298172
231,"JACKSON TN",11,73,30,12,31,73,-88.81397247,35.61472321
231,"JACKSON WY",11,5,3,1,1,5,-110.7644806,43.4798851
231,"JACKSONVILLE AL",11,7,3,3,1,7,-85.76148987,33.81370163
231,"JACKSONVILLE AR",11,1,0,0,1,1,-92.11023712,34.86617279
231,"JACKSONVILLE BEACH FL",11,73,14,19,40,73,-81.39300537,30.29505539
231,"JACKSONVILLE FL",11,429,107,109,213,429,-81.65545654,30.33253288
231,"JACKSONVILLE IL",11,1,1,0,0,1,-90.22943115,39.73405838
231,"JACKSONVILLE NC",11,17,4,7,6,17,-77.42939758,34.75283813
231,"JACKSONVILLE TX",11,1,1,0,0,1,-95.27114868,31.96398926
231,"JAMESTOWN NC",11,3,0,1,2,3,-79.93502045,35.99464417
231,"JAMESTOWN ND",11,4,0,1,3,4,-98.70591736,46.90496063
231,"JAMESTOWN NY",11,5,3,2,0,5,-79.23510742,42.09712601
231,"JANESVILLE WI",11,40,11,11,18,40,-89.01893616,42.68303299
231,"JASPER AL",11,16,8,2,6,16,-87.27728271,33.83164597
231,"JASPER FL",11,1,0,0,1,1,-82.94778442,30.51891518
231,"JASPER TX",11,1,0,1,0,1,-93.9970932,30.92081833
231,"JEANNETTE PA",11,1,0,1,0,1,-79.61497498,40.32809448
231,"JEFFERSON CITY MO",11,61,24,10,27,61,-92.17385864,38.57698441
231,"JEFFERSON CITY TN",11,3,1,2,0,3,-83.48968506,36.11675644
231,"JEFFERSON GA",11,2,2,0,0,2,-83.57225037,34.11717606
231,"JEFFERSON OH",11,1,1,0,0,1,-80.76942444,41.73855209
231,"JEFFERSON SC",11,1,0,0,1,1,-80.38873291,34.65048599
231,"JEFFERSONVILLE IN",11,5,1,2,2,5,-85.73719788,38.27765656
231,"JENNINGS MO",11,34,10,11,13,34,-90.26077271,38.71944046
231,"JEROME AZ",11,35,8,13,14,35,-112.1151428,34.74900055
231,"JERSEY CITY NJ",11,168,48,45,75,168,-74.07667542,40.72816849
231,"JIM THORPE PA",11,4,1,0,3,4,-75.73157501,40.87605667
231,"JOHNSON CITY TN",11,33,9,10,14,33,-82.35308075,36.31352615
231,"JOHNSTOWN PA",11,3,1,0,2,3,-78.92127228,40.326931
231,"JOLIET IL",11,44,12,9,23,44,-88.08213043,41.52493668
231,"JONES OK",11,4,1,2,1,4,-97.28777313,35.56618881
231,"JONESBORO AR",11,34,9,13,12,34,-90.70430756,35.84226608
231,"JONESBORO GA",11,13,5,4,4,13,-84.35381317,33.52181625
231,"JONESBORO IL",11,2,1,0,1,2,-89.26836395,37.45198059
231,"JONESBORO LA",11,3,1,0,2,3,-92.71629333,32.24162292
231,"JONESTOWN MS",11,1,0,0,1,1,-90.45589447,34.31987381
231,"JOPLIN MO",11,23,7,6,10,23,-94.5140686,37.08442688
231,"JORDAN MN",11,1,0,0,1,1,-93.62203979,44.66780853
231,"JUPITER FL",11,90,23,32,35,90,-80.09382629,26.9349556
231,"JUSTIN TX",11,1,0,0,1,1,-97.29656219,33.08527374
231,"KAHOKA MO",11,3,2,0,1,3,-91.71973419,40.42050934
231,"KALAMAZOO MI",11,245,66,69,110,245,-85.58725739,42.29179764
231,"KALISPELL MT",11,11,3,2,6,11,-114.3166199,48.20161438
231,"KANKAKEE IL",11,2,0,1,1,2,-87.86149597,41.12018204
231,"KANNAPOLIS NC",11,1,0,0,1,1,-80.62119293,35.48755264
231,"KANSAS CITY KS",11,15,4,3,8,15,-94.62808228,39.1141777
231,"KANSAS CITY MO",11,1755,471,463,821,1755,-94.57884979,39.09976578
231,"KAPLAN LA",11,2,1,0,1,2,-92.28516388,29.99839401
231,"KATY TX",11,43,13,8,22,43,-95.82484436,29.78606224
231,"KAUFMAN TX",11,1,0,0,1,1,-96.30930328,32.58925247
231,"KAUKAUNA WI",11,5,0,2,3,5,-88.27227783,44.27797699
231,"KEARNEY MO",11,1,0,1,0,1,-94.36273956,39.36795044
231,"KEARNEY NE",11,7,3,2,2,7,-99.08208466,40.69932938
231,"KEARNY NJ",11,4,1,3,0,4,-74.14439392,40.76873398
231,"KEENE NH",11,3,1,2,0,3,-72.27714539,42.93392563
231,"KEIZER OR",11,1,0,0,1,1,-123.0285339,44.98967743
231,"KELLER TX",11,7,4,1,2,7,-97.25247192,32.93486786
231,"KENAI AK",11,1,1,0,0,1,-151.2597809,60.55926895
231,"KENDALL WI",11,2,0,2,0,2,-90.36859894,43.79189682
231,"KENDALLVILLE IN",11,5,4,0,1,5,-85.27036285,41.44488525
231,"KENMORE NY",11,2,1,0,1,2,-78.86985779,42.96615982
231,"KENMORE WA",11,7,3,3,1,7,-122.2464905,47.7568779
231,"KENNEBUNK ME",11,1,0,0,1,1,-70.5438385,43.38429642
231,"KENNEBUNKPORT ME",11,2,1,0,1,2,-70.47593689,43.36188126
231,"KENNER LA",11,1,0,0,1,1,-90.24167633,29.99442101
231,"KENNESAW GA",11,33,5,10,18,33,-84.61528015,34.02365875
231,"KENNETT MO",11,6,2,1,3,6,-90.05591583,36.23639297
231,"KENNEWICK WA",11,13,1,5,7,13,-119.1395264,46.2107811
231,"KENOSHA WI",11,10,4,1,5,10,-87.82134247,42.58494949
231,"KENSINGTON MD",11,6,1,3,2,6,-77.07564545,39.02577972
231,"KENT OH",11,36,6,11,19,36,-81.35736084,41.15368271
231,"KENT WA",11,115,34,35,46,115,-122.2377701,47.38068008
231,"KENTON OH",11,1,0,1,0,1,-83.60956573,40.64719391
231,"KENTWOOD LA",11,2,1,1,0,2,-90.50920868,30.93878746
231,"KENTWOOD MI",11,2,2,0,0,2,-85.64472198,42.86936569
231,"KERMAN CA",11,1,0,0,1,1,-120.0621414,36.723423
231,"KERNERSVILLE NC",11,3,2,1,0,3,-80.07332611,36.12029266
231,"KERRVILLE TX",11,5,1,2,2,5,-99.14083099,30.04796982
231,"KETCHIKAN AK",11,1,0,1,0,1,-131.6417084,55.34326935
231,"KETTERING OH",11,2,0,1,1,2,-84.1687088,39.68964005
231,"KEY BISCAYNE FL",11,1,0,1,0,1,-80.16217804,25.6944294
231,"KEY WEST FL",11,66,16,15,35,66,-81.78218079,24.556427
231,"KEYPORT NJ",11,1,0,1,0,1,-74.1986084,40.4332695
231,"KILL DEVIL HILLS NC",11,3,0,0,3,3,-75.6541214,36.01398468
231,"KILLEEN TX",11,11,3,5,3,11,-97.72832489,31.11753464
231,"KINGFISHER OK",11,4,1,3,0,4,-97.93222809,35.8614006
231,"KINGMAN AZ",11,4,0,0,4,4,-114.0542908,35.18925858
231,"KINGMAN KS",11,8,3,0,5,8,-98.11450958,37.64601517
231,"KINGSBURG CA",11,1,1,0,0,1,-119.5561218,36.5138588
231,"KINGSLAND GA",11,1,0,0,1,1,-81.68964386,30.80049896
231,"KINGSPORT TN",11,72,18,17,37,72,-82.56182861,36.54841232
231,"KINGSTON GA",11,1,0,0,1,1,-84.94379425,34.23725891
231,"KINGSTON NY",11,30,10,11,9,30,-73.99665833,41.92714691
231,"KINGSTON PA",11,3,0,0,3,3,-75.89610291,41.26209641
231,"KINSTON NC",11,4,1,1,2,4,-77.58128357,35.26295471
231,"KIRBY TX",11,1,0,0,1,1,-98.38637543,29.46365166
231,"KIRKLAND WA",11,49,19,10,20,49,-122.2108688,47.6813736
231,"KIRKWOOD MO",11,53,20,12,21,53,-90.40686798,38.5832901
231,"KISSIMMEE FL",11,24,5,4,15,24,-81.40729523,28.29271317
231,"KITTERY ME",11,2,1,1,0,2,-70.73544312,43.08844376
231,"KITTY HAWK NC",11,1,0,1,0,1,-75.70478058,36.06485367
231,"KLAMATH FALLS OR",11,2,0,1,1,2,-121.7844772,42.2244873
231,"KNOXVILLE IA",11,1,0,1,0,1,-93.1031189,41.31895828
231,"KNOXVILLE TN",11,244,61,77,106,244,-83.92067719,35.96077728
231,"KOKOMO IN",11,30,8,8,14,30,-86.12706757,40.48566818
231,"KOUNTZE TX",11,15,4,2,9,15,-94.31259918,30.3719101
231,"KURE BEACH NC",11,2,2,0,0,2,-77.90657043,33.99703979
231,"KUTZTOWN PA",11,3,0,0,3,3,-75.77677917,40.51739502
231,"KYLE TX",11,4,1,0,3,4,-97.87797546,29.9895649
231,"LA CROSSE WI",11,29,8,10,11,29,-91.23967743,43.80151367
231,"LA FERIA TX",11,2,1,1,0,2,-97.82754517,26.1601181
231,"LA GRANDE OR",11,15,8,4,3,15,-118.090126,45.32435989
231,"LA HABRA CA",11,1,0,0,1,1,-117.9494629,33.93001556
231,"LA MESA CA",11,12,1,5,6,12,-117.0447464,32.76841354
231,"LA MIRADA CA",11,5,3,1,1,5,-118.0295639,33.85194778
231,"LA PINE OR",11,1,0,0,1,1,-121.5054627,43.67027664
231,"LA PORTE TX",11,6,0,3,3,6,-95.01729584,29.66588402
231,"LA VERGNE TN",11,3,1,1,1,3,-86.58178711,36.01600266
231,"LA VERNE CA",11,7,0,4,3,7,-117.7696304,34.1006546
231,"LA VETA CO",11,1,0,1,0,1,-105.0112076,37.51592636
231,"LACEY WA",11,6,0,5,1,6,-122.8096161,47.03732681
231,"LACKAWANNA NY",11,1,0,1,0,1,-78.82299805,42.8258667
231,"LACONIA NH",11,4,0,0,2,2,-71.46888733,43.52740097
231,"LADUE MO",11,1,0,0,1,1,-90.38077545,38.64994049
231,"LAFAYETTE CA",11,6,0,5,1,6,-122.1200104,37.88574982
231,"LAFAYETTE CO",11,34,10,14,10,34,-105.0904388,39.99370956
231,"LAFAYETTE IN",11,27,7,8,12,27,-86.88406372,40.42077255
231,"LAFAYETTE LA",11,115,28,28,59,115,-92.01987457,30.22468185
231,"LAFAYETTE OR",11,4,2,2,0,4,-123.1177979,45.24378967
231,"LAGRANGE OH",11,1,1,0,0,1,-82.11968231,41.23716736
231,"LAGUNA BEACH CA",11,20,8,2,10,20,-117.7847061,33.54205322
231,"LAKE ARTHUR LA",11,1,0,0,1,1,-92.67166901,30.08100891
231,"LAKE CHARLES LA",11,28,4,9,15,28,-93.21766663,30.22713852
231,"LAKE FOREST IL",11,4,0,2,2,4,-87.84095764,42.25865555
231,"LAKE GENEVA WI",11,5,0,2,3,5,-88.43348694,42.59184265
231,"LAKE HAVASU CITY AZ",11,4,3,1,0,4,-114.3244324,34.48379517
231,"LAKE MARY FL",11,5,1,0,4,5,-81.31755829,28.75924492
231,"LAKE OSWEGO OR",11,7,2,2,3,7,-122.6727066,45.42033005
231,"LAKE PARK FL",11,1,0,0,1,1,-80.06585693,26.80088615
231,"LAKE PLACID FL",11,4,4,0,0,4,-81.36245728,27.29381371
231,"LAKE STATION IN",11,5,0,4,1,5,-87.23908997,41.57525253
231,"LAKE STEVENS WA",11,3,1,0,2,3,-122.0684662,48.01782227
231,"LAKE VILLA IL",11,2,1,0,1,2,-88.07393646,42.4168129
231,"LAKE WORTH FL",11,2,1,0,1,2,-80.05649567,26.61662102
231,"LAKE ZURICH IL",11,1,0,0,1,1,-88.09326935,42.1971283
231,"LAKELAND FL",11,21,5,7,9,21,-81.95620728,28.04432487
231,"LAKEMOOR IL",11,3,1,0,2,3,-88.19921875,42.32862854
231,"LAKESIDE PARK KY",11,1,0,0,1,1,-84.56926727,39.03553772
231,"LAKEVILLE MN",11,9,3,3,3,9,-93.24331665,44.64937973
231,"LAKEWOOD CA",11,13,3,5,5,13,-118.1357193,33.85370636
231,"LAKEWOOD CO",11,18,6,5,7,18,-105.0827332,39.70486069
231,"LAKEWOOD OH",11,56,18,12,26,56,-81.79773712,41.48223114
231,"LAKEWOOD WA",11,16,0,2,6,8,-122.3653679,47.661533355
231,"LAMAR CO",11,2,0,0,2,2,-102.6111527,38.08679581
231,"LAMBERTVILLE NJ",11,2,1,0,1,2,-74.94231415,40.36618423
231,"LANCASTER CA",11,18,6,5,7,18,-118.1386871,34.69804001
231,"LANCASTER KS",11,1,0,1,0,1,-95.30338287,39.57285309
231,"LANCASTER NY",11,3,2,0,1,3,-78.67009735,42.90063477
231,"LANCASTER OH",11,1,1,0,0,1,-82.59890747,39.71387482
231,"LANCASTER PA",11,100,31,25,44,100,-76.30498505,40.03824234
231,"LANCASTER SC",11,2,1,0,1,2,-80.76622772,34.71495819
231,"LANCASTER TX",11,2,1,0,1,2,-96.75682831,32.59244156
231,"LANDOVER HILLS MD",11,5,1,1,3,5,-76.89152527,38.94342804
231,"LANGHORNE PA",11,2,0,0,2,2,-74.92177582,40.17494965
231,"LANGLEY WA",11,3,0,1,2,3,-122.4162674,48.03789139
231,"LANSDALE PA",11,1,1,0,0,1,-75.28330994,40.24167633
231,"LANSDOWNE PA",11,3,0,2,1,3,-75.27108765,39.93852234
231,"LANSING IL",11,11,2,3,6,11,-87.5393219,41.56502151
231,"LANSING MI",11,149,44,35,70,149,-84.55532074,42.73265839
231,"LANTANA FL",11,1,0,1,0,1,-80.05174255,26.58732224
231,"LAPEER MI",11,12,1,3,8,12,-83.31890869,43.05135345
231,"LARAMIE WY",11,31,8,12,11,31,-105.592804,41.3115387
231,"LARCHMONT NY",11,1,0,1,0,1,-73.7507782,40.92812729
231,"LAREDO TX",11,40,8,10,22,40,-99.50824738,27.50720978
231,"LARGO FL",11,81,17,32,32,81,-82.78675079,27.91026115
231,"LARKSPUR CA",11,1,0,1,0,1,-122.5373993,37.93414688
231,"LAS CRUCES NM",11,38,9,11,18,38,-106.7798538,32.31209564
231,"LAS VEGAS NV",11,1886,486,553,847,1886,-115.1382141,36.17488098
231,"LATHROP CA",11,7,0,5,2,7,-121.2790833,37.82243729
231,"LATROBE PA",11,4,1,1,2,4,-79.37892914,40.32139206
231,"LAUDERDALE LAKES FL",11,15,3,4,8,15,-80.20793915,26.1671524
231,"LAUDERHILL FL",11,1,1,0,0,1,-80.21311188,26.14096451
231,"LAUREL MS",11,1,0,0,1,1,-89.13054657,31.69452286
231,"LAWRENCE IN",11,3,1,1,1,3,-86.02498627,39.83873749
231,"LAWRENCE KS",11,237,64,76,97,237,-95.23565674,38.97153091
231,"LAWRENCE MA",11,5,1,3,1,5,-71.15792084,42.70630646
231,"LAWRENCEBURG KY",11,6,3,1,2,6,-84.89624023,38.03728867
231,"LAWRENCEBURG TN",11,11,2,4,5,11,-87.33492279,35.24256897
231,"LAWRENCEVILLE GA",11,22,6,10,6,22,-83.98753357,33.95662308
231,"LAWRENCEVILLE IL",11,1,0,1,0,1,-87.68203735,38.7292366
231,"LAWTON OK",11,59,16,10,33,59,-98.39124298,34.60861969
231,"LAYTON UT",11,3,2,0,1,3,-111.9724808,41.06021118
231,"LE CLAIRE IA",11,1,0,0,1,1,-90.3465271,41.59780884
231,"LEAGUE CITY TX",11,18,3,3,12,18,-95.09550476,29.50793457
231,"LEANDER TX",11,10,4,2,4,10,-97.85368347,30.57936287
231,"LEAVENWORTH KS",11,1,0,1,0,1,-94.92282867,39.31124115
231,"LEAVENWORTH WA",11,1,0,1,0,1,-120.6632767,47.59615707
231,"LEAWOOD KS",11,4,1,2,1,4,-94.61756897,38.96688461
231,"LEBANON IN",11,1,0,0,1,1,-86.46936035,40.0486412
231,"LEBANON MO",11,2,1,0,1,2,-92.66392517,37.68081284
231,"LEBANON NH",11,1,0,0,1,1,-72.251091,43.64245987
231,"LEBANON OH",11,7,1,2,4,7,-84.20275879,39.43528748
231,"LEBANON PA",11,3,0,1,2,3,-76.41091156,40.34118652
231,"LEBANON TN",11,15,4,2,9,15,-86.29133606,36.20846939
231,"LEBANON VA",11,1,0,0,1,1,-82.07959747,36.90112305
231,"LEESBURG FL",11,14,4,7,3,14,-81.87727356,28.81123161
231,"LEESBURG GA",11,1,0,1,0,1,-84.17071533,31.73245049
231,"LEESBURG VA",11,12,3,3,6,12,-77.56890869,39.11256027
231,"LEHI UT",11,6,1,2,3,6,-111.8519974,40.39155197
231,"LEMON GROVE CA",11,3,0,1,2,3,-117.0335465,32.74267197
231,"LENEXA KS",11,9,4,4,1,9,-94.73374176,38.95368576
231,"LENOIR NC",11,1,0,1,0,1,-81.53869629,35.91436386
231,"LEOMINSTER MA",11,1,0,0,1,1,-71.75862122,42.52514648
231,"LESLIE MO",11,9,1,6,2,9,-91.23233795,38.41774368
231,"LEWES DE",11,3,0,1,2,3,-75.1359024,38.77365494
231,"LEWISTON ID",11,2,0,0,2,2,-117.0198975,46.41637421
231,"LEWISTON ME",11,6,1,3,2,6,-70.21377563,44.10037231
231,"LEWISTON NY",11,1,0,1,0,1,-79.03521729,43.17250061
231,"LEWISTOWN PA",11,1,0,1,0,1,-77.57058716,40.59930801
231,"LEWISVILLE TX",11,24,8,4,12,24,-96.99449921,33.04630661
231,"LEXINGTON MA",11,5,3,1,1,5,-71.22381592,42.44742584
231,"LEXINGTON NC",11,3,1,2,0,3,-80.25289154,35.8242569
231,"LEXINGTON SC",11,15,6,5,4,15,-81.23597717,33.98204041
231,"LEXINGTON TN",11,1,0,0,1,1,-88.39100647,35.64579391
231,"LEXINGTON VA",11,20,8,4,8,20,-79.4422226,37.78420639
231,"LIBERAL KS",11,2,0,2,0,2,-100.9224777,37.04306412
231,"LIBERAL MO",11,2,0,1,1,2,-94.52056122,37.55810547
231,"LIBERTY KY",11,1,0,0,1,1,-84.93912506,37.31856537
231,"LIBERTY MO",11,25,6,12,7,25,-94.4196167,39.24604034
231,"LIBERTY NY",11,1,0,1,0,1,-74.74575043,41.80154037
231,"LIBERTY SC",11,2,0,0,2,2,-82.69210052,34.78824234
231,"LIBERTY TX",11,1,0,0,1,1,-94.79598999,30.05861664
231,"LIGONIER PA",11,2,0,2,0,2,-79.23710632,40.24316025
231,"LILBURN GA",11,9,1,4,4,9,-84.14273834,33.89017868
231,"LILLINGTON NC",11,1,1,0,0,1,-78.81506348,35.39981079
231,"LIMA OH",11,15,2,2,11,15,-84.10490417,40.74259186
231,"LINCOLN CA",11,4,1,2,1,4,-121.2951202,38.89149475
231,"LINCOLN IL",11,2,1,0,1,2,-89.36495209,40.1486702
231,"LINCOLN NE",11,98,19,21,58,98,-96.6674118,40.80001068
231,"LINCOLN PARK MI",11,3,0,2,1,3,-83.17868042,42.25064468
231,"LINCOLNTON NC",11,1,1,0,0,1,-81.25417328,35.47389603
231,"LINCOLNWOOD IL",11,1,0,0,1,1,-87.73023987,42.00463104
231,"LINDALE TX",11,3,1,1,1,3,-95.40984344,32.51585007
231,"LINDENHURST NY",11,1,0,0,1,1,-73.37233734,40.68688583
231,"LINO LAKES MN",11,1,1,0,0,1,-93.08938599,45.16019058
231,"LISBON OH",11,1,0,0,1,1,-80.76804352,40.77227402
231,"LITCHFIELD CT",11,1,0,1,0,1,-73.18777466,41.74758911
231,"LITTLE CHUTE WI",11,9,3,0,6,9,-88.31884003,44.27976608
231,"LITTLE FALLS NJ",11,1,1,0,0,1,-74.20709229,40.86914444
231,"LITTLE ROCK AR",11,263,61,64,138,263,-92.28178406,34.7369194
231,"LITTLETON CO",11,10,4,3,3,10,-105.0176163,39.6132431
231,"LIVE OAK FL",11,1,0,1,0,1,-82.98397064,30.29559708
231,"LIVERMORE CA",11,7,1,2,4,7,-121.7701416,37.68147659
231,"LIVERPOOL NY",11,3,0,0,3,3,-76.21547699,43.10769653
231,"LIVINGSTON MT",11,4,2,1,1,4,-110.5622253,45.66219711
231,"LIVONIA MI",11,23,6,3,14,23,-83.35256958,42.36862564
231,"LLANO TX",11,5,2,3,0,5,-98.67580414,30.7595768
231,"LOCK HAVEN PA",11,1,1,0,0,1,-77.44603729,41.13732147
231,"LOCKPORT NY",11,1,0,0,1,1,-78.69011688,43.17089081
231,"LOCUST GROVE GA",11,1,0,0,1,1,-84.10900879,33.3461113
231,"LODI CA",11,20,7,2,11,20,-121.2742386,38.12984467
231,"LOGAN UT",11,32,9,10,13,32,-111.8171616,41.73900604
231,"LOGAN WV",11,1,0,0,1,1,-81.99302673,37.8519783
231,"LOGANSPORT IN",11,1,0,1,0,1,-86.36410522,40.75329208
231,"LOGANVILLE GA",11,2,0,0,2,2,-83.90035248,33.83914948
231,"LOMBARD IL",11,2,2,0,0,2,-88.00775909,41.8800621
231,"LOMIRA WI",11,12,3,5,4,12,-88.44380188,43.59117126
231,"LOMPOC CA",11,5,4,1,0,5,-120.4598694,34.63894272
231,"LONDON KY",11,1,0,1,0,1,-84.08328247,37.12937546
231,"LONG BEACH CA",11,245,64,76,105,245,-118.1908112,33.7670517
231,"LONG BEACH NY",11,16,4,3,9,16,-73.6654129,40.58349991
231,"LONG BEACH WA",11,3,0,1,2,3,-124.0569916,46.35176086
231,"LONG BRANCH NJ",11,1,0,0,1,1,-73.991745,40.30428314
231,"LONG GROVE IL",11,3,0,1,2,3,-87.99829865,42.17835617
231,"LONGMONT CO",11,27,6,9,12,27,-105.1026764,40.16700745
231,"LONGVIEW TX",11,6,0,4,2,6,-94.73707581,32.4966507
231,"LONGVIEW WA",11,37,10,12,15,37,-122.9404221,46.1375885
231,"LORAIN OH",11,10,0,4,6,10,-82.17118073,41.45874023
231,"LORIS SC",11,6,0,4,2,6,-78.89011383,34.05680084
231,"LOS ALAMITOS CA",11,2,0,0,2,2,-118.0414505,33.77706909
231,"LOS ALTOS CA",11,16,5,7,4,16,-122.1163025,37.38525772
231,"LOS ANGELES CA",11,7544,2002,2064,3478,7544,-118.2459106,34.05225754
231,"LOS FRESNOS TX",11,2,2,0,0,2,-97.47680664,26.07257271
231,"LOS GATOS CA",11,11,3,2,6,11,-121.9771652,37.22674561
231,"LOS LUNAS NM",11,1,0,0,1,1,-106.7300263,34.80502701
231,"LOUISA KY",11,2,0,1,1,2,-82.60322571,38.11429596
231,"LOUISA VA",11,3,1,1,1,3,-78.00349426,38.0253067
231,"LOUISBURG KS",11,5,3,1,1,5,-94.68140411,38.61960602
231,"LOUISVILLE CO",11,6,1,2,3,6,-105.1326523,39.97768402
231,"LOVELADY TX",11,1,0,0,1,1,-95.44617462,31.12744713
231,"LOVELAND CO",11,9,3,3,3,9,-105.0755997,40.39763641
231,"LOVELAND OH",11,1,1,0,0,1,-84.25993347,39.26356506
231,"LOVELL WY",11,1,1,0,0,1,-108.3907242,44.83721924
231,"LOVES PARK IL",11,2,2,0,0,2,-89.05864716,42.31984711
231,"LOWELL IN",11,7,3,4,0,7,-87.42073059,41.29130173
231,"LOWELL MA",11,30,8,5,17,30,-71.31530762,42.63344574
231,"LOWELL MI",11,1,1,0,0,1,-85.34220123,42.93387604
231,"LOWVILLE NY",11,1,0,1,0,1,-75.49127197,43.78682709
231,"LUBBOCK TX",11,56,13,14,29,56,-101.8544312,33.59677505
231,"LUCAS KS",11,1,0,1,0,1,-98.53717041,39.05620193
231,"LUCEDALE MS",11,2,0,1,1,2,-88.59013367,30.92567635
231,"LUDINGTON MI",11,1,1,0,0,1,-86.4526062,43.95513153
231,"LUFKIN TX",11,13,1,6,6,13,-94.72932434,31.33858681
231,"LUMBERTON NC",11,1,0,0,1,1,-79.00803375,34.61832428
231,"LUMBERTON NJ",11,1,0,0,1,1,-74.80423737,39.9662323
231,"LURAY VA",11,1,0,0,1,1,-78.45899963,38.66542816
231,"LUTHER OK",11,3,1,1,1,3,-97.19435883,35.66645432
231,"LUTTRELL TN",11,1,0,1,0,1,-83.74188995,36.19982529
231,"LYNCHBURG VA",11,16,6,6,4,16,-79.14174652,37.41383362
231,"LYNDEN WA",11,7,0,2,5,7,-122.455101,48.94639969
231,"LYNDHURST NJ",11,2,0,2,0,2,-74.12353516,40.81222153
231,"LYNDHURST OH",11,3,1,0,2,3,-81.48820496,41.52012253
231,"LYNN MA",11,19,4,9,6,19,-70.94833374,42.46699905
231,"LYNNWOOD WA",11,19,2,8,9,19,-122.3175736,47.82042313
231,"LYNWOOD CA",11,16,2,7,7,16,-118.2135544,33.93053055
231,"LYNWOOD IL",11,1,1,0,0,1,-87.53853607,41.52642059
231,"MACOMB IL",11,5,0,1,4,5,-90.67189026,40.45938873
231,"MADELIA MN",11,3,0,2,1,3,-94.42191315,44.05470276
231,"MADERA CA",11,7,4,0,3,7,-120.0627594,36.96101379
231,"MADISON AL",11,10,2,1,2,5,-86.487213135,33.561834335
231,"MADISON HEIGHTS MI",11,6,2,2,2,6,-83.10519409,42.48604965
231,"MADISON IL",11,2,0,0,2,2,-90.15700531,38.68284988
231,"MADISON IN",11,1,0,1,0,1,-85.39073181,38.74140167
231,"MADISON MS",11,10,3,3,4,10,-90.11543274,32.46231079
231,"MADISON NC",11,1,0,0,1,1,-79.95928192,36.38565063
231,"MADISON NJ",11,2,1,0,1,2,-74.41627502,40.76013184
231,"MADISON WI",11,534,136,154,244,534,-89.40128326,43.07303619
231,"MADISON WV",11,1,0,1,0,1,-81.82273102,38.06180191
231,"MADISONVILLE LA",11,2,0,2,0,2,-90.15699005,30.40480232
231,"MADISONVILLE TN",11,2,0,0,2,2,-84.3633728,35.5197525
231,"MAGNOLIA AR",11,1,0,0,1,1,-93.23983765,33.26739883
231,"MAGNOLIA TX",11,2,1,1,0,2,-95.75150299,30.20981598
231,"MAIDEN ROCK WI",11,1,1,0,0,1,-92.31015778,44.56087494
231,"MAINEVILLE OH",11,1,1,0,0,1,-84.2207489,39.31535339
231,"MALDEN MA",11,3,0,2,1,3,-71.06546783,42.42518234
231,"MALDEN MO",11,1,0,1,0,1,-89.96641541,36.55708313
231,"MALVERN AR",11,9,0,2,7,9,-92.81313324,34.36237717
231,"MALVERN PA",11,3,1,1,1,3,-75.51319885,40.03642654
231,"MAMMOTH LAKES CA",11,1,0,0,1,1,-119.0125961,37.60457611
231,"MANASQUAN NJ",11,2,2,0,0,2,-74.04832458,40.12630463
231,"MANASSAS VA",11,17,5,7,5,17,-77.47459412,38.75112534
231,"MANCELONA MI",11,3,2,0,1,3,-85.06100464,44.90218735
231,"MANCHESTER CT",11,1,1,0,0,1,-72.52075958,41.77622986
231,"MANCHESTER MO",11,5,0,2,3,5,-90.50953674,38.597229
231,"MANCHESTER NH",11,76,24,26,26,76,-71.45406342,42.99581528
231,"MANDEVILLE LA",11,5,1,2,2,5,-90.06562805,30.35881805
231,"MANHATTAN BEACH CA",11,26,7,10,9,26,-118.4129181,33.88484192
231,"MANHATTAN IL",11,1,0,0,1,1,-87.98616791,41.42261124
231,"MANHATTAN KS",11,36,9,15,12,36,-96.57228851,39.18354034
231,"MANISTEE MI",11,1,0,0,1,1,-86.3241806,44.24435043
231,"MANITOU SPRINGS CO",11,4,1,1,2,4,-104.9184494,38.85948944
231,"MANITOWOC WI",11,3,1,0,2,3,-87.65751648,44.08858871
231,"MANKATO MN",11,82,23,16,43,82,-94.02125549,44.15895462
231,"MANNING SC",11,43,8,13,22,43,-80.21025085,33.69546509
231,"MANOR TX",11,1,0,1,0,1,-97.55760193,30.34129524
231,"MANSFIELD AR",11,4,2,0,2,4,-94.2530365,35.05989456
231,"MANSFIELD MA",11,1,0,0,1,1,-71.21801758,42.03358078
231,"MANSFIELD OH",11,8,3,2,3,8,-82.51545715,40.75864792
231,"MANSFIELD TX",11,11,3,1,7,11,-97.14230347,32.56362152
231,"MANTECA CA",11,12,2,2,8,12,-121.2179031,37.79747391
231,"MANVEL TX",11,1,0,0,1,1,-95.35823822,29.46306229
231,"MAPLE GROVE MN",11,15,0,5,10,15,-93.47679138,45.14711761
231,"MAPLE SHADE NJ",11,4,0,1,3,4,-74.9913559,39.95294571
231,"MAPLE VALLEY WA",11,4,0,3,1,4,-122.0403976,47.40601349
231,"MAPLETON UT",11,1,0,1,0,1,-111.5824585,40.13248444
231,"MAPLEWOOD MN",11,2,1,0,1,2,-93.05480194,45.01259232
231,"MAPLEWOOD MO",11,23,10,5,8,23,-90.32471466,38.6126976
231,"MAPLEWOOD NJ",11,30,5,7,18,30,-74.27243805,40.77401733
231,"MAQUOKETA IA",11,16,6,6,4,16,-90.66600037,42.06900024
231,"MARATHON FL",11,2,0,1,1,2,-81.09011841,24.71463966
231,"MARBLE FALLS TX",11,1,0,0,1,1,-98.27365875,30.5784893
231,"MARBLEHEAD MA",11,3,0,0,3,3,-70.85662079,42.50020599
231,"MARFA TX",11,55,10,20,25,55,-104.0205383,30.30808449
231,"MARIANNA FL",11,2,0,1,1,2,-85.22673798,30.77488518
231,"MARICOPA AZ",11,18,6,3,9,18,-112.0491562,33.05832672
231,"MARIETTA GA",11,89,20,34,35,89,-84.54958344,33.9527359
231,"MARIETTA OK",11,2,0,0,2,2,-97.11754608,33.93697739
231,"MARINA CA",11,2,1,1,0,2,-121.8042831,36.6841507
231,"MARINE CITY MI",11,1,0,0,1,1,-82.49177551,42.71967697
231,"MARINETTE WI",11,1,0,0,1,1,-87.63109589,45.10002518
231,"MARINGOUIN LA",11,1,0,0,1,1,-91.51993561,30.49166107
231,"MARION AL",11,1,1,0,0,1,-87.31942749,32.63277054
231,"MARION AR",11,3,1,2,0,3,-90.19646454,35.21472931
231,"MARION IA",11,1,0,0,1,1,-91.60752869,42.032547
231,"MARION IL",11,8,1,4,3,8,-88.93344116,37.73056412
231,"MARION IN",11,20,3,10,7,20,-85.65896606,40.55827332
231,"MARION KS",11,1,1,0,0,1,-97.018013,38.34838867
231,"MARION OH",11,9,4,1,4,9,-83.12861633,40.58881378
231,"MARION SC",11,1,0,1,0,1,-79.40047455,34.18493271
231,"MARISSA IL",11,1,1,0,0,1,-89.7505188,38.25014496
231,"MARKS MS",11,9,1,4,4,9,-90.27207947,34.25684357
231,"MARLBORO NJ",11,1,1,0,0,1,-74.24552917,40.31547546
231,"MARLBOROUGH MA",11,5,1,1,3,5,-71.55128479,42.34592819
231,"MARQUETTE MI",11,7,2,2,3,7,-87.39571381,46.54323196
231,"MARS PA",11,2,0,0,2,2,-80.01100159,40.69602585
231,"MARSHALL MI",11,92,27,30,35,92,-84.9631424,42.27227402
231,"MARSHALL MN",11,13,7,3,3,13,-95.78921509,44.4466362
231,"MARSHALL MO",11,3,1,0,2,3,-93.19745636,39.12294769
231,"MARSHALL NC",11,2,1,0,1,2,-82.68395996,35.79773331
231,"MARSHALL TX",11,3,0,2,1,3,-94.36775208,32.5450592
231,"MARSHALLTOWN IA",11,4,0,0,4,4,-92.90861511,42.04956055
231,"MARSHFIELD WI",11,3,0,1,2,3,-90.17188263,44.66900635
231,"MARTIN GA",11,2,0,2,0,2,-83.1847229,34.48738861
231,"MARTIN TN",11,2,0,0,2,2,-88.85335541,36.34902573
231,"MARTINEZ CA",11,12,2,0,10,12,-122.1364365,38.01914597
231,"MARTINS FERRY OH",11,4,1,0,3,4,-80.72425842,40.09586716
231,"MARTINSBURG WV",11,1,0,1,0,1,-77.96557617,39.45707703
231,"MARTINSVILLE IN",11,1,0,1,0,1,-86.42851257,39.42800903
231,"MARYLAND HEIGHTS MO",11,17,10,5,2,17,-90.43025208,38.71334076
231,"MARYSVILLE CA",11,2,1,0,1,2,-121.5933762,39.14567947
231,"MARYSVILLE MI",11,1,0,1,0,1,-82.48686218,42.91244888
231,"MARYSVILLE OH",11,1,0,1,0,1,-83.36706543,40.2364006
231,"MARYSVILLE WA",11,15,4,1,10,15,-122.179451,48.05155182
231,"MARYVILLE IL",11,1,0,1,0,1,-89.95622253,38.72364044
231,"MARYVILLE MO",11,6,4,1,1,6,-94.87281036,40.34609604
231,"MARYVILLE TN",11,6,0,0,6,6,-83.96243286,35.76000977
231,"MASCOUTAH IL",11,1,1,0,0,1,-89.79308319,38.49026489
231,"MASON CITY IA",11,3,1,1,1,3,-93.20175934,43.15355301
231,"MASON MI",11,1,1,0,0,1,-84.44378662,42.57910538
231,"MASON OH",11,10,4,1,5,10,-84.30989075,39.36032104
231,"MASON TN",11,39,9,16,14,39,-89.5331192,35.41201401
231,"MASONTOWN PA",11,1,0,1,0,1,-79.89925385,39.84680176
231,"MASSENA NY",11,1,0,0,1,1,-74.89122772,44.92828751
231,"MASSILLON OH",11,3,3,0,0,3,-81.52096558,40.7966156
231,"MATHIS TX",11,1,0,0,1,1,-97.82859802,28.09514809
231,"MATTESON IL",11,1,0,0,1,1,-87.71334839,41.50400162
231,"MATTHEWS NC",11,3,3,0,0,3,-80.72332001,35.11704254
231,"MATTOON IL",11,3,1,2,0,3,-88.37306976,39.48309326
231,"MAULDIN SC",11,1,1,0,0,1,-82.30957794,34.77907562
231,"MAUMEE OH",11,2,1,1,0,2,-83.65665436,41.56746292
231,"MAYFIELD HEIGHTS OH",11,1,0,0,1,1,-81.45755005,41.51942062
231,"MAYFIELD KY",11,2,1,0,1,2,-88.63654327,36.74169922
231,"MAYNARD MA",11,3,2,1,0,3,-71.44880676,42.43361664
231,"MAYVILLE WI",11,1,1,0,0,1,-88.54499817,43.49409103
231,"MAYWOOD IL",11,8,5,2,1,8,-87.84314728,41.87941742
231,"MCALESTER OK",11,3,0,0,3,3,-95.77042389,34.93368149
231,"MCALLEN TX",11,41,10,13,18,41,-98.23077393,26.20433426
231,"MCDONOUGH GA",11,2,1,0,1,2,-84.1467514,33.44765472
231,"MCFARLAND WI",11,1,0,1,0,1,-89.28981781,43.01242828
231,"MCHENRY IL",11,7,2,2,3,7,-88.2740097,42.34480286
231,"MCKINNEY TX",11,23,7,4,12,23,-96.6155777,33.19782257
231,"MCLEANSBORO IL",11,1,0,0,1,1,-88.53587341,38.09341049
231,"MCMINNVILLE OR",11,8,4,3,1,8,-123.2019272,45.20968628
231,"MCPHERSON KS",11,3,1,1,1,3,-97.66510773,38.37078094
231,"MEADVILLE MO",11,1,0,1,0,1,-93.3026123,39.78415298
231,"MEBANE NC",11,6,2,1,3,6,-79.26649475,36.09629059
231,"MECHANICSBURG PA",11,8,3,2,3,8,-77.00779724,40.21432114
231,"MECHANICVILLE NY",11,1,0,0,1,1,-73.68631744,42.90293121
231,"MEDFORD LAKES NJ",11,1,0,0,1,1,-74.80196381,39.85878754
231,"MEDFORD MA",11,30,7,7,16,30,-71.10526276,42.41849518
231,"MEDFORD NJ",11,3,0,2,1,3,-74.82254791,39.90135193
231,"MEDFORD OR",11,9,1,2,6,9,-122.8773193,42.32625961
231,"MEDIA PA",11,4,1,1,2,4,-75.38693237,39.91692734
231,"MEDICAL LAKE WA",11,5,2,1,2,5,-117.682518,47.57226944
231,"MEDINA OH",11,7,2,3,2,7,-81.86336517,41.13858795
231,"MEDWAY MA",11,3,0,2,1,3,-71.39579773,42.14194107
231,"MELBOURNE FL",11,18,5,6,7,18,-80.60625458,28.07838249
231,"MELISSA TX",11,1,0,1,0,1,-96.57331848,33.28625488
231,"MELROSE MA",11,3,1,1,1,3,-71.07271576,42.45837784
231,"MELVINDALE MI",11,1,1,0,0,1,-83.17527771,42.2828331
231,"MEMPHIS TN",11,1044,289,279,476,1044,-90.01696014,35.1194191
231,"MENA AR",11,23,6,10,7,23,-94.24035645,34.58638
231,"MENDOTA HEIGHTS MN",11,3,1,2,0,3,-93.12650299,44.88226318
231,"MENLO PARK CA",11,38,13,4,21,38,-122.1842423,37.45361328
231,"MENOMINEE MI",11,2,1,1,0,2,-87.61431885,45.10792542
231,"MENOMONEE FALLS WI",11,11,5,3,3,11,-88.11719513,43.17907715
231,"MENOMONIE WI",11,1,1,0,0,1,-91.92002106,44.87564468
231,"MENTOR-ON-THE-LAKE OH",11,1,0,0,1,1,-81.36006927,41.70515442
231,"MENTOR OH",11,9,3,3,3,9,-81.33918762,41.66637421
231,"MERCED CA",11,44,14,10,20,44,-120.4848785,37.30197525
231,"MERCEDES TX",11,3,1,0,2,3,-97.91394043,26.15032959
231,"MERIDIAN ID",11,4,2,1,1,4,-116.3941193,43.611866
231,"MERIDIAN MS",11,4,0,1,3,4,-88.70374298,32.36473846
231,"MERRIAM KS",11,2,2,0,0,2,-94.69395447,39.02367401
231,"MERRILLVILLE IN",11,2,0,0,2,2,-87.33312988,41.48298645
231,"MESA AZ",11,164,55,22,87,164,-111.8239059,33.42222214
231,"MESQUITE TX",11,26,3,5,18,26,-96.59959412,32.76692581
231,"METUCHEN NJ",11,2,1,0,1,2,-74.36269379,40.543293
231,"MEXIA TX",11,1,0,0,1,1,-96.48291016,31.68026352
231,"MEXICO BEACH FL",11,2,0,2,0,2,-85.41775513,29.94825554
231,"MEXICO MO",11,9,4,2,3,9,-91.8833313,39.16965866
231,"MIAMI BEACH FL",11,142,34,35,73,142,-80.12982178,25.79146576
231,"MIAMI FL",11,1330,364,369,597,1330,-80.19329071,25.77483749
231,"MIAMI OK",11,1,1,0,0,1,-94.87779999,36.87476349
231,"MIAMI SPRINGS FL",11,1,0,0,1,1,-80.28911591,25.82328033
231,"MIAMISBURG OH",11,1,0,0,1,1,-84.28652191,39.643116
231,"MIDDLEBURG HEIGHTS OH",11,1,0,1,0,1,-81.81239319,41.3615799
231,"MIDDLEBURY VT",11,28,8,5,15,28,-73.16629028,44.01540756
231,"MIDDLETON MA",11,1,0,0,1,1,-71.01519775,42.59541702
231,"MIDDLETON WI",11,4,0,1,3,4,-89.50476074,43.09717941
231,"MIDDLETOWN CT",11,14,3,6,5,14,-72.64955902,41.56232071
231,"MIDDLETOWN DE",11,6,1,2,3,6,-75.71700287,39.44935226
231,"MIDDLETOWN NJ",11,7,3,0,4,7,-74.11607361,40.39449692
231,"MIDDLETOWN NY",11,1,0,1,0,1,-74.4223938,41.44607544
231,"MIDLAND MI",11,14,5,2,7,14,-84.24700928,43.61585236
231,"MIDLAND TX",11,12,4,3,5,12,-102.0793686,31.99754143
231,"MIDLOTHIAN TX",11,2,2,0,0,2,-96.99511719,32.4827919
231,"MIDWEST CITY OK",11,2,0,1,1,2,-97.39709473,35.44970703
231,"MILFORD CT",11,2,1,1,0,2,-73.05560303,41.2226181
231,"MILFORD DE",11,2,0,1,1,2,-75.42737579,38.9128685
231,"MILFORD MA",11,31,10,10,11,31,-71.51522064,42.14015198
231,"MILFORD MI",11,1,0,1,0,1,-83.59909821,42.59347534
231,"MILFORD NY",11,11,6,4,1,11,-74.94455719,42.59064865
231,"MILFORD OH",11,1,0,1,0,1,-84.29400635,39.17559433
231,"MILFORD PA",11,2,0,0,2,2,-74.80150604,41.3222847
231,"MILL VALLEY CA",11,22,9,5,8,22,-122.5473328,37.90579224
231,"MILLBROOK AL",11,5,0,4,1,5,-86.36187744,32.48031998
231,"MILLEDGEVILLE GA",11,4,1,0,3,4,-83.23179626,33.08055878
231,"MILLERSVILLE PA",11,1,0,0,1,1,-76.35368347,39.99788666
231,"MILLINGTON TN",11,1,0,0,1,1,-89.89770508,35.34148788
231,"MILLIS MA",11,1,1,0,0,1,-71.35676575,42.16779327
231,"MILLTOWN NJ",11,1,0,0,1,1,-74.44260406,40.45628738
231,"MILPITAS CA",11,5,4,1,0,5,-121.9090805,37.42808533
231,"MILTON FL",11,1,0,0,1,1,-87.03953552,30.63289833
231,"MILTON MA",11,1,0,0,1,1,-71.06531525,42.25027466
231,"MILTON PA",11,2,1,0,1,2,-76.84694672,41.0123024
231,"MILTON WI",11,7,3,1,3,7,-88.9439621,42.77545547
231,"MILWAUKEE WI",11,806,197,237,372,806,-87.90684509,43.03887939
231,"MILWAUKIE OR",11,3,0,1,2,3,-122.6417084,45.44596481
231,"MINDEN LA",11,96,27,13,56,96,-93.28716278,32.61589432
231,"MINEOLA NY",11,1,0,1,0,1,-73.63988495,40.74962234
231,"MINERAL WELLS TX",11,2,2,0,0,2,-98.11335754,32.80846024
231,"MINIER IL",11,3,2,1,0,3,-89.31304932,40.43381882
231,"MINNEAPOLIS MN",11,1462,423,389,650,1462,-93.26397705,44.97980118
231,"MINNEOLA FL",11,1,0,0,1,1,-81.74643707,28.57386589
231,"MINNETONKA MN",11,5,0,3,2,5,-93.43367004,44.92795181
231,"MINNEWAUKAN ND",11,1,0,1,0,1,-99.25090027,48.06991959
231,"MINOT ND",11,4,0,1,3,4,-101.2953949,48.23139572
231,"MIRAMAR FL",11,19,2,7,10,19,-80.23181915,25.98794746
231,"MISHAWAKA IN",11,11,1,3,7,11,-86.18048859,41.65872574
231,"MISSION KS",11,89,24,31,34,89,-94.65638733,39.02796173
231,"MISSION TX",11,14,1,3,10,14,-98.32580566,26.21655273
231,"MISSION VIEJO CA",11,8,2,4,2,8,-117.6737366,33.59992218
231,"MISSOULA MT",11,65,20,20,25,65,-113.9832687,46.87278366
231,"MISSOURI CITY TX",11,18,1,7,10,18,-95.5381012,29.61878204
231,"MOAB UT",11,6,1,2,3,6,-109.5508347,38.57315063
231,"MOBERLY MO",11,3,1,0,2,3,-92.43862152,39.41818619
231,"MOBILE AL",11,94,29,26,39,94,-88.04309845,30.69476128
231,"MODESTO CA",11,224,65,63,96,224,-120.9991455,37.63897324
231,"MOLINE IL",11,6,3,1,2,6,-90.51522064,41.5069809
231,"MONAHANS TX",11,3,0,1,2,3,-102.8932419,31.59444237
231,"MONCKS CORNER SC",11,1,1,0,0,1,-80.01290131,33.19626236
231,"MONESSEN PA",11,1,0,0,1,1,-79.88707733,40.14862442
231,"MONETT MO",11,1,0,1,0,1,-93.92830658,36.92906952
231,"MONONA WI",11,2,1,1,0,2,-89.33418274,43.06205368
231,"MONROE GA",11,1,1,0,0,1,-83.71302795,33.79499817
231,"MONROE LA",11,33,7,14,12,33,-92.11960602,32.50980759
231,"MONROE MI",11,7,0,2,5,7,-83.39758301,41.91663742
231,"MONROE NY",11,3,0,3,0,3,-74.18616486,41.33085632
231,"MONROEVILLE PA",11,1,0,1,0,1,-79.74937439,40.4387207
231,"MONROVIA CA",11,21,9,8,4,21,-118.0006485,34.14796829
231,"MONTAGUE MI",11,3,3,0,0,3,-86.35713959,43.41694641
231,"MONTCLAIR NJ",11,21,7,10,4,21,-74.20848083,40.82605362
231,"MONTEBELLO CA",11,4,0,1,3,4,-118.1069412,34.00930023
231,"MONTEREY CA",11,27,9,6,12,27,-121.8974838,36.6002388
231,"MONTEREY PARK CA",11,5,0,4,1,5,-118.1248398,34.06269836
231,"MONTEVALLO AL",11,1,0,1,0,1,-86.86419678,33.10087967
231,"MONTGOMERY AL",11,96,21,22,53,96,-86.29966736,32.36724472
231,"MONTGOMERY TX",11,3,1,1,1,3,-95.69664001,30.38855171
231,"MONTICELLO IL",11,1,0,0,1,1,-88.57354736,40.02787399
231,"MONTICELLO IN",11,1,0,1,0,1,-86.76451874,40.74537659
231,"MONTICELLO MS",11,1,0,0,1,1,-90.11628723,31.55413437
231,"MONTPELIER VT",11,4,3,0,1,4,-72.57458496,44.26039124
231,"MOON PA",11,5,3,1,1,5,-80.23907471,40.50891876
231,"MOORE OK",11,27,9,7,11,27,-97.48735046,35.33969498
231,"MOOREFIELD WV",11,1,1,0,0,1,-78.96636963,39.06458664
231,"MOORESTOWN NJ",11,4,3,1,0,4,-74.94165039,39.96718597
231,"MOORESVILLE IN",11,1,0,1,0,1,-86.37399292,39.61291504
231,"MOORESVILLE NC",11,3,2,1,0,3,-80.80976868,35.58535004
231,"MOORHEAD MN",11,10,3,2,5,10,-96.76844025,46.87382507
231,"MOORPARK CA",11,6,0,3,3,6,-118.8839111,34.28554535
231,"MOREHEAD KY",11,2,0,0,2,2,-83.43223572,38.18409348
231,"MORGAN CITY LA",11,2,1,0,1,2,-91.20729065,29.69994926
231,"MORGAN HILL CA",11,6,1,1,4,6,-121.6563797,37.1303978
231,"MORGANTON NC",11,3,0,1,2,3,-81.68434906,35.74584961
231,"MORGANTOWN WV",11,117,30,34,53,117,-79.95038605,39.63131714
231,"MORRIS MN",11,7,3,1,3,7,-95.91436005,45.58617401
231,"MORRISON CO",11,1,0,0,1,1,-105.1927185,39.65348434
231,"MORRISTOWN NJ",11,17,3,4,10,17,-74.48057556,40.79689789
231,"MORRISTOWN NY",11,2,2,0,0,2,-75.647789,44.58650208
231,"MORRISTOWN TN",11,1,0,1,0,1,-83.29478455,36.21415329
231,"MORRISVILLE NC",11,4,0,2,2,4,-78.82486725,35.82374954
231,"MORROW GA",11,28,8,8,12,28,-84.33943939,33.58339691
231,"MORROW OH",11,1,0,0,1,1,-84.12705231,39.35469437
231,"MORTON GROVE IL",11,2,0,2,0,2,-87.78246307,42.04076767
231,"MORTON IL",11,1,0,0,1,1,-89.45970917,40.61309433
231,"MORTON WA",11,1,1,0,0,1,-122.2775497,46.55794525
231,"MOSCOW ID",11,36,8,13,15,36,-117.0021973,46.73223877
231,"MOSCOW MILLS MO",11,2,0,0,2,2,-90.91833496,38.94809341
231,"MOSS POINT MS",11,2,0,1,1,2,-88.53965759,30.40934944
231,"MOULTON AL",11,1,0,1,0,1,-87.29332733,34.48143387
231,"MOULTRIE GA",11,1,0,0,1,1,-83.78891754,31.18035507
231,"MOUND MN",11,4,0,2,2,4,-93.66635132,44.93652725
231,"MOUND VALLEY KS",11,1,0,1,0,1,-95.40553284,37.20561218
231,"MOUNDSVILLE WV",11,118,38,24,56,118,-80.74716949,39.92013931
231,"MOUNT AIRY NC",11,2,1,1,0,2,-80.60665131,36.49975586
231,"MOUNT CLEMENS MI",11,2,1,1,0,2,-82.87785339,42.59724808
231,"MOUNT HOLLY NC",11,4,1,2,1,4,-81.0157547,35.29826736
231,"MOUNT JULIET TN",11,2,0,1,1,2,-86.51877594,36.19998932
231,"MOUNT MORRIS NY",11,1,0,0,1,1,-77.87361145,42.72562408
231,"MOUNT PLEASANT MI",11,2,1,1,0,2,-84.76785278,43.59777832
231,"MOUNT PLEASANT PA",11,1,0,1,0,1,-79.54049683,40.1492691
231,"MOUNT PLEASANT SC",11,11,5,3,3,11,-79.86242676,32.79427719
231,"MOUNT PLEASANT TX",11,1,0,0,1,1,-94.96855927,33.15682602
231,"MOUNT PROSPECT IL",11,13,4,0,9,13,-87.93763733,42.0663414
231,"MOUNT RAINIER MD",11,21,7,9,5,21,-76.96430206,38.9414978
231,"MOUNT VERNON IL",11,3,0,1,2,3,-88.90307617,38.31738663
231,"MOUNT VERNON IN",11,1,1,0,0,1,-87.89586639,37.93523407
231,"MOUNT VERNON NY",11,16,3,1,4,8,-76.36322403,41.83351135
231,"MOUNT VERNON OH",11,1,1,0,0,1,-82.48577118,40.3935585
231,"MOUNT VERNON TX",11,2,1,0,1,2,-95.22182465,33.18909454
231,"MOUNTAIN BROOK AL",11,1,0,0,1,1,-86.7520752,33.50109482
231,"MOUNTAIN HOME AR",11,1,0,1,0,1,-92.38542175,36.33543015
231,"MOUNTAIN VIEW AR",11,2,0,0,2,2,-92.11795807,35.86831665
231,"MOUNTAIN VIEW CA",11,50,14,7,29,50,-122.0861969,37.3859024
231,"MOUNTAIN WI",11,1,1,0,0,1,-88.47368622,45.18442154
231,"MULDROW OK",11,1,0,0,1,1,-94.59899139,35.40637589
231,"MUNCIE IN",11,38,11,13,14,38,-85.38398743,40.18970871
231,"MUNDELEIN IL",11,5,1,0,4,5,-88.00391388,42.26291275
231,"MUNFORD TN",11,2,0,1,1,2,-89.81508636,35.44957352
231,"MUNHALL PA",11,2,0,1,1,2,-79.89945984,40.39241409
231,"MUNISING MI",11,1,0,0,1,1,-86.64807892,46.410923
231,"MUNSTER IN",11,4,1,2,1,4,-87.51268768,41.56475449
231,"MURFREESBORO TN",11,75,19,15,41,75,-86.39038086,35.84575653
231,"MURPHY NC",11,6,1,2,3,6,-84.03442383,35.08757019
231,"MURPHY TX",11,2,0,1,1,2,-96.61357117,33.01515198
231,"MURPHYSBORO IL",11,1,0,0,1,1,-89.33552551,37.7644043
231,"MURRAY KY",11,27,11,3,13,27,-88.31504059,36.61037827
231,"MURRAY UT",11,5,0,2,3,5,-111.8896103,40.66687012
231,"MURRIETA CA",11,13,3,3,7,13,-117.2157898,33.55398941
231,"MUSCATINE IA",11,4,1,2,1,4,-91.05540466,41.4216156
231,"MUSCLE SHOALS AL",11,2,1,0,1,2,-87.6674881,34.74491882
231,"MUSKEGON MI",11,18,3,2,4,9,-86.25441742,43.23139763
231,"MUSKOGEE OK",11,31,6,7,18,31,-95.36999512,35.74824142
231,"MYRTLE BEACH SC",11,24,7,7,10,24,-78.88601685,33.69656372
231,"NACOGDOCHES TX",11,6,2,2,2,6,-94.6559906,31.60386467
231,"NAMPA ID",11,19,8,5,6,19,-116.5658188,43.54054642
231,"NANTUCKET MA",11,11,4,4,3,11,-70.09862518,41.28360748
231,"NAPA CA",11,34,10,9,15,34,-122.2872086,38.29692841
231,"NAPERVILLE IL",11,72,16,24,32,72,-88.14768219,41.78578949
231,"NAPLES FL",11,40,14,8,18,40,-81.79434204,26.14280128
231,"NASHUA NH",11,17,3,3,11,17,-71.46669769,42.76576996
231,"NASHVILLE GA",11,1,0,1,0,1,-83.24996185,31.20802689
231,"NASHVILLE IL",11,1,1,0,0,1,-89.3805542,38.34370804
231,"NASHVILLE IN",11,4,2,0,2,4,-86.25119781,39.20750046
231,"NASHVILLE NC",11,2,0,0,2,2,-77.96518707,35.97506714
231,"NATCHEZ MS",11,1,0,0,1,1,-91.40363312,31.56089783
231,"NATCHITOCHES LA",11,5,0,3,2,5,-93.08662415,31.76096535
231,"NATICK MA",11,9,3,3,3,9,-71.3484726,42.2836113
231,"NAUGATUCK CT",11,7,1,2,4,7,-73.04972076,41.4863205
231,"NAVASSA NC",11,1,0,1,0,1,-78.0069046,34.25564194
231,"NAZARETH PA",11,1,0,1,0,1,-75.30902863,40.74064255
231,"NECHE ND",11,3,0,0,3,3,-97.54907227,48.97986603
231,"NEDERLAND CO",11,5,2,0,3,5,-105.5114899,39.96115494
231,"NEDERLAND TX",11,6,1,0,5,6,-93.99260712,29.97476387
231,"NEEDHAM MA",11,10,3,1,6,10,-71.21767426,42.27159119
231,"NEEDLES CA",11,14,1,2,11,14,-114.6156082,34.84807587
231,"NEEDVILLE TX",11,1,0,0,1,1,-95.83795166,29.39995766
231,"NEENAH WI",11,4,1,1,2,4,-88.4626236,44.18569183
231,"NEODESHA KS",11,2,0,1,1,2,-95.68075562,37.41866684
231,"NEOGA IL",11,1,0,1,0,1,-88.45291901,39.31969833
231,"NEOSHO MO",11,1,0,0,1,1,-94.36846161,36.86910629
231,"NEPHI UT",11,1,0,1,0,1,-111.8384705,39.71007538
231,"NEVADA CITY CA",11,2,1,0,1,2,-121.0184174,39.26145172
231,"NEW ALBANY IN",11,27,7,9,11,27,-85.80917358,38.29167938
231,"NEW BEDFORD MA",11,11,2,4,5,11,-70.93328857,41.63626862
231,"NEW BERN NC",11,16,4,6,6,16,-77.04354095,35.10897827
231,"NEW BRAUNFELS TX",11,65,14,18,33,65,-98.12486267,29.70325089
231,"NEW BRIGHTON PA",11,2,0,2,0,2,-80.30953217,40.73060989
231,"NEW BRITAIN CT",11,4,0,3,1,4,-72.77884674,41.6615181
231,"NEW BRUNSWICK NJ",11,5,2,2,1,5,-74.45104218,40.48620987
231,"NEW CANAAN CT",11,2,1,1,0,2,-73.49369049,41.14690018
231,"NEW CARLISLE OH",11,1,0,0,1,1,-84.02508545,39.93630219
231,"NEW CARROLLTON MD",11,8,3,3,2,8,-76.8794632,38.97011185
231,"NEW CASTLE DE",11,12,3,5,4,12,-75.56227875,39.66440964
231,"NEW CASTLE PA",11,8,1,4,3,8,-80.34657288,41.00389481
231,"NEW GLARUS WI",11,1,0,1,0,1,-89.63531494,42.81429672
231,"NEW HAVEN CT",11,369,97,122,150,369,-72.92726898,41.3084259
231,"NEW HOPE MN",11,1,1,0,0,1,-93.38259125,45.02332687
231,"NEW HOPE PA",11,1,0,0,1,1,-74.95053864,40.36468124
231,"NEW IBERIA LA",11,1,0,0,1,1,-91.81869507,30.0039444
231,"NEW LONDON CT",11,19,4,4,11,19,-72.09841156,41.35572815
231,"NEW LONDON MN",11,3,0,0,3,3,-94.94470978,45.30108261
231,"NEW MADRID MO",11,2,0,1,1,2,-89.52796936,36.58650589
231,"NEW MILFORD CT",11,2,1,1,0,2,-73.40771484,41.57733917
231,"NEW MILFORD NJ",11,1,0,0,1,1,-74.01824951,40.93526077
231,"NEW ORLEANS LA",11,1269,317,379,573,1269,-90.07525635,29.95483589
231,"NEW OXFORD PA",11,7,3,0,4,7,-77.05513,39.86403275
231,"NEW PALTZ NY",11,10,4,3,3,10,-74.08605194,41.74787903
231,"NEW PHILADELPHIA OH",11,2,1,0,1,2,-81.44538879,40.48986053
231,"NEW PORT RICHEY FL",11,14,6,6,2,14,-82.71899414,28.24477577
231,"NEW RICHMOND OH",11,2,0,0,2,2,-84.27954102,38.94869614
231,"NEW ROCHELLE NY",11,6,0,3,3,6,-73.78160858,40.91175842
231,"NEW SMYRNA BEACH FL",11,1,0,0,1,1,-80.92392731,29.0242157
231,"NEW YORK NY",11,5685,1497,1532,2656,5685,-74.00528717,40.7145195
231,"NEWARK CA",11,4,3,1,0,4,-122.0424347,37.5296669
231,"NEWARK DE",11,103,29,34,40,103,-75.74462128,39.68774414
231,"NEWARK NJ",11,323,87,72,164,323,-74.17185211,40.73570633
231,"NEWARK NY",11,2,0,1,1,2,-77.09454346,43.04671097
231,"NEWARK OH",11,8,3,1,4,8,-82.40110779,40.05843353
231,"NEWAYGO MI",11,1,0,0,1,1,-85.7999115,43.41973495
231,"NEWBERG OR",11,2,1,0,1,2,-122.9754334,45.29994202
231,"NEWBURGH IN",11,7,0,2,5,7,-87.40516663,37.94437027
231,"NEWBURGH NY",11,14,5,1,8,14,-74.00939941,41.50367737
231,"NEWBURYPORT MA",11,6,1,1,4,6,-70.8768692,42.81164551
231,"NEWCASTLE WA",11,67,21,15,31,67,-122.1575165,47.53847504
231,"NEWFANE VT",11,1,1,0,0,1,-72.65518188,42.98571396
231,"NEWMAN CA",11,4,0,1,3,4,-121.0232544,37.31364059
231,"NEWNAN GA",11,8,2,4,2,8,-84.79645538,33.37108231
231,"NEWPORT AR",11,1,1,0,0,1,-91.28199768,35.60486221
231,"NEWPORT NEWS VA",11,40,14,11,15,40,-76.42758942,36.97909927
231,"NEWPORT RI",11,43,12,10,21,43,-71.31213379,41.49024963
231,"NEWPORT TN",11,3,1,2,0,3,-83.18756104,35.96707916
231,"NEWTON IL",11,2,0,0,2,2,-88.16280365,38.99100876
231,"NEWTON KS",11,6,0,2,4,6,-97.3455658,38.04684067
231,"NEWTON MA",11,34,10,12,12,34,-71.20809937,42.33743286
231,"NEWTON NC",11,1,0,0,1,1,-81.22117615,35.67030334
231,"NEWTON NJ",11,1,0,0,1,1,-74.7516861,41.0583992
231,"NEWTOWN PA",11,8,3,3,2,8,-74.93606567,40.22966003
231,"NIAGARA FALLS NY",11,27,11,5,11,27,-79.05632019,43.09456253
231,"NICHOLSON GA",11,1,0,0,1,1,-83.43130493,34.11414719
231,"NISKAYUNA NY",11,3,1,0,2,3,-73.84505463,42.77999115
231,"NITRO WV",11,1,0,1,0,1,-81.8515625,38.41720581
231,"NIXA MO",11,49,13,18,18,49,-93.29502869,37.04324341
231,"NIXON TX",11,1,0,0,1,1,-97.76517487,29.26784897
231,"NOBLESVILLE IN",11,17,3,4,10,17,-86.01766205,40.03728104
231,"NOCONA TX",11,20,4,9,7,20,-97.72662354,33.78715515
231,"NOEL MO",11,3,0,0,3,3,-94.4858551,36.54568481
231,"NOGALES AZ",11,1,0,1,0,1,-110.9357224,31.34046173
231,"NOLENSVILLE TN",11,1,0,0,1,1,-86.66940308,35.95249557
231,"NOME AK",11,1,0,1,0,1,-165.3991394,64.51126099
231,"NORCO CA",11,2,1,0,1,2,-117.5555801,33.93997192
231,"NORCROSS GA",11,14,5,4,5,14,-84.21324158,33.94129181
231,"NORFOLK NE",11,1,0,0,1,1,-97.41788483,42.02838898
231,"NORFOLK VA",11,206,52,49,105,206,-76.28334045,36.84831619
231,"NORMAL IL",11,22,4,8,10,22,-88.99052429,40.51409912
231,"NORMAN OK",11,94,27,27,40,94,-97.44689178,35.22203827
231,"NORRISTOWN PA",11,1,0,0,1,1,-75.33937836,40.12155151
231,"NORTH ADAMS MA",11,4,2,0,2,4,-73.10797882,42.70087814
231,"NORTH ANDOVER MA",11,2,2,0,0,2,-71.13425446,42.69897079
231,"NORTH ARLINGTON NJ",11,1,0,1,0,1,-74.13215637,40.78865814
231,"NORTH AUGUSTA SC",11,6,3,1,2,6,-81.96509552,33.5021019
231,"NORTH BEACH MD",11,1,0,0,1,1,-76.53018188,38.70772552
231,"NORTH BEND WA",11,11,0,5,6,11,-121.7899017,47.49547195
231,"NORTH BERGEN NJ",11,36,7,10,19,36,-74.0112381,40.8045845
231,"NORTH CANTON OH",11,4,0,2,2,4,-81.40194702,40.87594223
231,"NORTH CHARLESTON SC",11,10,1,5,4,10,-79.97457886,32.85499191
231,"NORTH CHICAGO IL",11,17,3,6,8,17,-87.8412323,42.3254509
231,"NORTH EAST MD",11,1,0,0,1,1,-75.94083405,39.60018539
231,"NORTH HAVEN CT",11,1,1,0,0,1,-72.85857391,41.39123535
231,"NORTH LAS VEGAS NV",11,26,5,11,10,26,-115.1192093,36.19900131
231,"NORTH LIBERTY IA",11,5,2,1,2,5,-91.59856415,41.74905777
231,"NORTH LITTLE ROCK AR",11,31,5,9,17,31,-92.26677704,34.76465988
231,"NORTH MIAMI BEACH FL",11,6,2,0,4,6,-80.16223907,25.93397713
231,"NORTH MIAMI FL",11,10,1,2,7,10,-80.18624115,25.8908596
231,"NORTH OLMSTED OH",11,2,1,1,0,2,-81.92334747,41.41566849
231,"NORTH PLATTE NE",11,2,0,1,1,2,-100.7660141,41.12404633
231,"NORTH POLE AK",11,2,1,0,1,2,-147.3626251,64.7430191
231,"NORTH PORT FL",11,1,0,1,0,1,-82.23706055,27.04372597
231,"NORTH RICHLAND HILLS TX",11,1,0,1,0,1,-97.22973633,32.83457947
231,"NORTH RIDGEVILLE OH",11,1,0,0,1,1,-82.04491425,41.37031937
231,"NORTH RIVERSIDE IL",11,4,2,0,2,4,-87.82305908,41.84282684
231,"NORTH ROYALTON OH",11,2,0,2,0,2,-81.72419739,41.31388855
231,"NORTH SALT LAKE UT",11,1,0,0,1,1,-111.9105759,40.85150528
231,"NORTH TONAWANDA NY",11,3,2,0,1,3,-78.86399841,43.03866196
231,"NORTH WALES PA",11,1,0,0,1,1,-75.27763367,40.21118927
231,"NORTHAMPTON MA",11,40,13,11,16,40,-72.64012146,42.32544708
231,"NORTHAMPTON PA",11,1,0,1,0,1,-75.49620819,40.6865654
231,"NORTHBROOK IL",11,1,0,0,1,1,-87.82922363,42.12767792
231,"NORTHFIELD MN",11,4,0,0,4,4,-93.16210175,44.45811081
231,"NORTHFIELD NH",11,2,1,1,0,2,-71.59122467,43.43339157
231,"NORTHLAKE IL",11,1,0,0,1,1,-87.89591217,41.91732407
231,"NORTHPORT AL",11,2,0,0,2,2,-87.57746124,33.22927856
231,"NORTON VA",11,1,0,1,0,1,-82.62851715,36.93346786
231,"NORWALK CA",11,5,2,2,1,5,-118.0839539,33.90219116
231,"NORWALK CT",11,10,5,4,1,10,-73.40729523,41.11759949
231,"NORWALK IA",11,2,0,0,2,2,-93.67901611,41.47555161
231,"NORWALK OH",11,5,1,1,3,5,-82.61576843,41.24267197
231,"NORWICH CT",11,17,4,6,7,17,-72.07475281,41.52449036
231,"NORWICH NY",11,1,0,0,1,1,-75.52252197,42.53137207
231,"NOVATO CA",11,7,4,1,2,7,-122.576561,38.11727142
231,"NOVI MI",11,4,1,1,2,4,-83.47566223,42.48064423
231,"NUTLEY NJ",11,17,5,7,5,17,-74.15930939,40.82229996
231,"NYACK NY",11,2,1,0,1,2,-73.91687012,41.09091568
231,"O'FALLON MO",11,52,13,19,20,52,-90.69979095,38.8109436
231,"OAK BLUFFS MA",11,6,1,0,5,6,-70.56096649,41.45436859
231,"OAK BROOK IL",11,1,0,1,0,1,-87.92926788,41.83280945
231,"OAK CREEK WI",11,13,5,5,3,13,-87.86346436,42.88599014
231,"OAK FOREST IL",11,2,0,0,2,2,-87.74399567,41.60294342
231,"OAK HARBOR OH",11,1,0,0,1,1,-83.14666748,41.50702667
231,"OAK HARBOR WA",11,15,3,6,6,15,-122.6395798,48.29240036
231,"OAK HILL WV",11,1,0,0,1,1,-81.13639832,37.98807907
231,"OAK LAWN IL",11,2,1,1,0,2,-87.7545929,41.721138
231,"OAK PARK IL",11,33,2,12,19,33,-87.78443909,41.88500595
231,"OAK PARK MI",11,2,0,0,1,1,-84.21956253,42.40898132
231,"OAKDALE CA",11,1,0,1,0,1,-120.8491745,37.76628113
231,"OAKDALE LA",11,9,3,3,3,9,-92.66092682,30.8165493
231,"OAKDALE MN",11,1,0,0,1,1,-92.95690155,44.98758316
231,"OAKLAND CA",11,1645,413,457,775,1645,-122.2733154,37.80438614
231,"OAKLAND MD",11,2,1,0,0,1,-77.64079285,39.19859505
231,"OAKLAND PARK FL",11,2,0,1,1,2,-80.13152313,26.1731205
231,"OBERLIN OH",11,12,4,1,7,12,-82.21720886,41.29413223
231,"OBLONG IL",11,1,0,1,0,1,-87.90914154,39.00207138
231,"OCALA FL",11,18,6,4,8,18,-82.13973236,29.18780708
231,"OCCOQUAN VA",11,1,1,0,0,1,-77.25945282,38.68394852
231,"OCEAN CITY MD",11,3,0,2,1,3,-75.08437347,38.33656311
231,"OCEAN SPRINGS MS",11,1,1,0,0,1,-88.82833862,30.41417313
231,"OCEANPORT NJ",11,1,0,0,1,1,-74.01517487,40.31571198
231,"OCEANSIDE CA",11,124,25,47,52,124,-117.3814011,33.19587326
231,"OCOEE FL",11,5,1,2,2,5,-81.54336548,28.56987
231,"OCONOMOWOC WI",11,1,0,0,1,1,-88.49947357,43.11158752
231,"OCONTO WI",11,1,0,1,0,1,-87.86500549,44.88712311
231,"ODESSA MO",11,3,2,0,1,3,-93.95418549,38.99940491
231,"ODESSA TX",11,9,0,2,7,9,-102.3682938,31.84587097
231,"ODON IN",11,1,0,0,1,1,-86.99154663,38.84281158
231,"OGALLALA NE",11,56,19,19,18,56,-101.7200775,41.1279068
231,"OGDEN AR",11,3,1,0,2,3,-94.04294586,33.58304214
231,"OGDEN UT",11,35,11,6,18,35,-111.9730225,41.22582626
231,"OGDENSBURG NY",11,1,0,1,0,1,-75.48552704,44.69423294
231,"OHIO IL",11,2,1,0,1,2,-89.46100616,41.55773544
231,"OIL CITY PA",11,1,0,1,0,1,-79.70584106,41.4341774
231,"OJAI CA",11,4,0,1,3,4,-119.2175903,34.4372139
231,"OKEECHOBEE FL",11,1,0,0,1,1,-80.82913971,27.24450302
231,"OKLAHOMA CITY OK",11,263,78,76,109,263,-97.51699829,35.46761322
231,"OLATHE KS",11,94,23,28,43,94,-94.81970215,38.88142395
231,"OLD BRIDGE NJ",11,4,0,1,3,4,-74.36474609,40.41495895
231,"OLIVE BRANCH MS",11,10,4,2,4,10,-89.82355499,34.96377563
231,"OLYMPIA WA",11,225,59,71,95,225,-122.8909378,47.04053497
231,"OMAHA NE",11,449,117,128,204,449,-95.93825531,41.25878906
231,"ONEONTA AL",11,1,1,0,0,1,-86.4728241,33.94834518
231,"ONEONTA NY",11,3,2,0,1,3,-75.0631485,42.45296097
231,"ONTARIO CA",11,17,3,8,6,17,-117.6528702,34.06340408
231,"ONTARIO OR",11,3,1,0,2,3,-116.9652557,44.02645111
231,"OPA-LOCKA FL",11,1,0,0,1,1,-80.25005341,25.90292931
231,"OPELIKA AL",11,3,2,1,0,3,-85.3780365,32.64568329
231,"OPELOUSAS LA",11,3,2,0,1,3,-92.08177948,30.53403282
231,"ORANGE CA",11,65,28,15,22,65,-117.8544846,33.7877388
231,"ORANGE CITY FL",11,1,1,0,0,1,-81.29846191,28.94932175
231,"ORANGE CITY IA",11,13,4,4,5,13,-96.05925751,43.00707626
231,"ORANGE PARK FL",11,4,1,0,3,4,-81.70614624,30.16655731
231,"ORANGE TX",11,15,3,7,5,15,-93.73699951,30.09343147
231,"ORANGE VA",11,1,1,0,0,1,-78.11038208,38.2454834
231,"ORANGEBURG SC",11,4,0,2,2,4,-80.86129761,33.48974228
231,"ORCHARD PARK NY",11,2,0,2,0,2,-78.74337006,42.76783371
231,"OREGON CITY OR",11,10,3,5,2,10,-122.6096726,45.35689163
231,"OREGON WI",11,1,0,0,1,1,-89.38459778,42.92614746
231,"OREM UT",11,13,0,1,12,13,-111.6960449,40.29695892
231,"ORINDA CA",11,1,0,0,1,1,-122.1821137,37.87714767
231,"ORLAND CA",11,2,0,1,1,2,-122.1985169,39.74710464
231,"ORLAND PARK IL",11,4,1,1,2,4,-87.85391235,41.63027573
231,"ORLANDO FL",11,1002,253,288,461,1002,-81.3789978,28.53886795
231,"ORMOND BEACH FL",11,76,26,19,31,76,-81.05541992,29.28623772
231,"ORONO ME",11,1,0,1,0,1,-68.67062378,44.88346863
231,"OROVILLE CA",11,2,0,0,2,2,-121.5581131,39.51348877
231,"ORRICK MO",11,1,0,0,1,1,-94.12295532,39.21264267
231,"ORTING WA",11,1,0,0,1,1,-122.2069778,47.09756088
231,"ORTONVILLE MI",11,2,1,1,0,2,-83.44315338,42.852314
231,"OSCEOLA MILLS PA",11,1,0,0,1,1,-78.27013397,40.85004807
231,"OSHKOSH WI",11,12,3,2,7,12,-88.54268646,44.02453613
231,"OSSINING NY",11,4,1,3,0,4,-73.86093903,41.16327286
231,"OSSIPEE NH",11,1,0,1,0,1,-71.11573029,43.68548965
231,"OSWEGO IL",11,5,2,1,2,5,-88.3513031,41.68288422
231,"OSWEGO NY",11,10,1,6,3,10,-76.50988007,43.45563889
231,"OTTAWA IL",11,1,1,0,0,1,-88.8425827,41.34545898
231,"OTTUMWA IA",11,3,0,1,2,3,-92.41059113,41.01459122
231,"OURAY CO",11,1,0,0,1,1,-107.67276,38.02296448
231,"OVERLAND MO",11,2,1,1,0,2,-90.36277008,38.70130157
231,"OVERLAND PARK KS",11,80,26,21,33,80,-94.67124939,38.98216248
231,"OVIEDO FL",11,6,0,4,2,6,-81.20778656,28.67054749
231,"OWASSO OK",11,12,1,4,7,12,-95.85546875,36.26954651
231,"OWATONNA MN",11,23,8,5,10,23,-93.22633362,44.08358383
231,"OWENSBORO KY",11,17,4,7,6,17,-87.11345673,37.77421188
231,"OWENSVILLE MO",11,1,0,1,0,1,-91.50177765,38.34587479
231,"OWINGSVILLE KY",11,7,1,1,5,7,-83.76404572,38.14480591
231,"OWOSSO MI",11,2,0,1,1,2,-84.17687988,42.99795914
231,"OXFORD AL",11,1,0,0,1,1,-85.83503723,33.6145134
231,"OXFORD IN",11,1,0,0,1,1,-87.24803925,40.51984024
231,"OXFORD MI",11,3,1,0,2,3,-83.26428986,42.82481766
231,"OXFORD MS",11,67,19,15,33,67,-89.52319336,34.37203979
231,"OXFORD OH",11,1,0,0,1,1,-84.74536133,39.50694275
231,"OXFORD PA",11,3,1,1,1,3,-75.97814178,39.78580856
231,"OXNARD CA",11,28,9,9,10,28,-119.1790085,34.19766998
231,"OZARK MO",11,15,5,4,6,15,-93.20661163,37.02112198
231,"PACIFIC MO",11,1,0,0,1,1,-90.74199677,38.48199081
231,"PACIFICA CA",11,6,1,2,3,6,-122.4893951,37.61383438
231,"PADUCAH KY",11,25,7,12,6,25,-88.60009766,37.08333206
231,"PAINESVILLE OH",11,1,0,0,1,1,-81.24531555,41.72451782
231,"PALACIOS TX",11,5,1,2,2,5,-96.21818542,28.7086792
231,"PALATINE IL",11,2,0,1,1,2,-88.03440857,42.11017609
231,"PALATKA FL",11,1,1,0,0,1,-81.63694763,29.6489048
231,"PALESTINE TX",11,9,3,2,4,9,-95.6313324,31.76263046
231,"PALISADES PARK NJ",11,12,3,3,6,12,-73.9969635,40.84852982
231,"PALM BAY FL",11,2,0,1,1,2,-80.58313751,28.03806496
231,"PALM BEACH FL",11,91,16,35,40,91,-80.03616333,26.70643616
231,"PALM BEACH GARDENS FL",11,8,1,2,5,8,-80.07454681,26.8109169
231,"PALM DESERT CA",11,27,3,8,16,27,-116.3907166,33.72164154
231,"PALM SPRINGS CA",11,105,28,27,50,105,-116.5467758,33.83036423
231,"PALM SPRINGS FL",11,1,0,1,0,1,-80.09664154,26.63662338
231,"PALMDALE CA",11,33,10,11,12,33,-118.118454,34.57925034
231,"PALMER AK",11,3,1,2,0,3,-149.1138458,61.59459305
231,"PALMYRA MO",11,1,1,0,0,1,-91.53061676,39.80343628
231,"PALMYRA PA",11,1,0,0,1,1,-76.59290314,40.30906677
231,"PALO ALTO CA",11,65,18,26,21,65,-122.1449661,37.44177628
231,"PALOS HEIGHTS IL",11,2,1,0,1,2,-87.79647827,41.66812134
231,"PANAMA CITY BEACH FL",11,15,2,9,4,15,-85.80211639,30.1792717
231,"PANAMA CITY FL",11,58,12,20,26,58,-85.65970612,30.16412926
231,"PAPILLION NE",11,4,0,2,2,4,-96.04257202,41.15442276
231,"PARADISE CA",11,2,0,0,2,2,-121.6395493,39.74609756
231,"PARADISE VALLEY AZ",11,2,1,1,0,2,-111.9442825,33.53105164
231,"PARAGOULD AR",11,7,3,2,2,7,-90.5002594,36.05854034
231,"PARAMOUNT CA",11,2,0,1,1,2,-118.161644,33.88947678
231,"PARAMUS NJ",11,1,1,0,0,1,-74.0747757,40.9445343
231,"PARCHMENT MI",11,1,1,0,0,1,-85.57003021,42.32801056
231,"PARIS IL",11,20,5,8,7,20,-87.69623566,39.61117172
231,"PARIS KY",11,3,0,1,2,3,-84.25283051,38.21011353
231,"PARIS TN",11,2,0,0,2,2,-88.3266983,36.30187225
231,"PARIS TX",11,8,1,3,4,8,-95.55589294,33.66113663
231,"PARK CITY UT",11,90,25,26,39,90,-111.5018539,40.65143204
231,"PARK FOREST IL",11,1,0,0,1,1,-87.67442322,41.49164963
231,"PARKER CO",11,7,2,2,3,7,-104.7624359,39.51849365
231,"PARKERSBURG WV",11,9,3,3,3,9,-81.54850006,39.28261948
231,"PARKVILLE MO",11,3,3,0,0,3,-94.68252563,39.19501114
231,"PARMA OH",11,6,1,1,4,6,-81.72257996,41.40510178
231,"PARSONS KS",11,1,1,0,0,1,-95.2614975,37.34062195
231,"PASADENA CA",11,163,37,55,71,163,-118.1466675,34.14794922
231,"PASADENA TX",11,8,1,5,2,8,-95.20979309,29.69150162
231,"PASCAGOULA MS",11,9,4,3,2,9,-88.55257416,30.36789703
231,"PASCO WA",11,7,1,2,4,7,-119.1023636,46.2282753
231,"PASS CHRISTIAN MS",11,1,0,1,0,1,-89.24402618,30.32174683
231,"PASSAIC NJ",11,7,0,5,2,7,-74.12754822,40.8571434
231,"PATCHOGUE NY",11,2,2,0,0,2,-73.01426697,40.76568985
231,"PATERSON NJ",11,305,80,58,167,305,-74.17102051,40.91714478
231,"PAULSBORO NJ",11,2,0,0,2,2,-75.23970032,39.83067322
231,"PAWTUCKET RI",11,10,4,0,6,10,-71.38137054,41.87892532
231,"PAYETTE ID",11,4,1,1,2,4,-116.9361572,44.07813263
231,"PAYSON AZ",11,2,1,1,0,2,-111.3258514,34.23103714
231,"PAYSON UT",11,1,0,1,0,1,-111.7331848,40.04447937
231,"PEABODY MA",11,2,0,0,2,2,-70.92794037,42.52825928
231,"PEARLAND TX",11,10,3,2,5,10,-95.28644562,29.56411743
231,"PEARSON GA",11,2,0,0,2,2,-82.85235596,31.29817009
231,"PEKIN IL",11,5,1,3,1,5,-89.64067841,40.56766891
231,"PEMBERTON NJ",11,2,0,0,2,2,-74.68242645,39.97236252
231,"PEMBROKE GA",11,2,0,2,0,2,-81.62184143,32.13653183
231,"PEMBROKE NC",11,4,1,0,3,4,-79.19446564,34.68062592
231,"PEMBROKE PINES FL",11,14,3,5,6,14,-80.22357941,26.00384903
231,"PENDLETON IN",11,2,1,1,0,2,-85.74658203,39.99742126
231,"PENDLETON OR",11,7,3,1,3,7,-118.7900848,45.67152786
231,"PENDLETON SC",11,7,3,1,3,7,-82.78354645,34.65194321
231,"PENNSVILLE NJ",11,1,0,0,1,1,-75.51573944,39.65373993
231,"PENSACOLA FL",11,116,30,35,51,116,-87.21669006,30.42154694
231,"PEORIA AZ",11,29,7,8,14,29,-112.2390747,33.58084106
231,"PEORIA IL",11,99,28,28,43,99,-89.59487152,40.70241928
231,"PERRY GA",11,1,1,0,0,1,-83.73152161,32.45870972
231,"PERRY MI",11,1,0,1,0,1,-84.21952057,42.82634354
231,"PERRY MO",11,1,0,0,1,1,-91.67559814,39.43136215
231,"PERRYSBURG OH",11,17,3,8,6,17,-83.62700653,41.55728531
231,"PERRYSVILLE OH",11,2,2,0,0,2,-82.31124115,40.65782547
231,"PERRYTON TX",11,1,0,0,1,1,-100.8032761,36.40009689
231,"PERRYVILLE MO",11,17,4,2,11,17,-89.86131287,37.72448349
231,"PERTH AMBOY NJ",11,27,7,8,12,27,-74.26480103,40.5068779
231,"PETAL MS",11,1,1,0,0,1,-89.26022339,31.34682083
231,"PETALUMA CA",11,28,7,5,16,28,-122.6394272,38.23221207
231,"PETERBOROUGH NH",11,1,1,0,0,1,-71.95066071,42.87090683
231,"PETERSBURG VA",11,2,0,0,2,2,-77.40148926,37.2280426
231,"PFLUGERVILLE TX",11,1,0,1,0,1,-97.62039948,30.4396553
231,"PHARR TX",11,7,2,2,3,7,-98.1840744,26.19566154
231,"PHENIX CITY AL",11,3,1,1,1,3,-85.00059509,32.4714241
231,"PHILADELPHIA PA",11,2422,653,705,1064,2422,-75.16322327,39.95243835
231,"PHILADELPHIA TN",11,2,0,1,1,2,-84.40354156,35.67960358
231,"PHILIPPI WV",11,4,1,0,3,4,-80.04271698,39.15179443
231,"PHILIPSBURG PA",11,2,0,2,0,2,-78.22016144,40.89661789
231,"PHILOMATH OR",11,3,1,1,1,3,-123.3694305,44.539608
231,"PHOENIX AZ",11,1025,243,307,475,1025,-112.0752716,33.44825363
231,"PHOENIXVILLE PA",11,13,4,6,3,13,-75.51416779,40.13076401
231,"PICAYUNE MS",11,2,1,0,1,2,-89.67980194,30.52602005
231,"PIEDMONT CA",11,1,0,0,1,1,-122.2344055,37.8243103
231,"PIKEVILLE KY",11,4,0,1,3,4,-82.51830292,37.47967529
231,"PIKEVILLE NC",11,1,0,0,1,1,-77.98130035,35.49745941
231,"PINE BLUFF AR",11,9,3,1,5,9,-92.00374603,34.22846222
231,"PINEBLUFF NC",11,1,1,0,0,1,-79.47153473,35.11040115
231,"PINEHURST NC",11,1,1,0,0,1,-79.46926117,35.19573975
231,"PINELLAS PARK FL",11,9,4,2,3,9,-82.69934845,27.84342194
231,"PINSON AL",11,1,0,1,0,1,-86.68317413,33.68905258
231,"PIQUA OH",11,1,0,1,0,1,-84.24250793,40.14477539
231,"PISCATAWAY NJ",11,2,1,1,0,2,-74.3984375,40.49933243
231,"PISMO BEACH CA",11,12,2,3,7,12,-120.6432953,35.1427269
231,"PITTSBORO IN",11,2,1,0,1,2,-86.46704865,39.8641243
231,"PITTSBORO NC",11,4,1,1,2,4,-79.17662811,35.72052002
231,"PITTSBURG CA",11,27,6,9,12,27,-121.8871613,38.02787781
231,"PITTSBURG KS",11,11,4,2,5,11,-94.70526123,37.41111374
231,"PITTSBURG TX",11,1,0,1,0,1,-94.96621704,32.99585342
231,"PITTSBURGH PA",11,1160,317,333,510,1160,-79.99537659,40.44091415
231,"PITTSFIELD IL",11,1,0,1,0,1,-90.80554962,39.60787964
231,"PITTSFIELD MA",11,107,34,36,37,107,-73.24451447,42.45004272
231,"PLACERVILLE CA",11,31,7,12,12,31,-120.8002701,38.72951508
231,"PLAINFIELD IL",11,1,0,1,0,1,-88.20417786,41.62700653
231,"PLAINFIELD NJ",11,2,0,1,1,2,-74.40673065,40.63404083
231,"PLAINSBORO NJ",11,5,1,0,4,5,-74.59952545,40.33381653
231,"PLAINVIEW TX",11,8,1,3,4,8,-101.7073975,34.18512726
231,"PLANO IL",11,1,0,1,0,1,-88.5372467,41.66307449
231,"PLANO TX",11,93,27,29,37,93,-96.69931793,33.01993942
231,"PLANTATION FL",11,11,5,4,2,11,-80.23281097,26.12825966
231,"PLAQUEMINE LA",11,1,1,0,0,1,-91.23427582,30.28962708
231,"PLATTE CITY MO",11,1,0,0,1,1,-94.78305054,39.37047958
231,"PLATTSBURGH NY",11,8,2,2,4,8,-73.45239258,44.69951248
231,"PLEASANT HILL CA",11,2,0,0,2,2,-122.0632401,37.94770813
231,"PLEASANTON CA",11,4,1,0,3,4,-121.8771362,37.66220856
231,"PLEASANTVILLE NJ",11,1,0,1,0,1,-74.52319336,39.3899765
231,"PLEASANTVILLE OH",11,4,2,1,1,4,-82.52178192,39.81002045
231,"PLOVER WI",11,2,1,0,1,2,-89.54450226,44.45635605
231,"PLYMOUTH IN",11,4,2,1,1,4,-86.31345367,41.33988953
231,"PLYMOUTH MA",11,32,7,13,12,32,-70.67458344,41.95769882
231,"PLYMOUTH MI",11,5,1,0,4,5,-83.46985626,42.37141418
231,"POCATELLO ID",11,7,2,2,3,7,-112.4475937,42.87098694
231,"POINT PLEASANT NJ",11,6,1,0,5,6,-74.06723022,40.08329391
231,"POMONA CA",11,49,12,12,25,49,-117.7534485,34.05541611
231,"POMPANO BEACH FL",11,28,6,9,13,28,-80.12407684,26.23855591
231,"PONTIAC MI",11,17,4,6,7,17,-83.29104614,42.63900757
231,"PONTOTOC MS",11,3,0,1,2,3,-88.99865723,34.24829102
231,"POOLER GA",11,1,0,1,0,1,-81.24672699,32.11583328
231,"POOLESVILLE MD",11,1,0,0,1,1,-77.41607666,39.14612198
231,"POPLAR BLUFF MO",11,25,6,6,13,25,-90.3928833,36.75717545
231,"POPLARVILLE MS",11,1,0,0,1,1,-89.53426361,30.84044838
231,"PORT ANGELES WA",11,4,0,1,3,4,-123.4329224,48.11795044
231,"PORT ARTHUR TX",11,38,4,11,23,38,-93.93045807,29.90067863
231,"PORT HURON MI",11,5,1,0,4,5,-82.42453766,42.97105026
231,"PORT JEFFERSON NY",11,1,0,0,1,1,-73.06815338,40.94688416
231,"PORT MATILDA PA",11,2,1,0,1,2,-78.05344391,40.79947662
231,"PORT ORANGE FL",11,12,4,3,5,12,-81.00856781,29.13491631
231,"PORT ORCHARD WA",11,4,2,0,2,4,-122.6369019,47.53696823
231,"PORT ORFORD OR",11,1,1,0,0,1,-124.4993668,42.74531555
231,"PORT TOWNSEND WA",11,1,0,0,1,1,-122.7630005,48.11659241
231,"PORTAGE MI",11,11,4,3,4,11,-85.57974243,42.20133972
231,"PORTAGE PA",11,1,0,0,1,1,-78.67198181,40.38890076
231,"PORTAGE WI",11,2,0,1,1,2,-89.46311188,43.53891754
231,"PORTER OK",11,1,0,0,1,1,-95.5231781,35.87133026
231,"PORTERVILLE CA",11,2,0,1,1,2,-119.0190811,36.06521988
231,"PORTLAND IN",11,3,2,1,0,3,-84.97788239,40.43445969
231,"PORTLAND ME",11,243,53,59,131,243,-70.25403595,43.6618576
231,"PORTLAND MI",11,3,0,1,2,3,-84.90298462,42.86923599
231,"PORTLAND OR",11,3537,910,951,1676,3537,-122.6786423,45.52309418
231,"PORTOLA VALLEY CA",11,1,0,1,0,1,-122.2373505,37.38395309
231,"PORTSMOUTH NH",11,31,11,9,11,31,-70.76164246,43.07198334
231,"PORTSMOUTH VA",11,20,7,8,5,20,-76.29769135,36.83554077
231,"POST FALLS ID",11,1,0,0,1,1,-116.954155,47.71800613
231,"POTEAU OK",11,2,0,0,2,2,-94.623703,35.05377197
231,"POTSDAM NY",11,4,1,2,1,4,-74.98085785,44.66995239
231,"POTTSTOWN PA",11,3,0,2,1,3,-75.64894867,40.24571609
231,"POTTSVILLE PA",11,2,0,0,2,2,-76.19465637,40.68566513
231,"POUGHKEEPSIE NY",11,18,2,4,12,18,-73.92034149,41.70055771
231,"POWAY CA",11,3,1,1,1,3,-117.0376205,32.96272659
231,"POWDER SPRINGS GA",11,3,1,0,2,3,-84.68379974,33.8599205
231,"PRAIRIE VIEW TX",11,5,0,3,2,5,-95.9883194,30.09370232
231,"PRAIRIE VILLAGE KS",11,4,2,0,2,4,-94.63400269,38.99189377
231,"PRATTVILLE AL",11,13,2,3,8,13,-86.45972443,32.46446228
231,"PRENTISS MS",11,1,0,0,1,1,-89.86693573,31.59882927
231,"PRESCOTT AZ",11,9,1,1,7,9,-112.4702301,34.54008102
231,"PRESTON ID",11,1,0,1,0,1,-111.8783875,42.09620285
231,"PRICE UT",11,1,0,1,0,1,-110.8117294,39.60165024
231,"PRICHARD AL",11,1,0,0,1,1,-88.07904053,30.739048
231,"PRIEST RIVER ID",11,1,1,0,0,1,-116.906868,48.18558121
231,"PRINCESS ANNE MD",11,2,0,0,2,2,-75.69158173,38.20330429
231,"PRINCETON IL",11,2,0,1,1,2,-89.46478271,41.36803055
231,"PRINCETON NJ",11,54,16,15,23,54,-74.65805817,40.34872055
231,"PRINCETON WV",11,1,0,0,1,1,-81.09912872,37.36967468
231,"PRIOR LAKE MN",11,1,0,0,1,1,-93.42295837,44.71300507
231,"PROSPER TX",11,18,4,2,12,18,-96.80168915,33.23641205
231,"PROSSER WA",11,2,0,1,1,2,-119.7716522,46.20647812
231,"PROVIDENCE RI",11,250,51,90,109,250,-71.40118408,41.82990265
231,"PROVIDENCE UT",11,1,0,0,1,1,-111.8190842,41.70813751
231,"PROVINCETOWN MA",11,189,50,56,83,189,-70.17770386,42.05849075
231,"PROVO UT",11,29,5,11,13,29,-111.6589813,40.23337936
231,"PUEBLO CO",11,48,18,9,21,48,-104.6108551,38.25450516
231,"PULLMAN WA",11,309,80,80,149,309,-117.180481,46.73068619
231,"PUNTA GORDA FL",11,7,0,4,3,7,-82.04517365,26.93050766
231,"PURCELLVILLE VA",11,1,0,1,0,1,-77.71422577,39.13694763
231,"PURYEAR TN",11,1,0,1,0,1,-88.33452606,36.44417191
231,"PUYALLUP WA",11,13,0,2,11,13,-122.2927628,47.19064331
231,"QUAKERTOWN PA",11,1,0,0,1,1,-75.33325958,40.44256592
231,"QUEEN CREEK AZ",11,10,2,1,7,10,-111.6382294,33.25391769
231,"QUINCY IL",11,13,5,2,6,13,-91.41021729,39.9356575
231,"QUINCY MA",11,13,2,4,7,13,-71.00706482,42.24961472
231,"QUINCY MI",11,2,2,0,0,2,-84.88388824,41.94426727
231,"QUINLAN TX",11,2,0,1,1,2,-96.13626099,32.91069031
231,"RACINE WI",11,14,3,2,9,14,-87.78296661,42.72628021
231,"RADFORD VA",11,30,10,6,14,30,-80.57588196,37.13208389
231,"RALEIGH MS",11,1,0,0,1,1,-89.52249146,32.0338974
231,"RALEIGH NC",11,681,175,196,310,681,-78.63800049,35.77230835
231,"RAMSEY MN",11,2,0,2,0,2,-93.41651154,45.24803162
231,"RAMSEY NJ",11,1,0,1,0,1,-74.13990021,41.05768967
231,"RANCHO CORDOVA CA",11,3,0,2,1,3,-121.3053742,38.58900452
231,"RANCHO MIRAGE CA",11,4,1,3,0,4,-116.4143066,33.73956299
231,"RANCHO PALOS VERDES CA",11,1,0,1,0,1,-118.388916,33.74456406
231,"RANDOLPH ME",11,2,2,0,0,2,-69.75239563,44.23274612
231,"RANDOLPH VT",11,2,0,0,2,2,-72.6631012,43.92315674
231,"RANGER GA",11,1,0,1,0,1,-84.71112823,34.50128555
231,"RANTOUL IL",11,1,0,1,0,1,-88.15558624,40.31206131
231,"RAPID CITY SD",11,18,3,11,4,18,-103.2325821,44.08078766
231,"RAVENNA OH",11,1,0,0,1,1,-81.24195099,41.15758896
231,"RAYNE LA",11,1,1,0,0,1,-92.2689209,30.23512268
231,"RAYTOWN MO",11,10,1,4,5,10,-94.46369934,39.00871277
231,"READING MA",11,2,2,0,0,2,-71.0990448,42.52708054
231,"READING PA",11,28,9,7,12,28,-75.9259491,40.33562851
231,"RECTOR AR",11,1,0,0,1,1,-90.29301453,36.26305771
231,"RED BANK NJ",11,3,1,0,2,3,-74.06324768,40.3471756
231,"RED BLUFF CA",11,3,0,2,1,3,-122.2382431,40.17803574
231,"RED HOOK NY",11,2,0,1,1,2,-73.87477875,41.99516296
231,"RED LION PA",11,7,2,2,3,7,-76.60523987,39.9010849
231,"RED OAK TX",11,2,0,1,1,2,-96.80502319,32.51770401
231,"RED WING MN",11,2,0,0,2,2,-92.53401184,44.56221771
231,"REDDING CA",11,38,13,3,22,38,-122.3944626,40.58649826
231,"REDLANDS CA",11,10,4,3,3,10,-117.21064,34.0318718
231,"REDMOND OR",11,5,1,1,3,5,-121.1761093,44.27230453
231,"REDMOND WA",11,135,34,35,66,135,-122.1240006,47.67367172
231,"REDONDO BEACH CA",11,38,5,16,17,38,-118.3907471,33.84916687
231,"REDWOOD CITY CA",11,48,12,13,23,48,-122.2364655,37.48601151
231,"REEDS SPRING MO",11,2,1,0,1,2,-93.37806702,36.74977493
231,"REFUGIO TX",11,2,1,1,0,2,-97.27603912,28.30598068
231,"REHOBOTH BEACH DE",11,2,0,1,1,2,-75.0807724,38.71229172
231,"REIDSVILLE NC",11,7,2,1,4,7,-79.66392517,36.35525513
231,"RENO NV",11,294,75,81,138,294,-119.8160934,39.5294838
231,"RENSSELAER NY",11,4,1,0,3,4,-73.741745,42.64271927
231,"RENTON WA",11,28,7,5,16,28,-122.2197342,47.48252487
231,"REPUBLIC MO",11,5,1,1,3,5,-93.48056793,37.12031555
231,"REVERE MA",11,5,1,3,1,5,-71.01091003,42.40863037
231,"REXBURG ID",11,3,1,1,1,3,-111.7915344,43.82584763
231,"REYNOLDSBURG OH",11,8,3,3,2,8,-82.81163788,39.95471191
231,"RHINELANDER WI",11,9,5,1,3,9,-89.41246796,45.63654709
231,"RIALTO CA",11,4,0,2,2,4,-117.3716126,34.1063118
231,"RICE LAKE WI",11,12,5,0,7,12,-91.73868561,45.5060463
231,"RICHARDSON TX",11,13,5,8,0,13,-96.73020172,32.94840622
231,"RICHFIELD MN",11,8,2,4,2,8,-93.28303528,44.87028503
231,"RICHLAND HILLS TX",11,16,3,6,7,16,-97.22873688,32.81633377
231,"RICHLAND MS",11,2,0,0,2,2,-90.16493225,32.22668076
231,"RICHLAND WA",11,90,12,70,8,90,-119.2866592,46.28547287
231,"RICHMOND CA",11,158,37,44,77,158,-122.3500443,37.9354744
231,"RICHMOND HEIGHTS MO",11,31,6,7,18,31,-90.31951904,38.62892532
231,"RICHMOND HEIGHTS OH",11,1,0,0,1,1,-81.50981903,41.55295944
231,"RICHMOND HILL GA",11,2,2,0,0,2,-81.30295563,31.9388752
231,"RICHMOND IN",11,12,3,2,7,12,-84.8900528,39.82888412
231,"RICHMOND KY",11,46,5,14,27,46,-84.29437256,37.74818802
231,"RICHMOND MO",11,2,0,2,0,2,-93.97762299,39.2788353
231,"RICHMOND TX",11,7,3,1,3,7,-95.76106262,29.58276558
231,"RICHMOND VA",11,508,131,147,230,508,-77.45962524,37.55412674
231,"RICHMOND VT",11,1,0,0,1,1,-72.99172211,44.40534973
231,"RIDGEFIELD CT",11,1,0,1,0,1,-73.49742126,41.28165054
231,"RIDGEFIELD PARK NJ",11,2,0,0,2,2,-74.02059937,40.85723877
231,"RIDGELAND MS",11,21,9,4,8,21,-90.13221741,32.42857742
231,"RIDGEWOOD NJ",11,1,1,0,0,1,-74.11595917,40.97959518
231,"RIDGWAY PA",11,3,1,1,1,3,-78.72838593,41.42049026
231,"RINCON GA",11,2,0,0,2,2,-81.23516846,32.29661179
231,"RIO GRANDE CITY TX",11,4,2,2,0,4,-98.82068634,26.38054466
231,"RIO RANCHO NM",11,10,3,2,5,10,-106.6682816,35.23852539
231,"RIPLEY MS",11,2,1,1,0,2,-88.95102692,34.72987747
231,"RIPON CA",11,1,0,0,1,1,-121.1263886,37.74160385
231,"RISON AR",11,3,0,2,1,3,-92.19036102,33.95878983
231,"RIVER FALLS WI",11,1,0,1,0,1,-92.62417603,44.86109543
231,"RIVERBANK CA",11,3,0,1,2,3,-120.9370804,37.73581314
231,"RIVERDALE GA",11,6,2,3,1,6,-84.4131012,33.57296371
231,"RIVERDALE IL",11,1,0,1,0,1,-87.633255,41.6336174
231,"RIVERHEAD NY",11,4,1,2,1,4,-72.66098785,40.91713333
231,"RIVERSIDE CA",11,166,40,51,75,166,-117.3973999,33.95311737
231,"RIVERSIDE NJ",11,3,1,0,2,3,-74.95646667,40.03240967
231,"ROANOKE RAPIDS NC",11,1,1,0,0,1,-77.65331268,36.46160889
231,"ROANOKE TX",11,1,0,0,1,1,-97.22651672,33.00436401
231,"ROANOKE VA",11,54,15,16,23,54,-79.94111633,37.27119827
231,"ROBBINS IL",11,1,0,0,1,1,-87.70363617,41.64415359
231,"ROBINSON IL",11,11,1,3,7,11,-87.73912048,39.00521469
231,"ROBINSON TX",11,1,0,1,0,1,-97.11503601,31.46778679
231,"ROCHELLE IL",11,2,1,1,0,2,-89.06913757,41.9238472
231,"ROCHESTER IL",11,1,0,1,0,1,-89.53198242,39.74978256
231,"ROCHESTER IN",11,13,3,4,6,13,-86.21604919,41.06472015
231,"ROCHESTER MI",11,4,0,2,2,4,-83.13374329,42.68050766
231,"ROCHESTER MN",11,40,15,8,17,40,-92.47042084,44.02156448
231,"ROCHESTER NY",11,453,113,115,225,453,-77.61522675,43.15487671
231,"ROCK HILL SC",11,37,9,10,18,37,-81.02463531,34.92498779
231,"ROCK ISLAND IL",11,1,0,1,0,1,-90.5790329,41.50963593
231,"ROCKAWAY NJ",11,1,0,1,0,1,-74.51339722,40.90123367
231,"ROCKDALE TX",11,11,2,2,7,11,-97.00177765,30.65601349
231,"ROCKFORD IL",11,35,3,16,16,35,-89.09428406,42.27135086
231,"ROCKFORD MI",11,4,0,2,2,4,-85.56002045,43.12025833
231,"ROCKINGHAM NC",11,1,0,1,0,1,-79.77334595,34.9397316
231,"ROCKLAND ME",11,1,0,0,1,1,-69.1079483,44.10363388
231,"ROCKLEDGE FL",11,2,0,0,2,2,-80.72518921,28.33512306
231,"ROCKLIN CA",11,5,1,1,3,5,-121.2383118,38.79031754
231,"ROCKPORT TX",11,3,0,0,3,3,-97.05498505,28.02133369
231,"ROCKVILLE MD",11,19,3,9,7,19,-77.15235901,39.08402252
231,"ROCKWALL TX",11,19,2,8,9,19,-96.46016693,32.93169022
231,"ROCKY HILL CT",11,4,0,2,2,4,-72.64056396,41.66537857
231,"ROCKY MOUNT NC",11,13,4,5,4,13,-77.78997803,35.93837738
231,"ROCKY MOUNT VA",11,1,0,1,0,1,-79.89165497,36.99800491
231,"ROCKY RIVER OH",11,3,2,0,1,3,-81.83889008,41.4756279
231,"ROELAND PARK KS",11,1,0,0,1,1,-94.63275146,39.03766251
231,"ROGERS AR",11,13,3,4,6,13,-94.11903381,36.33228683
231,"ROLLA MO",11,6,0,5,1,6,-91.77151489,37.95161438
231,"ROME GA",11,6,0,1,5,6,-85.16900635,34.24008942
231,"ROME NY",11,1,0,1,0,1,-75.4548645,43.21290207
231,"ROMEOVILLE IL",11,1,0,0,1,1,-88.08948517,41.64759064
231,"ROMULUS MI",11,1,1,0,0,1,-83.3963623,42.22240448
231,"RONCEVERTE WV",11,3,1,0,2,3,-80.46733856,37.74909592
231,"ROSCOE IL",11,1,0,1,0,1,-89.00959778,42.41326523
231,"ROSCOE SD",11,1,0,0,1,1,-99.33797455,45.44993591
231,"ROSE BUD AR",11,1,0,0,1,1,-92.08159637,35.33152771
231,"ROSE HILL KS",11,1,0,1,0,1,-97.13547516,37.5582962
231,"ROSEBURG OR",11,9,2,3,4,9,-123.3444519,43.21644974
231,"ROSELLE IL",11,2,0,1,1,2,-88.08023071,41.9848671
231,"ROSELLE NJ",11,1,0,0,1,1,-74.2624588,40.66469574
231,"ROSEMEAD CA",11,1,0,0,1,1,-118.0746079,34.08071899
231,"ROSENBERG TX",11,1,1,0,0,1,-95.80905914,29.5575695
231,"ROSENDALE NY",11,2,0,0,2,2,-74.0810318,41.84408951
231,"ROSEVILLE CA",11,22,7,8,7,22,-121.2899246,38.75195694
231,"ROSEVILLE MN",11,9,3,4,2,9,-93.14508057,45.02290726
231,"ROSSVILLE GA",11,1,1,0,0,1,-85.2930069,34.97555542
231,"ROSWELL GA",11,26,5,12,9,26,-84.36141205,34.02328491
231,"ROSWELL NM",11,5,2,1,2,5,-104.5282135,33.39533997
231,"ROUND LAKE IL",11,2,0,2,0,2,-88.09385681,42.35342789
231,"ROUND ROCK TX",11,17,3,4,10,17,-97.67939758,30.50861359
231,"ROWLETT TX",11,5,3,1,1,5,-96.56422424,32.90298462
231,"ROWLEY MA",11,1,0,1,0,1,-70.87771606,42.71709442
231,"ROY UT",11,1,0,1,0,1,-112.035286,41.16501999
231,"ROYAL OAK MI",11,20,7,5,8,20,-83.1442337,42.48933792
231,"ROYERSFORD PA",11,4,2,0,2,4,-75.53735352,40.18464279
231,"RUBICON WI",11,2,2,0,0,2,-88.45774078,43.34007263
231,"RUIDOSO NM",11,1,0,0,1,1,-105.6835709,33.33378601
231,"RUMSON NJ",11,20,7,3,10,20,-73.99851227,40.37051773
231,"RUSHVILLE IL",11,5,3,0,2,5,-90.56352997,40.12114334
231,"RUSHVILLE IN",11,3,0,2,1,3,-85.45323944,39.6113205
231,"RUSSELL MN",11,1,1,0,0,1,-95.95232391,44.3192482
231,"RUSSELLVILLE AR",11,5,0,0,5,5,-93.1343689,35.27845383
231,"RUSSELLVILLE KY",11,4,0,1,3,4,-86.88699341,36.84527588
231,"RUSTON LA",11,3,0,0,3,3,-92.63848877,32.52357101
231,"RUTHERFORD NJ",11,4,0,1,3,4,-74.10585022,40.82668304
231,"RUTHERFORDTON NC",11,2,2,0,0,2,-81.95639801,35.3694458
231,"RUTLAND VT",11,3,2,1,0,3,-72.97142029,43.61096954
231,"RUTLEDGE TN",11,2,0,2,0,2,-83.51450348,36.28107834
231,"RYE CO",11,6,1,3,2,6,-104.9316177,37.92366791
231,"RYE NY",11,4,1,2,1,4,-73.68312836,40.98072433
231,"SACHSE TX",11,2,1,0,1,2,-96.59605408,32.97636795
231,"SACKETS HARBOR NY",11,2,0,2,0,2,-76.12520599,43.94608688
231,"SACO ME",11,2,1,0,1,2,-70.4417038,43.50106049
231,"SACRAMENTO CA",11,740,190,228,322,740,-121.4959793,38.58154297
231,"SAGAMORE HILLS OH",11,1,0,1,0,1,-81.56762695,41.31193924
231,"SAGINAW MI",11,31,4,10,17,31,-83.95076752,43.41968918
231,"SAHUARITA AZ",11,63,22,13,28,63,-110.9567032,31.95795059
231,"SALEM IL",11,22,4,10,8,22,-88.94590759,38.62715149
231,"SALEM MA",11,26,5,10,11,26,-70.89565277,42.51993179
231,"SALEM NH",11,1,0,1,0,1,-71.19998169,42.78861618
231,"SALEM OH",11,2,1,1,0,2,-80.85612488,40.90091705
231,"SALEM OR",11,102,24,30,48,102,-123.0377197,44.94248199
231,"SALINA KS",11,6,0,2,4,6,-97.61184692,38.84041977
231,"SALINAS CA",11,140,32,36,72,140,-121.6571732,36.67780304
231,"SALINE MI",11,4,3,1,0,4,-83.78155518,42.16699982
231,"SALISBURY MD",11,24,4,6,14,24,-75.5984726,38.36100388
231,"SALISBURY NC",11,10,1,5,4,10,-80.47377014,35.67113495
231,"SALT LAKE CITY UT",11,275,73,69,133,275,-111.8912659,40.77029037
231,"SALTILLO MS",11,1,0,1,0,1,-88.68186188,34.37690353
231,"SALUDA NC",11,5,1,1,3,5,-82.34889221,35.23649216
231,"SAN ANGELO TX",11,29,7,12,10,29,-100.4379044,31.46401215
231,"SAN ANSELMO CA",11,1,0,1,0,1,-122.5641785,37.97429276
231,"SAN ANTONIO TX",11,1199,279,329,591,1199,-98.49394989,29.42439651
231,"SAN BENITO TX",11,3,1,0,2,3,-97.63174438,26.1331501
231,"SAN BERNARDINO CA",11,48,7,18,23,48,-117.304596,34.12142563
231,"SAN BRUNO CA",11,4,2,1,1,4,-122.4133148,37.63018799
231,"SAN CARLOS CA",11,9,5,2,2,9,-122.262207,37.50718307
231,"SAN CLEMENTE CA",11,7,1,2,4,7,-117.6134033,33.42698669
231,"SAN DIEGO CA",11,1635,388,467,780,1635,-117.1587296,32.71524429
231,"SAN DIMAS CA",11,4,0,2,2,4,-117.8088913,34.10668945
231,"SAN FERNANDO CA",11,1,0,0,1,1,-118.4407349,34.28187561
231,"SAN FRANCISCO CA",11,2619,696,657,1266,2619,-122.4213257,37.77465057
231,"SAN GABRIEL CA",11,1,0,1,0,1,-118.107605,34.09612274
231,"SAN JACINTO CA",11,1,0,0,1,1,-116.9603272,33.78380585
231,"SAN JOSE CA",11,473,125,112,236,473,-121.8973846,37.33491516
231,"SAN JUAN BAUTISTA CA",11,1,1,0,0,1,-121.5400391,36.84537506
231,"SAN LEANDRO CA",11,30,7,6,17,30,-122.155983,37.70180511
231,"SAN LUIS OBISPO CA",11,34,10,9,15,34,-120.6622849,35.28281021
231,"SAN MARCOS CA",11,12,4,1,7,12,-117.1673966,33.14345551
231,"SAN MARCOS TX",11,84,16,26,42,84,-97.94176483,29.88363266
231,"SAN MATEO CA",11,37,14,7,16,37,-122.3270264,37.56283569
231,"SAN RAFAEL CA",11,16,5,3,8,16,-122.5331726,37.97325134
231,"SAN RAMON CA",11,16,0,9,7,16,-121.9799347,37.77985764
231,"SANDERSVILLE GA",11,1,0,0,1,1,-82.80982208,32.98189545
231,"SANDUSKY OH",11,8,1,1,6,8,-82.7080307,41.44903183
231,"SANDWICH MA",11,1,0,1,0,1,-70.49419403,41.75436783
231,"SANDY OR",11,14,3,7,4,14,-122.263649,45.39704132
231,"SANDY SPRINGS GA",11,12,2,5,5,12,-84.37850952,33.92443848
231,"SANFORD FL",11,53,12,8,33,53,-81.27256012,28.80128288
231,"SANFORD ME",11,2,0,2,0,2,-70.77335358,43.43920135
231,"SANFORD MI",11,3,1,1,1,3,-84.38056946,43.67271042
231,"SANFORD NC",11,2,0,1,1,2,-79.17978668,35.4800415
231,"SANGER TX",11,1,0,1,0,1,-97.17427063,33.36363983
231,"SANTA ANA CA",11,42,11,12,19,42,-117.8697281,33.74567413
231,"SANTA BARBARA CA",11,224,61,61,102,224,-119.7056656,34.4233017
231,"SANTA CLARA CA",11,119,31,30,58,119,-121.946434,37.34754181
231,"SANTA CRUZ CA",11,120,32,28,60,120,-122.0333557,36.97389984
231,"SANTA FE NM",11,143,40,35,68,143,-105.9468155,35.68014526
231,"SANTA MARIA CA",11,4,1,0,3,4,-120.437973,34.95292664
231,"SANTA MONICA CA",11,213,53,60,100,213,-118.4925232,34.01921082
231,"SANTA PAULA CA",11,2,1,0,1,2,-119.0609283,34.35404587
231,"SANTA ROSA CA",11,140,37,34,69,140,-122.7165146,38.44017792
231,"SARALAND AL",11,1,0,1,0,1,-88.07051086,30.82098389
231,"SARANAC LAKE NY",11,4,2,2,0,4,-74.1305542,44.32965851
231,"SARASOTA FL",11,58,8,21,29,58,-82.53031158,27.33688736
231,"SARATOGA CA",11,11,3,4,4,11,-122.0252457,37.26384735
231,"SARATOGA SPRINGS NY",11,14,5,2,7,14,-73.78382111,43.08345032
231,"SARTELL MN",11,1,0,0,1,1,-94.20728302,45.62141418
231,"SATELLITE BEACH FL",11,3,0,1,2,3,-80.58939362,28.17677498
231,"SAUGATUCK MI",11,1,1,0,0,1,-86.2021637,42.65496826
231,"SAUGERTIES NY",11,10,1,3,6,10,-73.95199585,42.07786942
231,"SAUGUS MA",11,3,0,2,1,3,-71.00926971,42.46496964
231,"SAUK CITY WI",11,1,1,0,0,1,-89.72237396,43.27073669
231,"SAUK RAPIDS MN",11,2,1,0,1,2,-94.16661835,45.59189987
231,"SAUSALITO CA",11,9,1,7,1,9,-122.4881592,37.85736847
231,"SAVAGE MN",11,1,1,0,0,1,-93.33673096,44.7649498
231,"SAVANNAH GA",11,174,54,52,68,174,-81.09463501,32.07280731
231,"SAYREVILLE NJ",11,1,0,1,0,1,-74.36043549,40.45940018
231,"SCARSDALE NY",11,1,0,1,0,1,-73.78360748,41.00525665
231,"SCHAUMBURG IL",11,1,0,0,1,1,-88.08359528,42.03350449
231,"SCHENECTADY NY",11,11,2,6,3,11,-73.938591,42.81433487
231,"SCHERERVILLE IN",11,2,1,1,0,2,-87.44911957,41.49306488
231,"SCHULENBURG TX",11,1,0,0,1,1,-96.90359497,29.68226433
231,"SCHUYLKILL HAVEN PA",11,2,1,1,0,2,-76.17021942,40.63098145
231,"SCOTCH PLAINS NJ",11,9,4,2,3,9,-74.38912964,40.65579605
231,"SCOTIA NE",11,2,0,2,0,2,-98.70371246,41.4665184
231,"SCOTLAND NECK NC",11,2,0,2,0,2,-77.41972351,36.12969589
231,"SCOTTSBLUFF NE",11,1,0,0,1,1,-103.6682434,41.86663818
231,"SCOTTSDALE AZ",11,95,24,26,45,95,-111.9002533,33.50918579
231,"SCOTTSVILLE TX",11,1,0,1,0,1,-94.23889923,32.54086304
231,"SCRANTON PA",11,27,10,3,14,27,-75.66184998,41.40919113
231,"SEABROOK TX",11,4,1,1,2,4,-95.02601624,29.56442451
231,"SEAL BEACH CA",11,3,0,3,0,3,-118.1067505,33.74150848
231,"SEALY TX",11,1,0,0,1,1,-96.15762329,29.78135109
231,"SEARSPORT ME",11,2,1,0,1,2,-68.92290497,44.45871353
231,"SEASIDE CA",11,5,1,1,3,5,-121.8542252,36.6110611
231,"SEASIDE OR",11,1,1,0,0,1,-123.9250565,45.99291992
231,"SEAT PLEASANT MD",11,2,0,1,1,2,-76.90610504,38.8963623
231,"SEATTLE WA",11,4240,1143,1236,1861,4240,-122.3343964,47.60571289
231,"SEBASTIAN FL",11,2,0,1,1,2,-80.47020721,27.81705856
231,"SEBASTOPOL CA",11,9,2,2,5,9,-122.8264999,38.40188217
231,"SEBRING FL",11,1,0,0,1,1,-81.4406662,27.49625397
231,"SECAUCUS NJ",11,2,0,0,2,2,-74.05567169,40.78977585
231,"SEDALIA MO",11,11,1,2,8,11,-93.22884369,38.70438766
231,"SEDONA AZ",11,17,5,6,6,17,-111.7623367,34.86959839
231,"SEGUIN TX",11,12,2,6,4,12,-97.96529388,29.56933594
231,"SELAH WA",11,1,0,0,1,1,-120.5326233,46.65384674
231,"SELBYVILLE DE",11,1,1,0,0,1,-75.22740173,38.45663452
231,"SELLERSBURG IN",11,3,0,1,2,3,-85.75473785,38.39831543
231,"SELMA AL",11,7,2,1,4,7,-87.02119446,32.40768433
231,"SELMA CA",11,2,0,0,2,2,-119.6140518,36.57050323
231,"SEMINOLE FL",11,4,1,1,2,4,-82.79083252,27.84035683
231,"SEMMES AL",11,5,1,1,3,5,-88.25917053,30.7788372
231,"SENATOBIA MS",11,2,0,0,2,2,-89.96900177,34.61786652
231,"SENECA SC",11,8,1,2,5,8,-82.95318604,34.68600845
231,"SENOIA GA",11,1,0,0,1,1,-84.55380249,33.30273819
231,"SEQUIM WA",11,1,0,0,1,1,-123.1045303,48.07928085
231,"SEVIERVILLE TN",11,1,0,1,0,1,-83.56149292,35.86820984
231,"SHAFTSBURY VT",11,1,0,1,0,1,-73.19034576,43.0089798
231,"SHAKER HEIGHTS OH",11,148,42,37,69,148,-81.53669739,41.47419357
231,"SHAKOPEE MN",11,3,1,0,2,3,-93.52770233,44.79788971
231,"SHARON MA",11,2,0,0,2,2,-71.17311096,42.12431335
231,"SHARPSBURG MD",11,2,0,0,2,2,-77.74819183,39.45773315
231,"SHARPSVILLE IN",11,2,1,0,1,2,-86.08840179,40.37942886
231,"SHAWNEE KS",11,61,15,16,30,61,-94.7208786,39.0417366
231,"SHAWNEE OK",11,14,4,3,7,14,-96.92608643,35.32754898
231,"SHEBOYGAN WI",11,120,34,30,56,120,-87.71476746,43.75089264
231,"SHEFFIELD IA",11,1,0,0,1,1,-93.2154007,42.89302444
231,"SHELBURNE VT",11,1,0,0,1,1,-73.22679901,44.3805542
231,"SHELBY MI",11,1,1,0,0,1,-86.36434174,43.60855484
231,"SHELBY NC",11,8,5,3,0,8,-81.53518677,35.29262543
231,"SHELBYVILLE IL",11,2,2,0,0,2,-88.78992462,39.40638733
231,"SHELBYVILLE IN",11,4,2,0,2,4,-85.77182007,39.5215683
231,"SHELBYVILLE KY",11,3,1,0,2,3,-85.22341156,38.21203232
231,"SHELDON IA",11,12,1,5,6,12,-95.8535614,43.18698502
231,"SHELTON WA",11,1,0,1,0,1,-123.0995026,47.21501923
231,"SHENANDOAH PA",11,1,0,1,0,1,-76.20007324,40.8204422
231,"SHERIDAN WY",11,2,0,2,0,2,-106.9579773,44.7972641
231,"SHERMAN TX",11,7,4,2,1,7,-96.60933685,33.63597488
231,"SHERWOOD AR",11,9,2,2,5,9,-92.22438049,34.81515884
231,"SHERWOOD OR",11,3,0,2,1,3,-122.8425446,45.35624313
231,"SHERWOOD WI",11,2,0,0,1,1,-89.30547333,44.311050415
231,"SHIPPENSBURG PA",11,3,1,0,2,3,-77.51955414,40.05068207
231,"SHIVELY KY",11,8,3,2,3,8,-85.82255554,38.20013809
231,"SHOREVIEW MN",11,1,1,0,0,1,-93.1241684,45.06987762
231,"SHOREWOOD IL",11,1,0,1,0,1,-88.201828,41.52030182
231,"SHOREWOOD WI",11,1,1,0,0,1,-87.88748932,43.08912277
231,"SHREVEPORT LA",11,145,39,29,77,145,-93.7507019,32.52565002
231,"SHREWSBURY MA",11,1,0,0,1,1,-71.7025528,42.29489517
231,"SIDNEY OH",11,2,1,1,0,2,-84.15549469,40.28426743
231,"SIERRA MADRE CA",11,8,4,1,3,8,-118.0547943,34.16183853
231,"SIERRA VISTA AZ",11,2,0,1,1,2,-110.3048325,31.55449295
231,"SIGEL IL",11,1,0,0,1,1,-88.49406433,39.22620392
231,"SIKESTON MO",11,6,2,3,1,6,-89.5878067,36.87693024
231,"SILER CITY NC",11,1,0,0,1,1,-79.46157074,35.72395325
231,"SILOAM SPRINGS AR",11,1,1,0,0,1,-94.54097748,36.18841934
231,"SILSBEE TX",11,1,1,0,0,1,-94.17839813,30.34930038
231,"SILVER CITY NM",11,1,0,0,1,1,-108.281929,32.77336884
231,"SILVER CREEK NY",11,1,1,0,0,1,-79.16636658,42.5442009
231,"SILVERTON OR",11,3,1,2,0,3,-122.7857742,45.00499725
231,"SIMI VALLEY CA",11,23,6,7,10,23,-118.7839508,34.26951981
231,"SIMPSONVILLE SC",11,2,1,0,1,2,-82.25405121,34.73744202
231,"SIMSBURY CT",11,3,0,1,2,3,-72.8000412,41.8762207
231,"SIOUX CENTER IA",11,2,1,0,1,2,-96.17614746,43.0798111
231,"SIOUX CITY IA",11,5,2,2,1,5,-96.40085602,42.5001564
231,"SIOUX FALLS SD",11,44,13,12,19,44,-96.73429108,43.54177475
231,"SKOKIE IL",11,2,0,1,1,2,-87.73321533,42.03328705
231,"SLIDELL LA",11,14,2,5,7,14,-89.78143311,30.27558708
231,"SLIPPERY ROCK PA",11,10,3,5,2,10,-80.05516052,41.06407928
231,"SLOATSBURG NY",11,2,0,0,2,2,-74.19187164,41.15483475
231,"SMITHFIELD VA",11,4,2,2,0,4,-76.63034058,36.98272324
231,"SMITHTON MO",11,2,2,0,0,2,-93.09358978,38.68019104
231,"SMITHVILLE MO",11,1,0,0,1,1,-94.58171082,39.38669586
231,"SMYRNA DE",11,2,0,2,0,2,-75.60120392,39.30263519
231,"SMYRNA GA",11,11,1,4,6,11,-84.51447296,33.88409042
231,"SMYRNA TN",11,7,0,6,1,7,-86.51843262,35.98318863
231,"SNOHOMISH WA",11,13,3,4,6,13,-122.1009903,47.91241837
231,"SNOQUALMIE WA",11,2,0,2,0,2,-121.8274155,47.52823257
231,"SOCIAL CIRCLE GA",11,18,3,6,9,18,-83.71785736,33.65628433
231,"SOLDOTNA AK",11,5,2,1,2,5,-151.0635071,60.47569275
231,"SOLEDAD CA",11,3,1,2,0,3,-121.3278732,36.42473984
231,"SOMERSET KY",11,1,1,0,0,1,-84.60385132,37.09214783
231,"SOMERSET MA",11,1,0,0,1,1,-71.12979889,41.77045441
231,"SOMERVILLE MA",11,141,39,29,73,141,-71.09860992,42.38757324
231,"SONOMA CA",11,3,1,0,2,3,-122.4600754,38.29153061
231,"SONORA CA",11,35,7,11,17,35,-120.3842011,37.98400497
231,"SORRENTO LA",11,1,0,1,0,1,-90.85954285,30.18468285
231,"SOUDERTON PA",11,7,2,3,2,7,-75.32456207,40.31177902
231,"SOUTH AMBOY NJ",11,1,1,0,0,1,-74.28966522,40.47789383
231,"SOUTH BEND IN",11,159,40,56,63,159,-86.25171661,41.67295837
231,"SOUTH BOSTON VA",11,3,1,2,0,3,-78.90062714,36.6987915
231,"SOUTH CHARLESTON WV",11,3,0,1,2,3,-81.69944763,38.36863708
231,"SOUTH CHICAGO HEIGHTS IL",11,2,1,1,0,2,-87.63790894,41.48114014
231,"SOUTH GATE CA",11,19,5,4,10,19,-118.213707,33.95462799
231,"SOUTH HADLEY MA",11,6,1,4,1,6,-72.57582855,42.26013184
231,"SOUTH HOLLAND IL",11,1,0,1,0,1,-87.60710144,41.60099792
231,"SOUTH HOUSTON TX",11,1,1,0,0,1,-95.23612976,29.66330719
231,"SOUTH JORDAN UT",11,4,0,1,3,4,-111.9315186,40.56394577
231,"SOUTH LAKE TAHOE CA",11,20,7,1,12,20,-119.972786,38.94574356
231,"SOUTH LYON MI",11,2,1,0,1,2,-83.65129089,42.46051788
231,"SOUTH MIAMI FL",11,2,0,1,1,2,-80.29296875,25.70849991
231,"SOUTH MILWAUKEE WI",11,3,2,0,1,3,-87.86100006,42.91051483
231,"SOUTH NYACK NY",11,1,0,0,1,1,-73.91947937,41.08323288
231,"SOUTH PITTSBURG TN",11,1,0,0,1,1,-85.70410156,35.01231766
231,"SOUTH PLAINFIELD NJ",11,8,1,1,6,8,-74.41103363,40.57961655
231,"SOUTH PORTLAND ME",11,9,0,4,5,9,-70.23975372,43.6415062
231,"SOUTH RIVER NJ",11,1,0,0,1,1,-74.38522339,40.44672394
231,"SOUTH SALT LAKE UT",11,1,1,0,0,1,-111.8901367,40.71858215
231,"SOUTH SAN FRANCISCO CA",11,2,1,0,1,2,-122.4101868,37.65430069
231,"SOUTH TUCSON AZ",11,1,0,0,1,1,-110.9697952,32.19969177
231,"SOUTHAMPTON NY",11,66,17,17,32,66,-72.38861084,40.88444519
231,"SOUTHAVEN MS",11,2,2,0,0,2,-90.02496338,34.99386215
231,"SOUTHERN PINES NC",11,1,0,0,1,1,-79.39178467,35.17448425
231,"SOUTHFIELD MI",11,32,8,11,13,32,-83.22153473,42.47357559
231,"SOUTHGATE MI",11,1,0,0,1,1,-83.19342804,42.2142067
231,"SOUTHINGTON CT",11,6,2,1,3,6,-72.8768158,41.59680557
231,"SOUTHLAKE TX",11,3,1,0,2,3,-97.13466644,32.94153214
231,"SOUTHWICK MA",11,6,3,1,2,6,-72.76921844,42.05488205
231,"SPANISH FORT AL",11,1,1,0,0,1,-87.88751221,30.67488098
231,"SPARKS NV",11,19,2,7,10,19,-119.7548142,39.53468704
231,"SPARTA IL",11,1,1,0,0,1,-89.70211792,38.12332535
231,"SPARTA MI",11,3,2,0,1,3,-85.71018982,43.16081238
231,"SPARTA NC",11,1,0,1,0,1,-81.12025452,36.50556946
231,"SPARTANBURG SC",11,83,25,19,39,83,-81.93160248,34.94982529
231,"SPEARFISH SD",11,1,0,0,1,1,-103.8635941,44.49181366
231,"SPEARMAN TX",11,3,1,2,0,3,-101.1934052,36.19818497
231,"SPEEDWAY IN",11,95,23,25,47,95,-86.2671051,39.80224609
231,"SPENCER IA",11,1,0,1,0,1,-95.14494324,43.14133835
231,"SPIRIT LAKE IA",11,2,0,0,2,2,-95.10250854,43.4221344
231,"SPIRO OK",11,2,1,1,0,2,-94.62031555,35.24132538
231,"SPOKANE WA",11,290,97,68,125,290,-117.4281387,47.65847015
231,"SPRAGUE NE",11,1,1,0,0,1,-96.7452774,40.62594604
231,"SPRING HILL TN",11,4,0,2,2,4,-86.93003845,35.75111389
231,"SPRING LAKE NC",11,1,1,0,0,1,-78.97221375,35.16840744
231,"SPRINGDALE AR",11,29,8,12,9,29,-94.12921143,36.1869278
231,"SPRINGDALE OH",11,1,0,0,1,1,-84.48524475,39.28693008
231,"SPRINGFIELD IL",11,114,29,30,55,114,-89.6439743,39.80184174
231,"SPRINGFIELD MA",11,43,15,7,21,43,-72.57289124,42.10980606
231,"SPRINGFIELD MO",11,573,149,168,256,573,-93.29862213,37.21548843
231,"SPRINGFIELD OH",11,6,3,1,2,6,-83.80889893,39.92424011
231,"SPRINGFIELD OR",11,9,1,2,6,9,-123.024704,44.04590988
231,"SPRINGFIELD PA",11,1,1,0,0,1,-75.31934357,39.93074036
231,"SPRINGFIELD TN",11,4,0,2,2,4,-86.88502502,36.50941086
231,"SPRINGFIELD VT",11,6,2,0,4,6,-72.48161316,43.29873657
231,"SPRINGVILLE UT",11,1,0,1,0,1,-111.6123734,40.16522598
231,"SPRUCE PINE NC",11,2,0,1,1,2,-82.06425476,35.91545486
231,"ST LOUIS MO",11,10005,2946,2350,4709,10005,-90.19819641,38.62716675
231,"STAMFORD CT",11,36,11,7,18,36,-73.53807068,41.05353165
231,"STAMPING GROUND KY",11,2,2,0,0,2,-84.68621826,38.27175522
231,"STANHOPE NJ",11,2,0,1,1,2,-74.70857239,40.90287399
231,"STANLEY NC",11,2,0,0,2,2,-81.09666443,35.35927582
231,"STANWOOD WA",11,3,0,3,0,3,-122.3728256,48.24087524
231,"STARKE FL",11,1,0,0,1,1,-82.10956573,29.94442368
231,"STARKVILLE MS",11,38,9,10,19,38,-88.81492615,33.46545029
231,"STATE COLLEGE PA",11,57,12,18,27,57,-77.85973358,40.79336929
231,"STATESBORO GA",11,39,9,7,23,39,-81.78266907,32.44914246
231,"STAUNTON IL",11,1,0,0,1,1,-89.79161072,39.01238632
231,"STAUNTON VA",11,11,2,6,3,11,-79.07145691,38.14970016
231,"STEAMBOAT SPRINGS CO",11,17,6,7,4,17,-106.8292313,40.48627853
231,"STEPHENS CITY VA",11,1,0,0,1,1,-78.217659,39.08377075
231,"STEPHENVILLE TX",11,2,0,0,2,2,-98.20308685,32.22081757
231,"STERLING CO",11,4,1,1,2,4,-103.2093811,40.62519073
231,"STERLING HEIGHTS MI",11,4,1,1,2,4,-83.03016663,42.58047485
231,"STEVENS POINT WI",11,4,3,0,1,4,-89.57467651,44.52337265
231,"STEVENSVILLE MI",11,1,0,0,1,1,-86.51921082,42.0143013
231,"STEVENSVILLE MT",11,2,1,1,0,2,-114.0948715,46.50963974
231,"STILLWATER MN",11,11,3,5,3,11,-92.80657959,45.05171967
231,"STILLWATER OK",11,18,3,7,8,18,-97.0588913,36.11580658
231,"STOCKBRIDGE GA",11,9,0,3,6,9,-84.23356628,33.54455185
231,"STOCKTON CA",11,121,42,25,54,121,-121.293457,37.95776749
231,"STONE MOUNTAIN GA",11,34,4,9,21,34,-84.14538574,33.8065033
231,"STOUGHTON WI",11,1,0,0,1,1,-89.21815491,42.91680145
231,"STOW OH",11,9,2,4,3,9,-81.44025421,41.1593895
231,"STOWE VT",11,1,0,1,0,1,-72.68366241,44.46540451
231,"STRATFORD CT",11,11,3,2,6,11,-73.13223267,41.18459702
231,"STRATFORD OK",11,1,0,1,0,1,-96.95996857,34.7968483
231,"STUART FL",11,3,1,1,1,3,-80.25237274,27.19645882
231,"STUART VA",11,5,2,2,1,5,-80.26490784,36.64115906
231,"STUTTGART AR",11,1,0,0,1,1,-91.55264282,34.50066376
231,"SUFFERN NY",11,1,0,0,1,1,-74.14870453,41.11490631
231,"SUFFOLK VA",11,13,3,1,9,13,-76.58317566,36.72846985
231,"SUGAR LAND TX",11,34,11,8,15,34,-95.6352005,29.61997795
231,"SULLIGENT AL",11,1,1,0,0,1,-88.13464355,33.90181732
231,"SULPHUR OK",11,1,1,0,0,1,-96.96926117,34.5080719
231,"SULPHUR ROCK AR",11,1,1,0,0,1,-91.50110626,35.75118637
231,"SUMMERSVILLE WV",11,1,0,0,1,1,-80.85063171,38.27550125
231,"SUMMERVILLE SC",11,9,3,4,2,9,-80.17547607,33.01868439
231,"SUMTER SC",11,11,1,3,7,11,-80.34135437,33.92088318
231,"SUN PRAIRIE WI",11,5,2,2,1,5,-89.21392059,43.18373108
231,"SUN VALLEY ID",11,2,2,0,0,2,-114.3539352,43.69688034
231,"SUNNYSIDE WA",11,1,0,1,0,1,-120.0105743,46.32343674
231,"SUNNYVALE CA",11,53,20,11,22,53,-122.0380707,37.36878967
231,"SUNNYVALE TX",11,3,1,0,2,3,-96.56118774,32.7967453
231,"SUNRISE FL",11,2,0,1,1,2,-80.2282486,26.14059067
231,"SUNSET HILLS MO",11,1,0,1,0,1,-90.40755463,38.53887558
231,"SUNSET LA",11,1,0,0,1,1,-92.06873322,30.41154289
231,"SUPERIOR WI",11,2,0,0,2,2,-92.10461426,46.72050476
231,"SURF CITY NC",11,3,0,0,3,3,-77.54553986,34.42726898
231,"SURFSIDE BEACH SC",11,9,5,0,4,9,-78.97283173,33.6062355
231,"SURFSIDE FL",11,6,2,2,2,6,-80.12493134,25.87931252
231,"SUSQUEHANNA PA",11,1,0,1,0,1,-75.59903717,41.94361877
231,"SUTHERLIN OR",11,1,0,1,0,1,-123.3144531,43.38960648
231,"SUWANEE GA",11,11,5,3,3,11,-84.0713501,34.05178452
231,"SWAINSBORO GA",11,1,1,0,0,1,-82.33340454,32.59764099
231,"SWAMPSCOTT MA",11,2,0,1,1,2,-70.91659546,42.47095108
231,"SWANSEA IL",11,4,2,0,2,4,-89.98918152,38.53406143
231,"SWARTZ CREEK MI",11,5,1,1,3,5,-83.8306427,42.95724869
231,"SWEDESBORO NJ",11,1,0,0,1,1,-75.3094635,39.74773026
231,"SWEENY TX",11,4,3,0,1,4,-95.69893646,29.03920364
231,"SWEETWATER TX",11,1,1,0,0,1,-100.4070358,32.47128296
231,"SWISSVALE PA",11,1,0,0,1,1,-79.88240814,40.42403793
231,"SYCAMORE IL",11,4,3,1,0,4,-88.68714142,41.98875427
231,"SYKESVILLE MD",11,8,1,5,2,8,-76.96707916,39.37390518
231,"SYLACAUGA AL",11,3,2,0,1,3,-86.25159454,33.17354202
231,"SYLVANIA OH",11,24,6,9,9,24,-83.71266174,41.71902466
231,"SYRACUSE NY",11,343,88,98,157,343,-76.14653015,43.04846191
231,"TABERNACLE NJ",11,1,0,1,0,1,-74.70965576,39.84401703
231,"TACOMA WA",11,324,105,86,133,324,-122.4466705,47.25242233
231,"TAHLEQUAH OK",11,12,6,3,3,12,-94.9703064,35.91559982
231,"TAKOMA PARK MD",11,9,2,4,3,9,-77.00667572,38.97793198
231,"TALLADEGA AL",11,1,0,0,1,1,-86.10553741,33.43610001
231,"TALLAHASSEE FL",11,191,59,53,79,191,-84.27896881,30.44669914
231,"TALLULAH LA",11,1,0,1,0,1,-91.18704987,32.40855789
231,"TAMARAC FL",11,7,1,2,4,7,-80.22389984,26.19458199
231,"TAMPA FL",11,1006,275,283,448,1006,-82.4580307,27.94833755
231,"TAMPICO IL",11,1,0,1,0,1,-89.78656006,41.63049698
231,"TANANA AK",11,1,0,1,0,1,-152.0746002,65.16492462
231,"TANGENT OR",11,2,0,0,2,2,-123.1104889,44.54080582
231,"TAOS NM",11,115,38,31,46,115,-105.5769424,36.40658188
231,"TARBORO NC",11,1,0,1,0,1,-77.5349884,35.89706039
231,"TARENTUM PA",11,1,0,0,1,1,-79.75936127,40.60139465
231,"TARPON SPRINGS FL",11,31,13,8,10,31,-82.75656128,28.14682198
231,"TARRYTOWN NY",11,1,1,0,0,1,-73.85806274,41.07656097
231,"TAUNTON MA",11,6,2,1,3,6,-71.08903503,41.900177
231,"TAYLOR MI",11,12,4,3,5,12,-83.26967621,42.24112701
231,"TEA SD",11,4,1,3,0,4,-96.83795166,43.44678497
231,"TEANECK NJ",11,24,8,5,11,24,-74.01485443,40.89759064
231,"TEHACHAPI CA",11,1,0,0,1,1,-118.4508972,35.132164
231,"TEKONSHA MI",11,1,0,0,1,1,-84.98558044,42.09355927
231,"TELL CITY IN",11,1,0,1,0,1,-86.76784515,37.95154953
231,"TEMECULA CA",11,35,11,8,16,35,-117.1428146,33.48790741
231,"TEMPE AZ",11,292,66,85,141,292,-111.9108276,33.41504288
231,"TEMPLE CITY CA",11,8,2,3,3,8,-118.0596924,34.10735321
231,"TEMPLE TX",11,19,4,5,10,19,-97.34354401,31.09850502
231,"TERRE HAUTE IN",11,22,6,5,11,22,-87.41414642,39.46681976
231,"TEUTOPOLIS IL",11,3,0,0,3,3,-88.47222137,39.13311386
231,"TEWKSBURY MA",11,17,9,2,6,17,-71.23313904,42.61103439
231,"TEXARKANA AR",11,2,1,0,1,2,-94.03818512,33.44210052
231,"TEXARKANA TX",11,5,0,2,3,5,-94.04785156,33.42536545
231,"TEXAS CITY TX",11,1,0,0,1,1,-94.90317535,29.38432312
231,"THATCHER AZ",11,1,0,1,0,1,-109.7611008,32.84925461
231,"THE DALLES OR",11,2,2,0,0,2,-121.1804581,45.59422684
231,"THIBODAUX LA",11,1,0,0,1,1,-90.82309723,29.79626465
231,"THIEF RIVER FALLS MN",11,3,0,0,3,3,-96.18167114,48.11899567
231,"THOMASTON GA",11,1,1,0,0,1,-84.32656097,32.888237
231,"THOMASVILLE GA",11,1,0,0,1,1,-83.97835541,30.8371582
231,"THORNTON CO",11,14,2,2,10,14,-104.9727631,39.86811829
231,"THOUSAND OAKS CA",11,13,2,4,7,13,-118.8398514,34.17078018
231,"THREE LAKES WI",11,1,1,0,0,1,-89.16351318,45.79806519
231,"THREE RIVERS MI",11,13,2,7,4,13,-85.63246918,41.94419861
231,"TIFFIN OH",11,2,2,0,0,2,-83.17781067,41.11477661
231,"TIFTON GA",11,4,1,1,2,4,-83.508255,31.4508934
231,"TIGARD OR",11,9,4,3,2,9,-122.7737198,45.4310112
231,"TIGER GA",11,1,0,0,1,1,-83.43260956,34.84734344
231,"TILLAMOOK OR",11,1,0,1,0,1,-123.8468399,45.45576096
231,"TILTON NH",11,1,0,0,1,1,-71.59250641,43.44886398
231,"TIMPSON TX",11,3,0,0,3,3,-94.39550781,31.90409851
231,"TINLEY PARK IL",11,4,2,1,1,4,-87.78465271,41.57352448
231,"TIPP CITY OH",11,4,2,2,0,4,-84.17195892,39.95846939
231,"TITUSVILLE PA",11,1,0,1,0,1,-79.67320251,41.62724304
231,"TOLEDO OH",11,288,67,72,149,288,-83.55497742,41.66411591
231,"TOMAH WI",11,1,0,0,1,1,-90.50442505,43.97857666
231,"TOMBALL TX",11,12,4,4,4,12,-95.6162262,30.09776115
231,"TOMBSTONE AZ",11,25,9,4,12,25,-110.0689316,31.71310997
231,"TOMS RIVER NJ",11,18,6,6,6,18,-74.19700623,39.95401382
231,"TONAWANDA NY",11,5,0,2,3,5,-78.88004303,43.02050018
231,"TONKAWA OK",11,2,0,0,2,2,-97.3106308,36.67843628
231,"TOOELE UT",11,5,4,1,0,5,-112.3005066,40.53457642
231,"TOPEKA KS",11,76,19,24,33,76,-95.67857361,39.04813766
231,"TOPPENISH WA",11,6,0,2,4,6,-120.3111954,46.37686539
231,"TOPSFIELD MA",11,1,0,0,1,1,-70.94822693,42.6378746
231,"TORONTO KS",11,39,9,8,22,39,-95.94944,37.79908752
231,"TORONTO OH",11,6,1,0,5,6,-80.60319519,40.46689606
231,"TORRANCE CA",11,94,22,31,41,94,-118.3428345,33.8359642
231,"TORRINGTON CT",11,110,35,31,44,110,-73.12056732,41.80105209
231,"TORRINGTON WY",11,3,3,0,0,3,-104.1826859,42.06502533
231,"TOWER MN",11,1,1,0,0,1,-92.27474976,47.80524826
231,"TRACY CA",11,9,2,3,4,9,-121.427269,37.73949814
231,"TRAPPE MD",11,2,0,1,1,2,-76.05755615,38.65869522
231,"TRAVELERS REST SC",11,1,0,0,1,1,-82.44297028,34.96780014
231,"TRAVERSE CITY MI",11,38,9,10,19,38,-85.6207962,44.76324844
231,"TREASURE ISLAND FL",11,5,1,1,3,5,-82.76873779,27.76968193
231,"TRENTON MI",11,5,0,2,3,5,-83.17776489,42.13973236
231,"TRENTON NJ",11,40,5,12,23,40,-74.74206543,40.21709442
231,"TRENTON OH",11,3,1,0,2,3,-84.45779419,39.48095703
231,"TRINIDAD CO",11,1,0,0,1,1,-104.5080338,37.17304611
231,"TROY KS",11,1,0,0,1,1,-95.09043121,39.78313828
231,"TROY MI",11,10,2,4,4,10,-83.14983368,42.60589218
231,"TROY MO",11,45,15,17,13,45,-90.98098755,38.979702
231,"TROY NY",11,11,3,3,5,11,-73.69088745,42.72839737
231,"TROY OH",11,42,12,14,16,42,-84.20330811,40.03966141
231,"TRUCKEE CA",11,2,1,0,1,2,-120.1852493,39.32775879
231,"TRUMANN AR",11,1,1,0,0,1,-90.5122757,35.67847824
231,"TRUMBULL CT",11,1,1,0,0,1,-73.1999588,41.24323654
231,"TRUSSVILLE AL",11,1,0,1,0,1,-86.61297607,33.62001419
231,"TRUTH OR CONSEQUENCES NM",11,1,0,0,1,1,-107.2433853,33.13360596
231,"TUCKAHOE NY",11,1,0,0,1,1,-73.82630157,40.95046616
231,"TUCKER GA",11,3,1,0,2,3,-84.21690369,33.85486603
231,"TUCKERTON NJ",11,5,1,1,3,5,-74.3393631,39.60338211
231,"TUCSON AZ",11,474,135,135,204,474,-110.9277954,32.22209167
231,"TULARE CA",11,1,0,0,1,1,-119.3488922,36.20763016
231,"TULLAHOMA TN",11,2,0,2,0,2,-86.20916748,35.36205673
231,"TULSA OK",11,218,48,76,94,218,-95.98488617,36.1603241
231,"TUMWATER WA",11,2,0,1,1,2,-122.9116669,47.00710678
231,"TUPELO MS",11,9,3,3,3,9,-88.71934509,34.26508713
231,"TUPPER LAKE NY",11,1,1,0,0,1,-74.46309662,44.22465134
231,"TURLOCK CA",11,6,1,2,3,6,-120.8488617,37.49431229
231,"TURTLE CREEK PA",11,3,2,0,1,3,-79.8516922,40.39013672
231,"TUSCALOOSA AL",11,115,39,26,50,115,-87.56897736,33.21024704
231,"TUSCUMBIA AL",11,1,1,0,0,1,-87.70251465,34.73139191
231,"TUSKEGEE AL",11,1,0,1,0,1,-85.69181061,32.42424011
231,"TUSTIN CA",11,10,2,5,3,10,-117.8277283,33.74598312
231,"TUTTLE OK",11,6,1,1,4,6,-97.82015991,35.29173279
231,"TWENTYNINE PALMS CA",11,4,0,1,3,4,-116.055397,34.13557053
231,"TWIN FALLS ID",11,46,10,18,18,46,-114.4627686,42.56301498
231,"TWINSBURG OH",11,3,3,0,0,3,-81.43978882,41.3127594
231,"TYLER TX",11,41,12,11,18,41,-95.3013916,32.35176468
231,"TYRONE GA",11,1,0,1,0,1,-84.59676361,33.47140121
231,"UKIAH CA",11,7,2,0,5,7,-123.2104721,39.15015793
231,"UNION BRIDGE MD",11,1,0,0,1,1,-77.17628479,39.56907654
231,"UNION CITY CA",11,3,0,0,3,3,-122.0214462,37.59539032
231,"UNION CITY GA",11,1,0,0,1,1,-84.55107117,33.58210373
231,"UNION CITY NJ",11,2,1,1,0,2,-74.02296448,40.77968979
231,"UNION CITY PA",11,1,1,0,0,1,-79.84510803,41.89942551
231,"UNION KY",11,1,0,0,1,1,-84.68045044,38.94612122
231,"UNION ME",11,2,1,1,0,2,-69.27328491,44.21183395
231,"UNION MO",11,13,2,6,5,13,-91.00618744,38.44558716
231,"UNION NJ",11,4,0,1,3,4,-74.26235199,40.69780731
231,"UNIONTOWN PA",11,6,3,2,1,6,-79.7276535,39.89894104
231,"UNIONVILLE PA",11,3,0,0,1,1,-77.93852234,40.5169906633333
231,"UNIVERSAL CITY TX",11,8,3,2,3,8,-98.29141235,29.54836273
231,"UNIVERSITY CITY MO",11,182,65,42,75,182,-90.33391571,38.66000748
231,"UNIVERSITY HEIGHTS OH",11,1,1,0,0,1,-81.5369873,41.49779892
231,"UNIVERSITY PLACE WA",11,8,4,2,2,8,-122.5529404,47.2352562
231,"UPLAND CA",11,12,1,5,6,12,-117.6498413,34.09745026
231,"UPPER ARLINGTON OH",11,1,0,0,1,1,-83.06159973,39.99918365
231,"UPPER DARBY PA",11,2,0,0,2,2,-75.27319336,39.92858124
231,"UPPER MARLBORO MD",11,5,0,2,3,5,-76.74905396,38.81620026
231,"URBANA IL",11,66,24,14,28,66,-88.20746613,40.11079025
231,"URBANA OH",11,4,1,1,2,4,-83.75213623,40.10844803
231,"URBANDALE IA",11,1,0,1,0,1,-93.71256256,41.62665176
231,"UTICA NY",11,6,1,4,1,6,-75.23220062,43.10119629
231,"UVALDE TX",11,3,2,0,1,3,-99.78696442,29.20999336
231,"VACAVILLE CA",11,19,9,4,6,19,-121.9900284,38.35633469
231,"VADER WA",11,20,4,8,8,20,-122.962738,46.40246582
231,"VADNAIS HEIGHTS MN",11,1,0,0,1,1,-93.07452393,45.05739975
231,"VALDOSTA GA",11,88,27,24,37,88,-83.27806854,30.83293533
231,"VALLEJO CA",11,69,22,19,28,69,-122.2594299,38.1039505
231,"VALLEY AL",11,5,2,2,1,5,-85.17531586,32.81519318
231,"VALLEY CENTER KS",11,2,0,0,2,2,-97.37397003,37.83451462
231,"VALLEY PARK MO",11,1,0,1,0,1,-90.49259186,38.54935455
231,"VALLEY STREAM NY",11,3,1,0,2,3,-73.70756531,40.66439819
231,"VALPARAISO IN",11,9,1,6,2,9,-87.05838013,41.46813583
231,"VAN BUREN IN",11,2,2,0,0,2,-85.5044632,40.61747742
231,"VANCOUVER WA",11,116,44,23,49,116,-122.6816559,45.63534164
231,"VARNADO LA",11,2,0,1,1,2,-89.82972717,30.89409256
231,"VARNELL GA",11,1,0,1,0,1,-84.97011566,34.90238953
231,"VARNVILLE SC",11,6,1,4,1,6,-81.07863617,32.85089874
231,"VENETA OR",11,4,3,0,1,4,-123.3538208,44.04835129
231,"VENICE FL",11,11,6,2,3,11,-82.45388031,27.10065269
231,"VERDON NE",11,2,0,0,2,2,-95.71338654,40.14810562
231,"VERMILLION SD",11,4,1,1,2,4,-96.92948914,42.77981949
231,"VERNAL UT",11,1,0,1,0,1,-109.5302963,40.45552444
231,"VERNON AL",11,1,0,0,1,1,-88.10897064,33.75712967
231,"VERNON CT",11,1,1,0,0,1,-72.47887421,41.81890869
231,"VERO BEACH FL",11,15,5,6,4,15,-80.39705658,27.63908195
231,"VERONA NJ",11,2,0,0,2,2,-74.23944092,40.83020401
231,"VERONA PA",11,4,2,0,2,4,-79.84282684,40.50643539
231,"VERONA WI",11,1,0,1,0,1,-89.53356171,42.99075699
231,"VERSAILLES KY",11,2,1,1,0,2,-84.73013306,38.05267715
231,"VESTAVIA HILLS AL",11,1,1,0,0,1,-86.78768921,33.44869995
231,"VICKSBURG MS",11,24,5,10,9,24,-90.87818909,32.35280991
231,"VICTORIA TX",11,18,3,5,10,18,-97.00409698,28.80560303
231,"VICTORVILLE CA",11,30,6,10,14,30,-117.2928162,34.53612137
231,"VIDALIA GA",11,2,0,1,1,2,-82.41294098,32.21813965
231,"VIDALIA LA",11,1,1,0,0,1,-91.42620087,31.56594276
231,"VIENNA GA",11,1,0,1,0,1,-83.7951889,32.09189987
231,"VIENNA VA",11,38,9,11,18,38,-77.2645874,38.90164566
231,"VIENNA WV",11,7,4,1,2,7,-81.54671478,39.33840179
231,"VILLA PARK IL",11,2,1,0,1,2,-87.98905182,41.88983536
231,"VILLA RICA GA",11,7,2,2,3,7,-84.91907501,33.73210907
231,"VINCENNES IN",11,1,0,1,0,1,-87.5169754,38.68549347
231,"VINE GROVE KY",11,21,6,6,9,21,-85.98104858,37.81027222
231,"VINELAND NJ",11,9,3,2,4,9,-75.02515411,39.48631668
231,"VINITA OK",11,1,0,0,1,1,-95.15478516,36.63890839
231,"VIRGINIA BEACH VA",11,447,128,124,195,447,-75.97751617,36.8533783
231,"VIROQUA WI",11,1,0,0,1,1,-90.8891983,43.55662155
231,"VISALIA CA",11,17,2,4,11,17,-119.2938156,36.33000946
231,"VISTA CA",11,38,16,11,11,38,-117.2447052,33.2000885
231,"VIVIAN LA",11,1,0,0,1,1,-93.98780823,32.87190247
231,"VOORHEESVILLE NY",11,1,0,1,0,1,-73.92787933,42.6541748
231,"WACO TX",11,26,7,7,12,26,-97.14704895,31.54987144
231,"WACONIA MN",11,1,0,0,1,1,-93.78717041,44.85052109
231,"WAGONER OK",11,1,0,1,0,1,-95.37010193,35.95982361
231,"WAGRAM NC",11,2,0,0,2,2,-79.36548615,34.88830948
231,"WAITE PARK MN",11,118,31,23,64,118,-94.224823,45.55731201
231,"WAKE FOREST NC",11,19,6,10,3,19,-78.50919342,35.98039246
231,"WAKEFIELD MA",11,18,3,6,9,18,-71.07489014,42.51018906
231,"WALDOBORO ME",11,14,6,4,4,14,-69.37466431,44.09539795
231,"WALHALLA SC",11,1,0,1,0,1,-83.06377411,34.76495743
231,"WALKERSVILLE MD",11,1,0,0,1,1,-77.35131073,39.48646164
231,"WALLA WALLA WA",11,5,1,1,3,5,-118.3452072,46.06405258
231,"WALLED LAKE MI",11,2,1,0,1,2,-83.4806366,42.53804779
231,"WALLINGFORD CT",11,7,0,5,2,7,-72.82215118,41.45715332
231,"WALLS MS",11,1,0,1,0,1,-90.15171814,34.95790863
231,"WALNUT CREEK CA",11,6,2,0,4,6,-122.0670624,37.90636826
231,"WALPOLE MA",11,1,0,0,1,1,-71.2485199,42.14173889
231,"WALTHAM MA",11,9,5,0,4,9,-71.2346344,42.37656403
231,"WALTON KY",11,4,2,1,1,4,-84.61334229,38.86997604
231,"WAPPINGERS FALLS NY",11,1,1,0,0,1,-73.91039276,41.59646606
231,"WARDEN WA",11,1,0,0,1,1,-119.0420456,46.96730423
231,"WARE MA",11,10,2,4,4,10,-72.24856567,42.26243591
231,"WAREHAM MA",11,2,0,1,1,2,-70.68606567,41.76660156
231,"WARMINSTER PA",11,1,0,0,1,1,-75.09890747,40.20700836
231,"WARNER ROBINS GA",11,4,2,2,0,4,-83.59963989,32.62118149
231,"WARREN MI",11,166,40,43,83,166,-83.02783203,42.47764969
231,"WARREN OH",11,4,3,1,0,4,-80.81771851,41.23757935
231,"WARRENSBURG MO",11,8,1,1,6,8,-93.73639679,38.76289749
231,"WARRENTON OR",11,1,0,0,1,1,-123.9260635,46.16466522
231,"WARRENTON VA",11,25,8,10,7,25,-77.79475403,38.71380615
231,"WARRINGTON PA",11,1,0,0,1,1,-75.13303375,40.24938202
231,"WARSAW IN",11,2,0,0,2,2,-85.85310364,41.23810196
231,"WARSAW NY",11,1,0,0,1,1,-78.13197327,42.74021912
231,"WARWICK NY",11,2,0,0,2,2,-74.35926819,41.25672531
231,"WARWICK RI",11,12,3,3,6,12,-71.37738037,41.69232941
231,"WASCO CA",11,5,1,1,3,5,-119.3427811,35.59425735
231,"WASHBURN MO",11,2,2,0,0,2,-93.96649933,36.58715439
231,"WASHINGTON COURT HOUSE OH",11,1,1,0,0,1,-83.43916321,39.53675079
231,"WASHINGTON DC",11,10520,2876,2791,4853,10520,-77.01257324,38.88911819
231,"WASHINGTON IL",11,1,0,1,0,1,-89.40994263,40.70514297
231,"WASHINGTON LA",11,1,1,0,0,1,-92.05741119,30.6164608
231,"WASHINGTON MO",11,29,7,10,12,29,-91.01213074,38.55807495
231,"WASHINGTON PA",11,3,1,0,2,3,-80.24552155,40.17398453
231,"WASHOUGAL WA",11,3,0,1,2,3,-122.3545303,45.58441925
231,"WASILLA AK",11,38,11,11,16,38,-149.4517059,61.58290482
231,"WATERBURY CT",11,7,2,1,4,7,-73.05029297,41.55849075
231,"WATERLOO IA",11,15,3,5,7,15,-92.34320831,42.49277496
231,"WATERLOO IL",11,24,7,4,13,24,-90.14981842,38.3361702
231,"WATERTOWN NY",11,8,4,3,1,8,-75.9100647,43.97471619
231,"WATERTOWN SD",11,1,0,0,1,1,-97.11455536,44.9015274
231,"WATERTOWN WI",11,1,1,0,0,1,-88.72946167,43.19454193
231,"WATERVILLE ME",11,14,2,7,5,14,-69.63098145,44.55205154
231,"WATERVLIET NY",11,1,0,0,1,1,-73.70020294,42.73034668
231,"WATKINSVILLE GA",11,1,0,1,0,1,-83.40834808,33.86332703
231,"WATSONVILLE CA",11,9,4,1,4,9,-121.7594147,36.90995407
231,"WAUCONDA IL",11,2,0,1,1,2,-88.13915253,42.25894928
231,"WAUKEE IA",11,1,0,1,0,1,-93.8857193,41.61172485
231,"WAUKEGAN IL",11,12,1,9,2,12,-87.84466553,42.36366653
231,"WAUKESHA WI",11,66,15,16,35,66,-88.23146057,43.01194382
231,"WAUNAKEE WI",11,31,11,10,10,31,-89.45576477,43.19177246
231,"WAUSAU WI",11,8,4,2,2,8,-89.63059998,44.95904922
231,"WAUSEON OH",11,1,0,0,1,1,-84.14173889,41.54945755
231,"WAUWATOSA WI",11,9,3,5,1,9,-88.00754547,43.04960632
231,"WAVELAND IN",11,2,0,0,2,2,-87.04476166,39.87699127
231,"WAVERLY KS",11,3,2,1,0,3,-95.603302,38.39393997
231,"WAVERLY NE",11,14,5,4,5,14,-96.52924347,40.9175148
231,"WAXAHACHIE TX",11,6,0,3,3,6,-96.84883118,32.38674545
231,"WAXHAW NC",11,1,1,0,0,1,-80.74282074,34.92486572
231,"WAYCROSS GA",11,3,1,1,1,3,-82.35388184,31.21380043
231,"WAYLAND MA",11,3,1,0,2,3,-71.36071777,42.36267471
231,"WAYLAND MI",11,2,1,1,0,2,-85.64461517,42.67387772
231,"WAYNE MI",11,2,1,0,1,2,-83.38627625,42.28170776
231,"WAYNE NE",11,1,0,0,1,1,-97.01864624,42.23064804
231,"WAYNE NJ",11,4,1,2,1,4,-74.27560425,40.92553711
231,"WAYNE PA",11,2,0,1,1,2,-75.38678741,40.04436111
231,"WAYNE WV",11,1,1,0,0,1,-82.44137573,38.22011566
231,"WAYNESBORO PA",11,1,0,0,1,1,-77.5769043,39.75597763
231,"WAYNESBORO VA",11,2,0,2,0,2,-78.88896179,38.06871414
231,"WAYNESBURG PA",11,2,0,1,1,2,-80.17857361,39.89648438
231,"WAYNESVILLE MO",11,1,0,1,0,1,-92.20101166,37.8287735
231,"WAYNESVILLE NC",11,1,0,1,0,1,-82.98840332,35.48899078
231,"WAYZATA MN",11,1,0,0,1,1,-93.51425171,44.97086334
231,"WEATHERFORD TX",11,4,1,2,1,4,-97.79758453,32.7595253
231,"WEAVERVILLE NC",11,4,1,1,2,4,-82.56031799,35.6974411
231,"WEBB IA",11,1,0,0,1,1,-95.01261902,42.94872665
231,"WEBSTER GROVES MO",11,6,1,1,4,6,-90.35769653,38.59287262
231,"WEBSTER NY",11,3,1,0,2,3,-77.42967224,43.21234131
231,"WEED CA",11,10,5,2,3,10,-122.388382,41.42225266
231,"WEEHAWKEN NJ",11,22,8,6,8,22,-74.01938629,40.7696991
231,"WEIRTON WV",11,3,1,2,0,3,-80.58799744,40.40523529
231,"WELEETKA OK",11,1,0,1,0,1,-96.13697052,35.33607864
231,"WELLESLEY MA",11,7,1,5,1,7,-71.29138947,42.29670715
231,"WELLINGTON OH",11,1,0,1,0,1,-82.21770477,41.16889954
231,"WELLSBORO PA",11,1,1,0,0,1,-77.29973602,41.74900436
231,"WELLSVILLE OH",11,1,0,0,1,1,-80.65098572,40.60504913
231,"WENATCHEE WA",11,3,0,0,3,3,-120.3128357,47.42322159
231,"WENDELL NC",11,1,0,0,1,1,-78.36904144,35.78117371
231,"WENTZVILLE MO",11,9,2,2,5,9,-90.85335541,38.81171036
231,"WESLACO TX",11,73,17,20,36,73,-97.99131775,26.16018867
231,"WEST ALLIS WI",11,3,0,2,1,3,-88.00700378,43.01686478
231,"WEST BRANCH MI",11,1,1,0,0,1,-84.23848724,44.2763443
231,"WEST CALDWELL NJ",11,6,2,2,2,6,-74.30077362,40.84119797
231,"WEST CHESTER OH",11,8,1,4,3,8,-84.40789032,39.33029938
231,"WEST CHESTER PA",11,16,8,1,7,16,-75.60475159,39.96074677
231,"WEST CHICAGO IL",11,7,2,1,4,7,-88.20433807,41.88489914
231,"WEST COVINA CA",11,6,0,0,6,6,-117.9406204,34.0685463
231,"WEST DES MOINES IA",11,28,12,6,10,28,-93.71179962,41.57717514
231,"WEST FARGO ND",11,27,10,8,9,27,-96.90450287,46.87138367
231,"WEST FRANKFORT IL",11,1,0,0,1,1,-88.93157196,37.89781189
231,"WEST HARTFORD CT",11,25,8,8,9,25,-72.74108887,41.76238251
231,"WEST HAVEN CT",11,4,1,0,3,4,-72.94598389,41.27069473
231,"WEST HOLLYWOOD CA",11,146,44,39,63,146,-118.3634567,34.08982468
231,"WEST JORDAN UT",11,3,0,1,2,3,-111.9405594,40.60975647
231,"WEST LAFAYETTE IN",11,33,7,9,17,33,-86.9082489,40.42613983
231,"WEST LIBERTY KY",11,3,0,1,2,3,-83.25924683,37.92175293
231,"WEST MONROE LA",11,1,0,1,0,1,-92.14794922,32.5187645
231,"WEST ORANGE NJ",11,12,3,3,6,12,-74.23833466,40.7989006
231,"WEST PALM BEACH FL",11,109,30,29,50,109,-80.05298615,26.71585464
231,"WEST PLAINS MO",11,12,2,2,8,12,-91.85284424,36.72810745
231,"WEST POINT GA",11,1,0,0,1,1,-85.18297577,32.87822342
231,"WEST RICHLAND WA",11,1,0,0,1,1,-119.3632965,46.30400085
231,"WEST SACRAMENTO CA",11,6,4,1,1,6,-121.5324554,38.58049393
231,"WEST SENECA NY",11,1,0,0,1,1,-78.79914856,42.85012436
231,"WEST TX",11,12,4,2,6,12,-97.09226227,31.80267906
231,"WEST VALLEY CITY UT",11,3,0,1,2,3,-111.9695816,40.69639969
231,"WEST WARWICK RI",11,47,14,17,16,47,-71.5218811,41.70644379
231,"WESTBOROUGH MA",11,3,1,0,2,3,-71.61507416,42.26956177
231,"WESTBROOK ME",11,1,0,0,1,1,-70.37012482,43.67708588
231,"WESTCHESTER IL",11,1,0,0,1,1,-87.88202667,41.85084534
231,"WESTERLY RI",11,2,0,1,1,2,-71.82659149,41.37784958
231,"WESTERVILLE OH",11,23,3,6,14,23,-82.92906952,40.12620926
231,"WESTFIELD IN",11,11,4,2,5,11,-86.12757111,40.04309464
231,"WESTFIELD MA",11,2,1,0,1,2,-72.74882507,42.12547302
231,"WESTFIELD NJ",11,25,11,7,7,25,-74.34671783,40.65938187
231,"WESTFIELD NY",11,1,0,1,0,1,-79.57750702,42.32229996
231,"WESTLAKE OH",11,3,0,0,3,3,-81.91750336,41.45558167
231,"WESTLAND MI",11,7,2,3,2,7,-83.39988708,42.32430649
231,"WESTMINSTER CO",11,8,3,3,2,8,-105.0385208,39.83644867
231,"WESTMINSTER MD",11,12,4,2,6,12,-76.99542999,39.57574463
231,"WESTMONT IL",11,2,1,1,0,2,-87.97566223,41.79613113
231,"WESTMORELAND TN",11,2,1,0,1,2,-86.24802399,36.56184006
231,"WESTPORT NY",11,9,2,1,6,9,-73.43728638,44.18396759
231,"WHEAT RIDGE CO",11,3,0,1,2,3,-105.0783615,39.76603317
231,"WHEATON IL",11,14,3,4,7,14,-88.10729218,41.86618805
231,"WHEELER TX",11,1,0,1,0,1,-100.2721405,35.44525528
231,"WHEELING IL",11,3,2,0,1,3,-87.92919159,42.13937759
231,"WHEELING WV",11,21,6,2,13,21,-80.7192688,40.06991577
231,"WHITE BEAR LAKE MN",11,3,1,0,2,3,-93.01039886,45.08457947
231,"WHITE HOUSE TN",11,3,2,0,1,3,-86.65110016,36.47054672
231,"WHITE PLAINS NY",11,18,7,4,7,18,-73.76217651,41.03399658
231,"WHITE RIVER SD",11,1,1,0,0,1,-100.7463379,43.56811142
231,"WHITEFISH MT",11,1,0,0,1,1,-114.3380127,48.41337967
231,"WHITESBURG KY",11,3,0,2,1,3,-82.82665253,37.11859894
231,"WHITEWATER WI",11,4,1,1,2,4,-88.73226166,42.83348846
231,"WHITMAN MA",11,2,0,2,0,2,-70.93466187,42.0807991
231,"WHITNEY POINT NY",11,1,0,1,0,1,-75.96672058,42.32924271
231,"WHITTIER CA",11,20,6,7,7,20,-118.0349197,33.9793129
231,"WICHITA FALLS TX",11,33,4,18,11,33,-98.49403381,33.91383743
231,"WICHITA KS",11,174,43,67,64,174,-97.3383255,37.69230652
231,"WILDOMAR CA",11,1,0,0,1,1,-117.2806625,33.59801483
231,"WILKES-BARRE PA",11,13,1,8,4,13,-75.88058472,41.24601746
231,"WILKINSBURG PA",11,22,8,5,9,22,-79.88179016,40.44174194
231,"WILLIAMS CA",11,7,2,4,1,7,-122.151535,39.15454483
231,"WILLIAMSBURG VA",11,24,4,8,12,24,-76.70659637,37.27114868
231,"WILLIAMSON GA",11,1,0,0,1,1,-84.36169434,33.18276215
231,"WILLIAMSPORT PA",11,18,6,4,8,18,-77.00060272,41.24121475
231,"WILLIAMSTOWN KY",11,1,0,1,0,1,-84.56015778,38.63843536
231,"WILLIAMSTOWN MA",11,8,1,4,3,8,-73.21173859,42.70910263
231,"WILLIAMSVILLE NY",11,3,1,1,1,3,-78.73756409,42.96403885
231,"WILLINGBORO NJ",11,10,4,1,5,10,-74.86815643,40.02816391
231,"WILLISTON ND",11,12,3,0,9,12,-103.6307449,48.14650726
231,"WILLITS CA",11,1,1,0,0,1,-123.3572464,39.40924072
231,"WILLMAR MN",11,2,1,0,1,2,-95.04427338,45.12181473
231,"WILLOUGHBY HILLS OH",11,1,0,1,0,1,-81.41830444,41.598526
231,"WILLOUGHBY OH",11,4,0,1,3,4,-81.40597534,41.63972092
231,"WILMETTE IL",11,1,0,0,1,1,-87.72296143,42.07221222
231,"WILMINGTON DE",11,69,19,16,34,69,-75.54558563,39.74601364
231,"WILMINGTON MA",11,1,0,0,1,1,-71.17237091,42.54682159
231,"WILMINGTON NC",11,80,27,23,30,80,-77.94431305,34.22592926
231,"WILMINGTON OH",11,1,1,0,0,1,-83.82820892,39.44527435
231,"WILSON NC",11,3,0,1,2,3,-77.914711,35.72143173
231,"WILSONVILLE OR",11,3,2,0,1,3,-122.7757416,45.29935455
231,"WINCHESTER VA",11,18,8,4,6,18,-78.16301727,39.18608475
231,"WINDER GA",11,11,1,3,7,11,-83.71982574,33.99271393
231,"WINDERMERE FL",11,13,4,3,6,13,-81.53463745,28.49615097
231,"WINDSOR CO",11,1,0,0,1,1,-104.9023056,40.47741699
231,"WINDSOR MO",11,15,6,2,7,15,-93.5224762,38.53234863
231,"WINDSOR VT",11,1,0,0,1,1,-72.38378906,43.48069
231,"WINFIELD KS",11,3,1,0,2,3,-96.9961853,37.23976898
231,"WINFIELD MO",11,5,2,2,1,5,-90.73840332,38.99734879
231,"WINNEMUCCA NV",11,1,0,0,1,1,-117.7377853,40.97271347
231,"WINNETKA IL",11,1,0,0,1,1,-87.73626709,42.10827255
231,"WINONA MN",11,10,2,3,5,10,-91.63965607,44.04986572
231,"WINSTON-SALEM NC",11,99,26,30,43,99,-80.24356842,36.1001091
231,"WINTER PARK CO",11,4,0,1,3,4,-105.7649307,39.89161301
231,"WINTER PARK FL",11,51,16,11,24,51,-81.33872223,28.6003685
231,"WINTERS CA",11,2,1,0,1,2,-121.9734039,38.52486038
231,"WITT IL",11,1,0,1,0,1,-89.34815216,39.2564888
231,"WOBURN MA",11,4,3,1,0,4,-71.15155029,42.47951508
231,"WOODBURN OR",11,1,0,0,1,1,-122.8577652,45.14351273
231,"WOODBURY MN",11,11,3,2,6,11,-92.95999908,44.92368698
231,"WOODINVILLE WA",11,3,1,2,0,3,-122.1656876,47.75372314
231,"WOODLAND CA",11,10,1,1,8,10,-121.7751541,38.67827225
231,"WOODRIDGE IL",11,3,2,1,0,3,-88.05056763,41.74704742
231,"WOODSIDE CA",11,1,1,0,0,1,-122.2564316,37.42977905
231,"WOODSTOCK GA",11,6,2,2,2,6,-84.51925659,34.10178375
231,"WOODSTOCK VA",11,1,0,0,1,1,-78.50556183,38.88199234
231,"WOODSTOCK VT",11,2,0,1,1,2,-72.51759338,43.62456131
231,"WOODSTOWN NJ",11,1,0,0,1,1,-75.32749939,39.65195465
231,"WOONSOCKET RI",11,3,1,2,0,3,-71.51394653,42.00294876
231,"WOOSTER OH",11,17,6,2,9,17,-81.93497467,40.80502319
231,"WORCESTER MA",11,77,24,20,33,77,-71.801651,42.26288986
231,"WORTH IL",11,1,1,0,0,1,-87.79718018,41.68992233
231,"WORTHINGTON OH",11,6,0,4,2,6,-83.01785278,40.09322739
231,"WRIGHT CITY MO",11,2,2,0,0,2,-91.02021027,38.82786942
231,"WYANDOTTE MI",11,3,1,2,0,3,-83.15003204,42.21445465
231,"WYLIE TX",11,4,2,0,2,4,-96.5396347,33.01520157
231,"WYOMING DE",11,2,1,0,1,2,-75.55825043,39.11818314
231,"WYOMING MI",11,8,2,2,4,8,-85.70549011,42.9133873
231,"WYOMING MN",11,3,0,0,3,3,-92.99753571,45.33620453
231,"XENIA OH",11,1,1,0,0,1,-83.92948151,39.68489075
231,"YAKIMA WA",11,17,4,4,9,17,-120.508812,46.60157394
231,"YANKTON SD",11,1,0,0,1,1,-97.39076233,42.8748703
231,"YELLOW SPRINGS OH",11,1,0,1,0,1,-83.88698578,39.80642319
231,"YOAKUM TX",11,2,2,0,0,2,-97.15248108,29.2883358
231,"YODER KS",11,1,0,1,0,1,-97.86899567,37.94051361
231,"YONKERS NY",11,27,9,8,10,27,-73.89792633,40.93142319
231,"YORBA LINDA CA",11,9,1,6,2,9,-117.8147278,33.88856888
231,"YORK PA",11,35,13,9,13,35,-76.72687531,39.96264267
231,"YOUNGSTOWN OH",11,825,199,175,451,825,-80.64901733,41.1000061
231,"YOUNGSVILLE NC",11,1,0,1,0,1,-78.47360992,36.02531433
231,"YOUNTVILLE CA",11,1,0,0,1,1,-122.3634491,38.40127182
231,"YPSILANTI MI",11,85,23,32,30,85,-83.61315155,42.24105453
231,"YREKA CA",11,2,0,2,0,2,-122.6363983,41.73524094
231,"YUBA CITY CA",11,3,0,0,3,3,-121.6193237,39.14025497
231,"YUCAIPA CA",11,23,7,7,9,23,-117.0447998,34.03347397
231,"YUKON OK",11,5,3,0,2,5,-97.76316071,35.50673294
231,"YUMA AZ",11,4,1,2,1,4,-114.6262665,32.72531128
231,"YUMA CO",11,4,2,0,2,4,-102.7258301,40.12628937
231,"ZANESVILLE OH",11,7,3,2,2,7,-82.01314545,39.94056702
231,"ZEBULON NC",11,1,0,0,1,1,-78.31421661,35.82442474
231,"ZEELAND MI",11,1,1,0,0,1,-86.01843262,42.812603
231,"ZEPHYRHILLS FL",11,1,0,0,1,1,-82.18080902,28.2341938
231,"ZIONSVILLE IN",11,11,2,2,7,11,-86.26182556,39.95092773
232,"ABILENE KS",12,2,2,0,0,2,-97.21461487,38.9171524
232,"ABILENE TX",12,12,2,8,2,12,-99.73384094,32.44894028
232,"ACWORTH GA",12,2,0,0,2,2,-84.67662811,34.06597519
232,"ADA OK",12,2,2,0,0,2,-96.67899323,34.77481842
232,"ADAMS MA",12,2,0,0,2,2,-73.1167984,42.62440872
232,"ADDISON TX",12,2,0,2,0,2,-96.82976532,32.96215057
232,"AKRON OH",12,6,0,2,4,6,-81.51885223,41.08151627
232,"ALAMEDA CA",12,2,0,0,2,2,-122.2444763,37.76513672
232,"ALAMOGORDO NM",12,2,2,0,0,2,-105.9584656,32.90003967
232,"ALBANY NY",12,8,4,4,0,8,-73.75520325,42.6529007
232,"ALBUQUERQUE NM",12,72,14,18,40,72,-106.6517639,35.08336639
232,"ALEXANDRIA IN",12,2,0,0,2,2,-85.67569733,40.2626915
232,"ALEXANDRIA VA",12,24,6,8,10,24,-77.04605103,38.80503082
232,"ALLEN TX",12,2,2,0,0,2,-96.67116547,33.10336685
232,"ALLENTOWN PA",12,4,2,0,2,4,-75.46569824,40.60851288
232,"ALPHARETTA GA",12,2,2,0,0,2,-84.29410553,34.07542419
232,"ALTO TX",12,2,2,0,0,2,-95.07303619,31.65087509
232,"AMARILLO TX",12,8,2,2,4,8,-101.8324051,35.22210312
232,"AMES IA",12,12,6,0,6,12,-93.61370087,42.02269363
232,"AMHERST MA",12,2,2,0,0,2,-72.5192337,42.37371826
232,"ANAHEIM CA",12,14,2,6,6,14,-117.9165115,33.8354454
232,"ANCHORAGE AK",12,4,2,0,2,4,-149.8811951,61.21649933
232,"ANDERSON IN",12,2,0,0,2,2,-85.68051147,40.1053772
232,"ANDERSON SC",12,2,0,0,2,2,-82.65641785,34.50934219
232,"ANN ARBOR MI",12,20,4,4,12,20,-83.74536896,42.28347015
232,"ANNAPOLIS MD",12,2,0,0,2,2,-76.49166107,38.97844696
232,"ANTIOCH CA",12,2,0,2,0,2,-121.808136,38.0049057
232,"APEX NC",12,2,0,0,2,2,-78.84952545,35.73279572
232,"ARCHER FL",12,6,4,0,2,6,-82.51840973,29.53064919
232,"ARLINGTON TN",12,2,0,0,2,2,-89.66139984,35.29637527
232,"ARLINGTON TX",12,18,4,4,10,18,-97.10882568,32.73590469
232,"ASBURY PARK NJ",12,2,0,0,2,2,-74.01100159,40.22047806
232,"ASHEVILLE NC",12,28,10,2,16,28,-82.55367279,35.60134888
232,"ASHLAND OR",12,2,0,2,0,2,-122.7111359,42.19425583
232,"ASHLAND VA",12,2,0,2,0,2,-77.47959137,37.75937653
232,"ASKOV MN",12,4,0,0,4,4,-92.78282928,46.18641281
232,"ATHENS OH",12,2,0,0,2,2,-82.10113525,39.32934952
232,"ATLANTA GA",12,446,124,86,236,446,-84.38757324,33.74927521
232,"ATTLEBORO MA",12,2,0,0,2,2,-71.28439331,41.94469833
232,"AUBURN CA",12,14,4,2,8,14,-121.0794067,38.89623642
232,"AUBURN ME",12,2,0,2,0,2,-70.23028564,44.09794235
232,"AUBURN WA",12,6,2,2,2,6,-122.2304688,47.30677795
232,"AURORA CO",12,4,2,0,2,4,-104.8693161,39.73983765
232,"AUSTELL GA",12,4,0,2,2,4,-84.63414001,33.81290054
232,"AUSTIN TX",12,236,112,54,70,236,-97.74386597,30.26748466
232,"AUSTINTOWN OH",12,2,0,2,0,2,-80.76424408,41.10162354
232,"AZUSA CA",12,2,2,0,0,2,-117.9098816,34.13357544
232,"BAKERSFIELD CA",12,4,0,2,2,4,-119.0206375,35.37326813
232,"BALDWYN MS",12,4,0,0,4,4,-88.63553619,34.5099411
232,"BALTIMORE MD",12,120,48,18,54,120,-76.6115799,39.29075623
232,"BANGOR ME",12,2,0,2,0,2,-68.77653503,44.80109406
232,"BATON ROUGE LA",12,28,8,6,14,28,-91.15479279,30.45132256
232,"BAXTER SPRINGS KS",12,2,0,0,2,2,-94.73813629,37.02472305
232,"BAY VILLAGE OH",12,6,0,2,4,6,-81.92155457,41.48464966
232,"BAYTOWN TX",12,2,2,0,0,2,-94.97782135,29.73608589
232,"BEACON NY",12,4,2,2,0,4,-73.9688797,41.50502014
232,"BEAUFORT SC",12,2,2,0,0,2,-80.68718719,32.44019699
232,"BEAUMONT TX",12,4,2,0,2,4,-94.10238647,30.08622551
232,"BEL AIR MD",12,2,0,0,2,2,-76.34788513,39.53611374
232,"BELLEVILLE IL",12,10,2,2,6,10,-89.98438263,38.52002716
232,"BELLEVUE WA",12,8,2,2,4,8,-122.2029648,47.61014557
232,"BELLFLOWER CA",12,2,0,0,2,2,-118.1186295,33.88169479
232,"BELLINGHAM WA",12,18,10,4,4,18,-122.4727402,48.76121521
232,"BELLMAWR NJ",12,2,0,0,2,2,-75.09385681,39.86771774
232,"BEMIDJI MN",12,2,2,0,0,2,-94.88105774,47.47352982
232,"BEND OR",12,10,0,2,8,10,-121.3171387,44.0577774
232,"BERKELEY CA",12,44,12,6,26,44,-122.2752533,37.87145615
232,"BERRIEN SPRINGS MI",12,40,16,8,16,40,-86.33900452,41.94654846
232,"BESSEMER AL",12,4,0,2,2,4,-86.95465851,33.40222549
232,"BEVERLY HILLS CA",12,8,4,0,4,8,-118.4019775,34.07383347
232,"BILLINGS MT",12,2,2,0,0,2,-108.504631,45.7833786
232,"BINGHAMTON NY",12,6,0,4,2,6,-75.91755676,42.0986557
232,"BIRDSBORO PA",12,4,0,4,0,4,-75.80335236,40.26465225
232,"BIRMINGHAM AL",12,38,14,8,16,38,-86.80226898,33.52098846
232,"BLACK MOUNTAIN NC",12,4,0,2,2,4,-82.32103729,35.61796188
232,"BLOOMINGBURG OH",12,2,0,0,2,2,-83.39527893,39.60507202
232,"BLOOMINGTON IL",12,2,2,0,0,2,-88.99375916,40.48418045
232,"BLOOMINGTON IN",12,48,14,12,22,48,-86.53382874,39.16920471
232,"BOCA RATON FL",12,18,4,6,8,18,-80.08280182,26.35960197
232,"BONITA SPRINGS FL",12,10,2,2,6,10,-81.77822876,26.34039497
232,"BOSTON MA",12,256,74,60,122,256,-71.05905151,42.35883713
232,"BOULDER CO",12,22,4,4,14,22,-105.2715302,40.01483917
232,"BOWLING GREEN KY",12,2,0,2,0,2,-86.4437027,36.99057388
232,"BOWLING GREEN OH",12,4,2,0,2,4,-83.65102386,41.37505341
232,"BOYNTON BEACH FL",12,2,2,0,0,2,-80.066185,26.52592087
232,"BOZEMAN MT",12,2,0,2,0,2,-111.0471649,45.6803093
232,"BRADENTON FL",12,6,0,0,6,6,-82.57459259,27.49969101
232,"BRADLEY IL",12,2,0,0,2,2,-87.86099243,41.14196014
232,"BRANDON MS",12,4,2,0,2,4,-89.98616028,32.27327728
232,"BRIDGEPORT CT",12,6,2,2,2,6,-73.2040863,41.16743088
232,"BRISTOL CT",12,2,0,0,2,2,-72.94853973,41.67193222
232,"BRISTOL TN",12,6,2,0,4,6,-82.17338562,36.58886719
232,"BROKEN ARROW OK",12,2,0,2,0,2,-95.79160309,36.05273056
232,"BROOKLINE MA",12,2,0,0,2,2,-71.12002563,42.33176804
232,"BROOMFIELD CO",12,2,0,2,0,2,-105.0877686,39.92069244
232,"BROUSSARD LA",12,2,0,0,2,2,-91.96131134,30.14761353
232,"BUFFALO NY",12,70,26,12,32,70,-78.87787628,42.8867836
232,"BURBANK CA",12,2,0,0,2,2,-118.3104782,34.18065262
232,"BURLINGTON VT",12,14,2,4,8,14,-73.20542908,44.47687531
232,"CAIRO GA",12,2,0,2,0,2,-84.20102692,30.87791824
232,"CALABASAS CA",12,2,0,0,2,2,-118.6473236,34.1558876
232,"CALHOUN GA",12,2,0,2,0,2,-84.95102692,34.50297165
232,"CAMARILLO CA",12,4,4,0,0,4,-119.0400391,34.21628952
232,"CAMBRIDGE MA",12,10,2,4,4,10,-71.10369873,42.36532593
232,"CAMBRIDGE OH",12,6,2,2,2,6,-81.58615875,40.02525711
232,"CAMDEN NJ",12,8,4,2,2,8,-75.118927,39.92608261
232,"CANANDAIGUA NY",12,2,2,0,0,2,-77.28107452,42.88830948
232,"CANTON GA",12,2,0,0,2,2,-84.48571014,34.23356628
232,"CAPE GIRARDEAU MO",12,4,2,2,0,4,-89.51838684,37.30613327
232,"CAPE MAY NJ",12,4,2,0,2,4,-74.90522766,38.93513107
232,"CARBONDALE IL",12,6,2,2,2,6,-89.2168808,37.7274704
232,"CARLSBAD CA",12,4,2,2,0,4,-117.3528137,33.1580162
232,"CARMEL IN",12,2,0,0,2,2,-86.12607574,39.97961426
232,"CARRBORO NC",12,2,0,0,2,2,-79.07286835,35.91213989
232,"CARY NC",12,2,0,0,2,2,-78.78055573,35.79200745
232,"CASCADE LOCKS OR",12,2,2,0,0,2,-121.8928452,45.66971588
232,"CASTLE ROCK CO",12,2,2,0,0,2,-104.857811,39.37207031
232,"CATHEDRAL CITY CA",12,2,0,2,0,2,-116.4663467,33.77960205
232,"CEDAR PARK TX",12,2,0,0,2,2,-97.82061005,30.50554466
232,"CHANDLER AZ",12,2,2,0,0,2,-111.8428345,33.3062439
232,"CHAPEL HILL NC",12,8,0,4,4,8,-79.05697632,35.91110611
232,"CHARLESTON SC",12,30,6,10,14,30,-79.93032074,32.77671814
232,"CHARLESTON WV",12,56,20,10,26,56,-81.63149261,38.34872055
232,"CHARLOTTE NC",12,126,36,26,64,126,-80.84257507,35.22746277
232,"CHARLOTTESVILLE VA",12,14,10,4,0,14,-78.49123383,38.03798676
232,"CHATTANOOGA TN",12,4,0,2,2,4,-85.30583954,35.04058456
232,"CHESAPEAKE VA",12,2,2,0,0,2,-76.27422333,36.81948853
232,"CHESTER PA",12,2,2,0,0,2,-75.35475159,39.84973145
232,"CHESTERFIELD MO",12,2,2,0,0,2,-90.5772934,38.6631279
232,"CHEYENNE WY",12,2,0,2,0,2,-104.8183899,41.13345718
232,"CHICAGO IL",12,466,136,114,216,466,-87.6503067,41.85000992
232,"CHICO CA",12,8,0,0,8,8,-121.839447,39.72846222
232,"CHULA VISTA CA",12,6,4,0,2,6,-117.0857468,32.64037704
232,"CINCINNATI OH",12,38,8,8,22,38,-84.51939392,39.10413742
232,"CLAIRTON PA",12,2,2,0,0,2,-79.88103485,40.2925148
232,"CLAREMONT CA",12,2,0,0,2,2,-117.7214508,34.09675217
232,"CLARKSVILLE TN",12,12,2,6,4,12,-87.35944366,36.52993011
232,"CLEARWATER FL",12,2,0,0,2,2,-82.79984283,27.9665451
232,"CLEVELAND HEIGHTS OH",12,2,2,0,0,2,-81.55568695,41.52017975
232,"CLEVELAND OH",12,216,70,52,94,216,-81.69516754,41.49978256
232,"CLEVELAND TX",12,2,2,0,0,2,-95.08600616,30.34188652
232,"CLIFTON NJ",12,2,2,0,0,2,-74.16278076,40.85860062
232,"CLINTON SC",12,2,0,2,0,2,-81.88014984,34.47286224
232,"CLIVE IA",12,2,2,0,0,2,-93.72477722,41.60302734
232,"COEUR D'ALENE ID",12,2,0,0,2,2,-116.781929,47.67768478
232,"COLD SPRING NY",12,2,0,0,2,2,-73.9535675,41.42040253
232,"COLLEGE PARK GA",12,6,4,2,0,6,-84.44933319,33.65347672
232,"COLLEGE PARK MD",12,16,2,0,14,16,-76.93619537,38.98080444
232,"COLLEGE STATION TX",12,20,10,4,6,20,-96.33758545,30.62316895
232,"COLLEGEVILLE PA",12,2,0,0,2,2,-75.4506073,40.18598557
232,"COLLINGSWOOD NJ",12,2,2,0,0,2,-75.07028961,39.9186058
232,"COLMA CA",12,2,0,0,2,2,-122.4610977,37.67665482
232,"COLOMA MI",12,2,0,0,2,2,-86.30813599,42.18628693
232,"COLORADO SPRINGS CO",12,8,4,0,4,8,-104.8225174,38.83369446
232,"COLUMBIA MO",12,12,2,6,4,12,-92.33429718,38.95169067
232,"COLUMBIA SC",12,28,6,6,16,28,-81.04045105,34.00138855
232,"COLUMBIA TN",12,48,10,24,14,48,-87.03533173,35.61502457
232,"COLUMBUS GA",12,18,2,6,10,18,-84.98313141,32.46828842
232,"COLUMBUS IN",12,2,0,0,2,2,-85.92284393,39.20959473
232,"COLUMBUS OH",12,96,24,26,46,96,-82.99890137,39.96136475
232,"COMMERCE TX",12,2,0,2,0,2,-95.90060425,33.24729538
232,"COMPTON CA",12,2,0,0,2,2,-118.2218704,33.89606857
232,"CONCORD CA",12,2,0,0,2,2,-122.0333328,37.97780228
232,"CONYERS GA",12,2,0,0,2,2,-84.0175705,33.66764832
232,"CORAL GABLES FL",12,4,0,2,2,4,-80.26779938,25.72242165
232,"CORINTH MS",12,4,0,4,0,4,-88.52302551,34.93960571
232,"CORONA CA",12,4,2,0,2,4,-117.5688171,33.87516785
232,"CORPUS CHRISTI TX",12,2,2,0,0,2,-97.42076874,27.77859879
232,"CORTE MADERA CA",12,12,0,8,4,12,-122.5294342,37.9252739
232,"CORVALLIS OR",12,4,0,2,2,4,-123.2646637,44.56417084
232,"COSTA MESA CA",12,2,0,0,2,2,-117.9204407,33.64131927
232,"COTATI CA",12,2,0,0,2,2,-122.7091904,38.32655334
232,"COTTAGE GROVE MN",12,2,0,0,2,2,-92.88017273,44.842556
232,"COVINGTON OH",12,2,0,0,2,2,-84.35377502,40.12005997
232,"CRESTVIEW FL",12,4,0,0,4,4,-86.57064819,30.76231766
232,"CREWE VA",12,12,6,6,0,12,-78.12284088,37.17355728
232,"CROWN POINT IN",12,2,2,0,0,2,-87.36541748,41.41695023
232,"CRYSTAL LAKE IL",12,2,0,0,2,2,-88.3161087,42.2411499
232,"CUBA MO",12,2,0,0,2,2,-91.40387726,38.06311035
232,"CUPERTINO CA",12,2,0,0,2,2,-122.0342026,37.32306671
232,"DADEVILLE AL",12,2,0,0,2,2,-85.76355743,32.83142853
232,"DALLAS TX",12,230,66,64,100,230,-96.80088043,32.78369904
232,"DALTON GA",12,2,2,0,0,2,-84.97008514,34.76976776
232,"DANBURY CT",12,2,0,0,2,2,-73.45310974,41.39499664
232,"DANDRIDGE TN",12,2,0,2,0,2,-83.41452026,36.0157814
232,"DAVIS CA",12,4,0,4,0,4,-121.7421722,38.54467773
232,"DAWSONVILLE GA",12,2,0,2,0,2,-84.11881256,34.42126083
232,"DAYTON OH",12,40,8,10,22,40,-84.19126892,39.75915146
232,"DAYTONA BEACH FL",12,2,0,0,2,2,-81.02253723,29.21147537
232,"DEARBORN MI",12,2,0,2,0,2,-83.1758728,42.32239914
232,"DECATUR GA",12,32,14,8,10,32,-84.29631805,33.77489471
232,"DECATUR IL",12,2,0,2,0,2,-88.95516968,39.84060287
232,"DELRAY BEACH FL",12,4,4,0,0,4,-80.07209778,26.46233368
232,"DELTONA FL",12,4,4,0,0,4,-81.25521088,28.90277863
232,"DENTON TX",12,12,4,2,6,12,-97.13349915,33.21514893
232,"DENVER CO",12,136,44,34,58,136,-104.9853745,39.73901749
232,"DENVILLE NJ",12,2,0,2,0,2,-74.47631836,40.89261246
232,"DES MOINES IA",12,10,0,4,6,10,-93.6210022,41.59817123
232,"DES PLAINES IL",12,2,0,0,2,2,-87.8833847,42.03343964
232,"DESTIN FL",12,18,2,6,10,18,-86.49551392,30.39405632
232,"DETROIT MI",12,118,40,20,58,118,-83.04567719,42.33172226
232,"DIETERICH IL",12,2,2,0,0,2,-88.3795929,39.06205368
232,"DONIPHAN MO",12,2,2,0,0,2,-90.82394409,36.62110138
232,"DOVER DE",12,4,4,0,0,4,-75.52090454,39.15853882
232,"DOYLESTOWN PA",12,6,2,2,2,6,-75.1292038,40.31054688
232,"DUBLIN VA",12,2,2,0,0,2,-80.68517303,37.10611343
232,"DUBUQUE IA",12,10,4,4,2,10,-90.67155457,42.51130295
232,"DULUTH MN",12,2,0,2,0,2,-92.10697174,46.78300858
232,"DUNCANVILLE TX",12,2,0,0,2,2,-96.9091568,32.65229034
232,"DUNEDIN FL",12,2,0,2,0,2,-82.77127838,28.02050591
232,"DURHAM NC",12,44,16,14,14,44,-78.89787292,35.99412918
232,"DYERSBURG TN",12,2,0,0,2,2,-89.38568878,36.03469849
232,"EAGAN MN",12,2,0,0,2,2,-93.16746521,44.80387878
232,"EAGLE LAKE MN",12,2,0,0,2,2,-93.88172913,44.16489792
232,"EAST LANSING MI",12,2,2,0,0,2,-84.48403931,42.73703384
232,"EAST ORANGE NJ",12,2,2,0,0,2,-74.21418762,40.76618958
232,"EAST PALO ALTO CA",12,2,0,0,2,2,-122.143013,37.46857452
232,"EAST POINT GA",12,2,2,0,0,2,-84.43933868,33.67996979
232,"EAST PROVIDENCE RI",12,2,2,0,0,2,-71.36916351,41.81398392
232,"EASTON PA",12,6,0,2,4,6,-75.21966553,40.68871689
232,"EDINA MN",12,2,2,0,0,2,-93.34928131,44.91236496
232,"EDINBORO PA",12,20,6,4,10,20,-80.13100433,41.87437439
232,"EDMOND OK",12,2,2,0,0,2,-97.48453522,35.65326309
232,"EDWARDSVILLE IL",12,10,0,6,4,10,-89.95322418,38.8115654
232,"EL MONTE CA",12,2,0,2,0,2,-118.0298996,34.06880569
232,"EL PASO TX",12,4,2,0,2,4,-106.4620514,31.78388405
232,"EL SEGUNDO CA",12,2,0,0,2,2,-118.4185257,33.91943741
232,"ELGIN IL",12,6,4,0,2,6,-88.28123474,42.03733444
232,"ELIZABETH NJ",12,4,0,0,4,4,-74.21881866,40.66823578
232,"ELK GROVE CA",12,38,8,8,22,38,-121.3743591,38.40848923
232,"ELMIRA NY",12,4,0,0,4,4,-76.80737305,42.08998108
232,"ENCINITAS CA",12,2,2,0,0,2,-117.2937012,33.0371666
232,"EUGENE OR",12,30,12,6,12,30,-123.0898361,44.05194855
232,"EVANSTON IL",12,2,0,0,2,2,-87.69037628,42.04132843
232,"EVANSVILLE IN",12,4,0,0,4,4,-87.56850433,37.97795486
232,"EVERETT WA",12,4,0,0,4,4,-122.2045441,47.97843552
232,"EXETER NH",12,2,2,0,0,2,-70.95800781,42.98471451
232,"FAIRBANKS AK",12,6,4,2,0,6,-147.7185669,64.83367157
232,"FAIRFAX VA",12,4,0,2,2,4,-77.30588531,38.84661865
232,"FALLS CHURCH VA",12,6,2,0,4,6,-77.17056274,38.88268661
232,"FARGO ND",12,4,2,0,2,4,-96.79805756,46.87498474
232,"FARMINGTON HILLS MI",12,6,2,0,4,6,-83.3771286,42.48558807
232,"FAYETTEVILLE AR",12,2,0,2,0,2,-94.15759277,36.06256104
232,"FAYETTEVILLE NC",12,8,2,4,2,8,-78.87771606,35.05313873
232,"FAYETTEVILLE TN",12,2,0,0,2,2,-86.57073212,35.15206146
232,"FENTON MO",12,6,0,2,4,6,-90.43593597,38.51305771
232,"FERGUSON MO",12,30,12,4,14,30,-90.306633,38.74429321
232,"FERNDALE MI",12,16,6,2,8,16,-83.13441467,42.46089172
232,"FIREBAUGH CA",12,2,0,0,2,2,-120.4577408,36.85879517
232,"FISHERS IN",12,2,0,0,2,2,-86.0140152,39.95565414
232,"FLAGLER BEACH FL",12,2,0,0,2,2,-81.12680054,29.47527695
232,"FLAGSTAFF AZ",12,4,0,4,0,4,-111.6533051,35.19802475
232,"FLINT MI",12,6,4,2,0,6,-83.68744659,43.01246643
232,"FLORENCE AL",12,8,0,0,8,8,-87.67726898,34.7997818
232,"FLORENCE CO",12,6,2,0,4,6,-105.119751,38.39019012
232,"FLORESVILLE TX",12,2,0,0,2,2,-98.15641022,29.13393784
232,"FLORISSANT MO",12,16,6,0,10,16,-90.32299042,38.78946304
232,"FLUSHING MI",12,2,0,0,2,2,-83.85099792,43.06319427
232,"FORSYTH MO",12,2,0,0,2,2,-93.120224,36.68517685
232,"FORT COLLINS CO",12,10,2,2,6,10,-105.0858688,40.58546066
232,"FORT LAUDERDALE FL",12,12,4,6,2,12,-80.14283752,26.12309074
232,"FORT MILL SC",12,4,4,0,0,4,-80.94496155,35.00762558
232,"FORT MYERS FL",12,4,2,2,0,4,-81.87184143,26.64133644
232,"FORT WAYNE IN",12,8,0,0,8,8,-85.13967896,41.07278061
232,"FORT WORTH TX",12,26,10,2,14,26,-97.32135773,32.72562027
232,"FOUKE AR",12,2,0,2,0,2,-93.88582611,33.26132202
232,"FRANKFORT KY",12,6,4,0,2,6,-84.87322235,38.20124054
232,"FRANKLIN TN",12,2,0,0,2,2,-86.87760162,35.92164993
232,"FREDERICK MD",12,6,2,4,0,6,-77.40981293,39.41444397
232,"FREEPORT IL",12,2,0,0,2,2,-89.62126923,42.29691696
232,"FREMONT CA",12,16,4,0,12,16,-121.9740372,37.55101776
232,"FRESNO CA",12,4,0,0,4,4,-119.7739868,36.74755478
232,"FRISCO TX",12,2,0,0,2,2,-96.82434082,33.15098572
232,"GAINESVILLE FL",12,32,6,6,20,32,-82.32462311,29.65203285
232,"GAITHERSBURG MD",12,6,0,0,6,6,-77.20072174,39.14352417
232,"GARDEN GROVE CA",12,2,2,0,0,2,-117.943718,33.77397156
232,"GARDENA CA",12,2,2,0,0,2,-118.3105164,33.88837814
232,"GARY IN",12,4,0,4,0,4,-87.33873749,41.59325409
232,"GASTONIA NC",12,2,0,2,0,2,-81.18706512,35.26216507
232,"GAYLORD MI",12,4,0,4,0,4,-84.67483521,45.02762222
232,"GENOA CITY WI",12,2,0,0,2,2,-88.32978821,42.49824905
232,"GERMANTOWN TN",12,2,0,0,2,2,-89.80731201,35.08958817
232,"GIG HARBOR WA",12,16,8,6,2,16,-122.590683,47.32983398
232,"GILBERT AZ",12,4,2,2,0,4,-111.7899933,33.35302353
232,"GLEN ALPINE NC",12,2,2,0,0,2,-81.77864838,35.729496
232,"GLEN ROSE TX",12,2,2,0,0,2,-97.7556839,32.23469162
232,"GLENDALE AZ",12,2,0,2,0,2,-112.1871796,33.5386467
232,"GLOUCESTER MA",12,2,0,0,2,2,-70.66117096,42.61589432
232,"GOODRICH TX",12,2,2,0,0,2,-94.9467926,30.60574341
232,"GRAHAM NC",12,2,0,0,2,2,-79.39993286,36.06936646
232,"GRANBURY TX",12,2,0,2,0,2,-97.79492187,32.44239044
232,"GRAND BLANC MI",12,2,0,0,2,2,-83.62955475,42.92750168
232,"GRAND FORKS ND",12,8,0,2,6,8,-97.03855133,47.92044067
232,"GRAND PRAIRIE TX",12,4,2,2,0,4,-96.99823761,32.74625015
232,"GRAND RAPIDS MI",12,14,8,4,2,14,-85.66797638,42.96317291
232,"GRANITE CITY IL",12,12,4,2,6,12,-90.14891815,38.70147705
232,"GREAT BEND KS",12,2,0,0,2,2,-98.76521301,38.36428452
232,"GREEN BAY WI",12,6,2,0,4,6,-88.01370239,44.51335907
232,"GREENBELT MD",12,8,2,4,2,8,-76.87561035,39.00544357
232,"GREENEVILLE TN",12,2,0,2,0,2,-82.83133698,36.16376495
232,"GREENSBORO NC",12,20,0,4,16,20,-79.79152679,36.0729599
232,"GREENVILLE MS",12,18,14,2,2,18,-91.05704498,33.40253448
232,"GREENVILLE NC",12,4,2,2,0,4,-77.37215424,35.61170959
232,"GREENVILLE SC",12,24,4,6,14,24,-82.39870453,34.84753418
232,"GREENWICH CT",12,2,0,0,2,2,-73.62783051,41.02645111
232,"GREENWOOD MS",12,2,2,0,0,2,-90.17974091,33.51645279
232,"GULF SHORES AL",12,2,0,2,0,2,-87.70103455,30.24625969
232,"HACKLEBURG AL",12,2,0,2,0,2,-87.82893372,34.27754211
232,"HAMILTON OH",12,2,0,2,0,2,-84.56098175,39.39949799
232,"HAMPTON VA",12,10,4,2,4,10,-76.34473419,37.03002548
232,"HANOVER PA",12,2,2,0,0,2,-76.98248291,39.80073929
232,"HARLINGEN TX",12,2,2,0,0,2,-97.69669342,26.19152069
232,"HARRISBURG PA",12,2,2,0,0,2,-76.88382721,40.27407455
232,"HARRISONBURG VA",12,2,2,0,0,2,-78.86815643,38.44975281
232,"HARRISONVILLE MO",12,2,0,0,2,2,-94.34924316,38.65325928
232,"HARTFORD CT",12,8,4,0,4,8,-72.68445587,41.76383591
232,"HARTSVILLE SC",12,2,0,0,2,2,-80.07303619,34.37445068
232,"HATTIESBURG MS",12,2,0,2,0,2,-89.29040527,31.32738686
232,"HAYWARD CA",12,2,2,0,0,2,-122.0832672,37.66890335
232,"HELENA MT",12,2,0,0,2,2,-112.0374527,46.59269333
232,"HENDERSON NV",12,12,6,2,4,12,-114.9741058,36.03540421
232,"HENDERSONVILLE NC",12,4,0,2,2,4,-82.46079254,35.31912994
232,"HENDERSONVILLE TN",12,2,0,0,2,2,-86.61997986,36.30472565
232,"HERMISTON OR",12,8,0,4,4,8,-119.2915268,45.84025192
232,"HESPERIA CA",12,2,2,0,0,2,-117.3026352,34.42634964
232,"HIALEAH FL",12,2,2,0,0,2,-80.27757263,25.85853386
232,"HICKORY NC",12,2,0,0,2,2,-81.34054565,35.72800827
232,"HIGHLAND PARK NJ",12,2,0,0,2,2,-74.4232254,40.49617386
232,"HILLIARD OH",12,2,2,0,0,2,-83.15856171,40.03361511
232,"HILLSBORO OR",12,16,4,4,8,16,-122.9927826,45.52270508
232,"HOLLY SPRINGS GA",12,2,2,0,0,2,-84.50123596,34.17427826
232,"HOLLYWOOD FL",12,2,0,0,2,2,-80.14926147,26.01175499
232,"HOMESTEAD FL",12,2,0,2,0,2,-80.47710419,25.46927071
232,"HOT SPRINGS AR",12,4,2,0,2,4,-93.05556488,34.5039978
232,"HOUSTON MS",12,2,0,0,2,2,-88.99927521,33.89876556
232,"HOUSTON TX",12,244,76,66,102,244,-95.36399841,29.76376343
232,"HUNTINGTON NY",12,6,2,2,2,6,-73.42463684,40.86833191
232,"HUNTINGTON WV",12,2,0,2,0,2,-82.44620514,38.4181366
232,"HUNTSVILLE AL",12,18,6,2,10,18,-86.58609772,34.73073959
232,"IDAHO FALLS ID",12,2,0,2,0,2,-112.035408,43.46630478
232,"INDEPENDENCE MO",12,14,4,4,6,14,-94.41611481,39.09104538
232,"INDIAN TRAIL NC",12,2,0,0,2,2,-80.66901398,35.07696915
232,"INDIANA PA",12,2,0,0,2,2,-79.15187073,40.6216507
232,"INDIANAPOLIS IN",12,58,14,8,36,58,-86.15828705,39.76844788
232,"INGLEWOOD CA",12,4,2,0,2,4,-118.354805,33.96157074
232,"IOWA CITY IA",12,14,4,2,8,14,-91.53023529,41.66130066
232,"IRVINE CA",12,6,0,2,4,6,-117.8243942,33.66952515
232,"IRVING TX",12,2,2,0,0,2,-96.94924927,32.81419754
232,"IRVINGTON KY",12,2,2,0,0,2,-86.28356934,37.88031387
232,"ITHACA NY",12,10,2,4,4,10,-76.49575043,42.44075775
232,"JACKSON MS",12,2,0,0,2,2,-90.19654846,32.298172
232,"JACKSON SC",12,2,0,0,2,2,-81.78768158,33.32559586
232,"JACKSON TN",12,12,4,2,6,12,-88.81397247,35.61472321
232,"JACKSONVILLE BEACH FL",12,6,4,0,2,6,-81.39300537,30.29505539
232,"JACKSONVILLE FL",12,16,8,4,4,16,-81.65545654,30.33253288
232,"JACKSONVILLE NC",12,6,0,2,4,6,-77.42939758,34.75283813
232,"JANESVILLE WI",12,4,0,0,4,4,-89.01893616,42.68303299
232,"JERSEY CITY NJ",12,26,8,4,14,26,-74.07667542,40.72816849
232,"JOHNSON AR",12,2,0,0,2,2,-94.16587067,36.13319397
232,"JOHNSON CITY TN",12,2,0,0,2,2,-82.35308075,36.31352615
232,"JOLIET IL",12,18,4,6,8,18,-88.08213043,41.52493668
232,"JUPITER FL",12,10,0,2,8,10,-80.09382629,26.9349556
232,"KALAMAZOO MI",12,8,2,4,2,8,-85.58725739,42.29179764
232,"KANSAS CITY MO",12,160,70,24,66,160,-94.57884979,39.09976578
232,"KEARNEY NE",12,2,0,2,0,2,-99.08208466,40.69932938
232,"KEARNY NJ",12,2,0,2,0,2,-74.14439392,40.76873398
232,"KELLER TX",12,2,2,0,0,2,-97.25247192,32.93486786
232,"KENNESAW GA",12,2,0,0,2,2,-84.61528015,34.02365875
232,"KENNEWICK WA",12,2,0,2,0,2,-119.1395264,46.2107811
232,"KENT OH",12,2,0,0,2,2,-81.35736084,41.15368271
232,"KETTERING OH",12,2,2,0,0,2,-84.1687088,39.68964005
232,"KEY BISCAYNE FL",12,2,2,0,0,2,-80.16217804,25.6944294
232,"KEY WEST FL",12,16,6,6,4,16,-81.78218079,24.556427
232,"KEYSTONE HEIGHTS FL",12,4,2,2,0,4,-82.03114319,29.78640366
232,"KINGSPORT TN",12,4,2,0,2,4,-82.56182861,36.54841232
232,"KINNELON NJ",12,2,0,0,2,2,-74.36607361,41.00188065
232,"KIRKLAND WA",12,16,4,4,8,16,-122.2108688,47.6813736
232,"KNOXVILLE TN",12,22,4,4,14,22,-83.92067719,35.96077728
232,"KOKOMO IN",12,4,0,0,4,4,-86.12706757,40.48566818
232,"LA MIRADA CA",12,2,2,0,0,2,-118.0295639,33.85194778
232,"LA VERNE CA",12,2,0,0,2,2,-117.7696304,34.1006546
232,"LAFAYETTE CO",12,8,2,4,2,8,-105.0904388,39.99370956
232,"LAFAYETTE IN",12,2,0,0,2,2,-86.88406372,40.42077255
232,"LAFAYETTE LA",12,20,2,6,12,20,-92.01987457,30.22468185
232,"LAGUNA BEACH CA",12,2,0,0,2,2,-117.7847061,33.54205322
232,"LAKE HAVASU CITY AZ",12,6,2,2,2,6,-114.3244324,34.48379517
232,"LAKE STATION IN",12,4,4,0,0,4,-87.23908997,41.57525253
232,"LAKEWOOD NJ",12,2,2,0,0,2,-74.21684265,40.09822845
232,"LAKEWOOD OH",12,2,0,2,0,2,-81.79773712,41.48223114
232,"LANCASTER PA",12,14,8,2,4,14,-76.30498505,40.03824234
232,"LANSDALE PA",12,2,0,0,2,2,-75.28330994,40.24167633
232,"LANSING MI",12,8,2,0,6,8,-84.55532074,42.73265839
232,"LAREDO TX",12,4,2,0,2,4,-99.50824738,27.50720978
232,"LARGO FL",12,2,0,0,2,2,-82.78675079,27.91026115
232,"LAS CRUCES NM",12,4,0,4,0,4,-106.7798538,32.31209564
232,"LAS VEGAS NV",12,138,46,48,44,138,-115.1382141,36.17488098
232,"LAWRENCE KS",12,20,10,2,8,20,-95.23565674,38.97153091
232,"LAWRENCEBURG TN",12,2,0,2,0,2,-87.33492279,35.24256897
232,"LAWRENCEVILLE GA",12,2,2,0,0,2,-83.98753357,33.95662308
232,"LAWRENCEVILLE VA",12,2,0,0,2,2,-77.84610748,36.75788879
232,"LEANDER TX",12,4,0,0,4,4,-97.85368347,30.57936287
232,"LEBANON IN",12,2,0,0,2,2,-86.46936035,40.0486412
232,"LEESBURG FL",12,6,0,2,4,6,-81.87727356,28.81123161
232,"LESLIE MO",12,2,0,0,2,2,-91.23233795,38.41774368
232,"LEWIS IN",12,6,2,2,2,6,-87.25762177,39.26026917
232,"LEXINGTON SC",12,2,0,2,0,2,-81.23597717,33.98204041
232,"LEXINGTON VA",12,8,2,0,6,8,-79.4422226,37.78420639
232,"LIBBY MT",12,2,0,0,2,2,-115.5511856,48.38265991
232,"LIBERTY MO",12,2,2,0,0,2,-94.4196167,39.24604034
232,"LIBERTY MS",12,4,0,0,4,4,-90.81230927,31.15865898
232,"LIMA OH",12,2,2,0,0,2,-84.10490417,40.74259186
232,"LINCOLN NE",12,10,2,2,6,10,-96.6674118,40.80001068
232,"LITTLE ROCK AR",12,30,4,10,16,30,-92.28178406,34.7369194
232,"LODI CA",12,2,2,0,0,2,-121.2742386,38.12984467
232,"LOGANVILLE GA",12,2,0,0,2,2,-83.90035248,33.83914948
232,"LONG BEACH CA",12,28,10,6,12,28,-118.1908112,33.7670517
232,"LONGVIEW TX",12,2,2,0,0,2,-94.73707581,32.4966507
232,"LONGVIEW WA",12,4,0,2,2,4,-122.9404221,46.1375885
232,"LORAIN OH",12,2,0,0,2,2,-82.17118073,41.45874023
232,"LOS ANGELES CA",12,426,146,90,190,426,-118.2459106,34.05225754
232,"LOS GATOS CA",12,2,2,0,0,2,-121.9771652,37.22674561
232,"LOUISA VA",12,2,0,2,0,2,-78.00349426,38.0253067
232,"LOUISVILLE CO",12,2,2,0,0,2,-105.1326523,39.97768402
232,"LOVELAND CO",12,2,0,2,0,2,-105.0755997,40.39763641
232,"LUBBOCK TX",12,6,0,2,4,6,-101.8544312,33.59677505
232,"LYNN MA",12,2,0,2,0,2,-70.94833374,42.46699905
232,"MADELIA MN",12,2,0,2,0,2,-94.42191315,44.05470276
232,"MADISON WI",12,42,14,4,24,42,-89.40128326,43.07303619
232,"MAGDALENA NM",12,4,0,2,2,4,-107.243515,34.11511993
232,"MAHWAH NJ",12,2,2,0,0,2,-74.14279175,41.08900452
232,"MAMMOTH LAKES CA",12,2,0,2,0,2,-119.0125961,37.60457611
232,"MANCHESTER NH",12,10,6,0,4,10,-71.45406342,42.99581528
232,"MANHATTAN BEACH CA",12,2,0,0,2,2,-118.4129181,33.88484192
232,"MANHATTAN KS",12,2,0,0,2,2,-96.57228851,39.18354034
232,"MANKATO MN",12,6,0,2,4,6,-94.02125549,44.15895462
232,"MANNING SC",12,2,0,0,2,2,-80.21025085,33.69546509
232,"MANSFIELD TX",12,2,0,2,0,2,-97.14230347,32.56362152
232,"MANTECA CA",12,2,0,2,0,2,-121.2179031,37.79747391
232,"MARIETTA GA",12,16,0,12,4,16,-84.54958344,33.9527359
232,"MARINA CA",12,2,0,0,2,2,-121.8042831,36.6841507
232,"MARSHALL MI",12,6,6,0,0,6,-84.9631424,42.27227402
232,"MARYSVILLE MI",12,2,2,0,0,2,-82.48686218,42.91244888
232,"MARYVILLE TN",12,2,2,0,0,2,-83.96243286,35.76000977
232,"MASCOUTAH IL",12,2,0,2,0,2,-89.79308319,38.49026489
232,"MAYVILLE WI",12,2,0,0,2,2,-88.54499817,43.49409103
232,"MCALLEN TX",12,4,0,2,2,4,-98.23077393,26.20433426
232,"MCMINNVILLE OR",12,4,0,0,4,4,-123.2019272,45.20968628
232,"MEDFORD MA",12,2,0,0,2,2,-71.10526276,42.41849518
232,"MEDFORD OR",12,2,0,0,2,2,-122.8773193,42.32625961
232,"MEMPHIS TN",12,42,16,6,20,42,-90.01696014,35.1194191
232,"MENA AR",12,6,2,2,2,6,-94.24035645,34.58638
232,"MENLO PARK CA",12,6,0,2,4,6,-122.1842423,37.45361328
232,"MENOMONEE FALLS WI",12,2,2,0,0,2,-88.11719513,43.17907715
232,"MERCED CA",12,2,0,2,0,2,-120.4848785,37.30197525
232,"MERIDIAN MS",12,2,0,0,2,2,-88.70374298,32.36473846
232,"MESA AZ",12,8,0,2,6,8,-111.8239059,33.42222214
232,"MESQUITE TX",12,2,0,2,0,2,-96.59959412,32.76692581
232,"MIAMI BEACH FL",12,2,0,2,0,2,-80.12982178,25.79146576
232,"MIAMI FL",12,108,24,18,66,108,-80.19329071,25.77483749
232,"MIDDLETOWN CT",12,2,0,0,2,2,-72.64955902,41.56232071
232,"MILL VALLEY CA",12,2,0,2,0,2,-122.5473328,37.90579224
232,"MILLSBORO DE",12,4,0,2,2,4,-75.29344177,38.58910751
232,"MILTON FL",12,2,0,0,2,2,-87.03953552,30.63289833
232,"MILWAUKEE WI",12,40,18,4,18,40,-87.90684509,43.03887939
232,"MINDEN LA",12,32,6,2,24,32,-93.28716278,32.61589432
232,"MINNEAPOLIS MN",12,140,52,34,54,140,-93.26397705,44.97980118
232,"MISSOULA MT",12,8,6,2,0,8,-113.9832687,46.87278366
232,"MOBILE AL",12,12,4,0,8,12,-88.04309845,30.69476128
232,"MODESTO CA",12,2,2,0,0,2,-120.9991455,37.63897324
232,"MOLINE IL",12,2,0,0,2,2,-90.51522064,41.5069809
232,"MONTCLAIR NJ",12,2,0,0,2,2,-74.20848083,40.82605362
232,"MONTEREY CA",12,4,2,2,0,4,-121.8974838,36.6002388
232,"MONTGOMERY AL",12,8,4,2,2,8,-86.29966736,32.36724472
232,"MOORPARK CA",12,4,2,2,0,4,-118.8839111,34.28554535
232,"MORGANTOWN WV",12,14,6,4,4,14,-79.95038605,39.63131714
232,"MORRIS MN",12,2,0,0,2,2,-95.91436005,45.58617401
232,"MORROW GA",12,10,4,4,2,10,-84.33943939,33.58339691
232,"MOSCOW ID",12,2,2,0,0,2,-117.0021973,46.73223877
232,"MOUND VALLEY KS",12,2,0,2,0,2,-95.40553284,37.20561218
232,"MOUNT VERNON MO",12,2,0,0,2,2,-93.81912231,37.10396194
232,"MUNCIE IN",12,4,0,2,2,4,-85.38398743,40.18970871
232,"MUNISING MI",12,2,2,0,0,2,-86.64807892,46.410923
232,"MURFREESBORO TN",12,10,6,0,4,10,-86.39038086,35.84575653
232,"MURPHY TX",12,2,2,0,0,2,-96.61357117,33.01515198
232,"MURRIETA CA",12,4,0,2,2,4,-117.2157898,33.55398941
232,"MUSCATINE IA",12,2,0,0,2,2,-91.05540466,41.4216156
232,"MUSKEGON MI",12,4,0,0,2,2,-86.25441742,43.23139763
232,"MYRTLE BEACH SC",12,4,4,0,0,4,-78.88601685,33.69656372
232,"NAPERVILLE IL",12,4,0,2,2,4,-88.14768219,41.78578949
232,"NEENAH WI",12,2,0,0,2,2,-88.4626236,44.18569183
232,"NEW ALBANY IN",12,4,0,0,4,4,-85.80917358,38.29167938
232,"NEW BRUNSWICK NJ",12,2,0,0,2,2,-74.45104218,40.48620987
232,"NEW HAVEN CT",12,16,6,4,6,16,-72.92726898,41.3084259
232,"NEW LONDON CT",12,2,0,0,2,2,-72.09841156,41.35572815
232,"NEW MILFORD CT",12,12,4,0,8,12,-73.40771484,41.57733917
232,"NEW ORLEANS LA",12,126,32,40,54,126,-90.07525635,29.95483589
232,"NEW YORK NY",12,542,194,134,214,542,-74.00528717,40.7145195
232,"NEWARK DE",12,12,6,2,4,12,-75.74462128,39.68774414
232,"NEWARK NJ",12,62,12,14,36,62,-74.17185211,40.73570633
232,"NEWARK OH",12,2,0,0,2,2,-82.40110779,40.05843353
232,"NEWPORT TN",12,2,2,0,0,2,-83.18756104,35.96707916
232,"NEWTON MA",12,4,0,2,2,4,-71.20809937,42.33743286
232,"NEWTOWN PA",12,2,0,0,2,2,-74.93606567,40.22966003
232,"NIXA MO",12,8,0,6,2,8,-93.29502869,37.04324341
232,"NOCONA TX",12,4,4,0,0,4,-97.72662354,33.78715515
232,"NORCO CA",12,2,0,0,2,2,-117.5555801,33.93997192
232,"NORFOLK VA",12,6,2,4,0,6,-76.28334045,36.84831619
232,"NORMAL IL",12,6,2,2,2,6,-88.99052429,40.51409912
232,"NORMAN OK",12,12,2,4,6,12,-97.44689178,35.22203827
232,"NORMANDY TN",12,4,0,2,2,4,-86.26022339,35.45226669
232,"NORTH BEND WA",12,2,2,0,0,2,-121.7899017,47.49547195
232,"NORTH BERGEN NJ",12,2,2,0,0,2,-74.0112381,40.8045845
232,"NORTH CHARLESTON SC",12,2,0,2,0,2,-79.97457886,32.85499191
232,"NORTH CHICAGO IL",12,2,0,0,2,2,-87.8412323,42.3254509
232,"NORTH LAS VEGAS NV",12,6,2,0,4,6,-115.1192093,36.19900131
232,"NORTHFIELD MN",12,2,0,0,2,2,-93.16210175,44.45811081
232,"NORTHPORT NY",12,2,0,0,2,2,-73.34220123,40.90099335
232,"O'FALLON MO",12,4,4,0,0,4,-90.69979095,38.8109436
232,"OAK PARK IL",12,2,0,0,2,2,-87.78443909,41.88500595
232,"OAKLAND CA",12,90,16,30,44,90,-122.2733154,37.80438614
232,"OBLONG IL",12,2,0,0,2,2,-87.90914154,39.00207138
232,"OCALA FL",12,4,2,0,2,4,-82.13973236,29.18780708
232,"OCEANSIDE CA",12,10,2,6,2,10,-117.3814011,33.19587326
232,"OGDEN UT",12,2,0,0,2,2,-111.9730225,41.22582626
232,"OKLAHOMA CITY OK",12,24,4,6,14,24,-97.51699829,35.46761322
232,"OLATHE KS",12,4,0,0,4,4,-94.81970215,38.88142395
232,"OLYMPIA FIELDS IL",12,2,2,0,0,2,-87.67446899,41.51344299
232,"OLYMPIA WA",12,14,2,4,8,14,-122.8909378,47.04053497
232,"OMAHA NE",12,32,14,4,14,32,-95.93825531,41.25878906
232,"ONTARIO CA",12,4,2,0,2,4,-117.6528702,34.06340408
232,"ORANGE CA",12,6,0,2,4,6,-117.8544846,33.7877388
232,"ORANGE CITY IA",12,4,0,4,0,4,-96.05925751,43.00707626
232,"ORANGE PARK FL",12,2,2,0,0,2,-81.70614624,30.16655731
232,"ORLANDO FL",12,46,14,14,18,46,-81.3789978,28.53886795
232,"ORMOND BEACH FL",12,6,4,0,2,6,-81.05541992,29.28623772
232,"OROVILLE CA",12,2,0,0,2,2,-121.5581131,39.51348877
232,"OSWEGO NY",12,2,0,2,0,2,-76.50988007,43.45563889
232,"OVERLAND PARK KS",12,4,0,2,2,4,-94.67124939,38.98216248
232,"OWENSBORO KY",12,2,0,2,0,2,-87.11345673,37.77421188
232,"OXFORD MS",12,6,4,0,2,6,-89.52319336,34.37203979
232,"PADUCAH KY",12,4,2,0,2,4,-88.60009766,37.08333206
232,"PALATINE IL",12,4,0,2,2,4,-88.03440857,42.11017609
232,"PALM DESERT CA",12,2,0,0,2,2,-116.3907166,33.72164154
232,"PALM SPRINGS CA",12,8,2,2,4,8,-116.5467758,33.83036423
232,"PALMDALE CA",12,2,0,0,2,2,-118.118454,34.57925034
232,"PALO ALTO CA",12,8,6,0,2,8,-122.1449661,37.44177628
232,"PANAMA CITY BEACH FL",12,6,0,2,4,6,-85.80211639,30.1792717
232,"PANAMA CITY FL",12,8,0,6,2,8,-85.65970612,30.16412926
232,"PASADENA CA",12,24,8,6,10,24,-118.1466675,34.14794922
232,"PASCAGOULA MS",12,2,0,0,2,2,-88.55257416,30.36789703
232,"PATERSON NJ",12,126,42,24,60,126,-74.17102051,40.91714478
232,"PAWTUCKET RI",12,2,0,0,2,2,-71.38137054,41.87892532
232,"PEMBROKE PINES FL",12,6,2,0,4,6,-80.22357941,26.00384903
232,"PENSACOLA FL",12,4,0,2,2,4,-87.21669006,30.42154694
232,"PEORIA AZ",12,4,0,2,2,4,-112.2390747,33.58084106
232,"PEORIA IL",12,2,2,0,0,2,-89.59487152,40.70241928
232,"PERTH AMBOY NJ",12,2,0,0,2,2,-74.26480103,40.5068779
232,"PETERSBURG VA",12,4,0,0,4,4,-77.40148926,37.2280426
232,"PHENIX CITY AL",12,2,0,0,2,2,-85.00059509,32.4714241
232,"PHILADELPHIA PA",12,238,58,60,120,238,-75.16322327,39.95243835
232,"PHILIPSBURG PA",12,2,0,2,0,2,-78.22016144,40.89661789
232,"PHOENIX AZ",12,72,30,22,20,72,-112.0752716,33.44825363
232,"PICO RIVERA CA",12,2,2,0,0,2,-118.0985489,33.983284
232,"PIERPONT SD",12,2,0,2,0,2,-97.82962036,45.49657059
232,"PISMO BEACH CA",12,2,0,2,0,2,-120.6432953,35.1427269
232,"PITTSBURGH PA",12,84,34,14,36,84,-79.99537659,40.44091415
232,"PLANO TX",12,20,6,6,8,20,-96.69931793,33.01993942
232,"PLANTATION FL",12,2,0,0,2,2,-80.23281097,26.12825966
232,"POMPANO BEACH FL",12,2,0,2,0,2,-80.12407684,26.23855591
232,"PONTIAC MI",12,16,4,2,10,16,-83.29104614,42.63900757
232,"POPLAR BLUFF MO",12,2,0,0,2,2,-90.3928833,36.75717545
232,"PORT CHESTER NY",12,2,2,0,0,2,-73.66493225,41.00179291
232,"PORT HURON MI",12,4,0,0,4,4,-82.42453766,42.97105026
232,"PORT ORANGE FL",12,8,0,0,8,8,-81.00856781,29.13491631
232,"PORT ORFORD OR",12,2,0,0,2,2,-124.4993668,42.74531555
232,"PORTLAND ME",12,24,10,8,6,24,-70.25403595,43.6618576
232,"PORTLAND OR",12,256,86,72,98,256,-122.6786423,45.52309418
232,"PORTSMOUTH VA",12,2,0,0,2,2,-76.29769135,36.83554077
232,"POTTSTOWN PA",12,6,2,0,4,6,-75.64894867,40.24571609
232,"POUGHKEEPSIE NY",12,4,2,0,2,4,-73.92034149,41.70055771
232,"PRATTVILLE AL",12,8,2,4,2,8,-86.45972443,32.46446228
232,"PRINCETON NJ",12,4,2,0,2,4,-74.65805817,40.34872055
232,"PRINCETON WV",12,2,0,0,2,2,-81.09912872,37.36967468
232,"PROVIDENCE RI",12,40,14,8,18,40,-71.40118408,41.82990265
232,"PROVINCETOWN MA",12,24,8,6,10,24,-70.17770386,42.05849075
232,"PROVO UT",12,2,2,0,0,2,-111.6589813,40.23337936
232,"PULLMAN WA",12,4,2,2,0,4,-117.180481,46.73068619
232,"QUEEN CREEK AZ",12,2,0,0,2,2,-111.6382294,33.25391769
232,"QUINCY IL",12,4,0,2,2,4,-91.41021729,39.9356575
232,"QUINCY MA",12,4,4,0,0,4,-71.00706482,42.24961472
232,"RACINE WI",12,4,0,2,2,4,-87.78296661,42.72628021
232,"RALEIGH NC",12,54,12,14,28,54,-78.63800049,35.77230835
232,"RAYTOWN MO",12,10,0,6,4,10,-94.46369934,39.00871277
232,"READING PA",12,2,2,0,0,2,-75.9259491,40.33562851
232,"RED LION PA",12,2,0,0,2,2,-76.60523987,39.9010849
232,"REDDING CA",12,6,4,2,0,6,-122.3944626,40.58649826
232,"REDKEY IN",12,2,0,0,2,2,-85.14984131,40.34886932
232,"REDLANDS CA",12,2,0,0,2,2,-117.21064,34.0318718
232,"REDMOND WA",12,4,2,0,2,4,-122.1240006,47.67367172
232,"REDONDO BEACH CA",12,16,2,4,10,16,-118.3907471,33.84916687
232,"REDWOOD CITY CA",12,12,4,2,6,12,-122.2364655,37.48601151
232,"RENO NV",12,42,8,4,30,42,-119.8160934,39.5294838
232,"RHOME TX",12,2,2,0,0,2,-97.47286224,33.05379486
232,"RICE LAKE WI",12,10,0,2,8,10,-91.73868561,45.5060463
232,"RICHMOND CA",12,10,4,0,6,10,-122.3500443,37.9354744
232,"RICHMOND HEIGHTS MO",12,4,4,0,0,4,-90.31951904,38.62892532
232,"RICHMOND KY",12,6,0,2,4,6,-84.29437256,37.74818802
232,"RICHMOND TX",12,2,0,2,0,2,-95.76106262,29.58276558
232,"RICHMOND VA",12,14,6,4,4,14,-77.45962524,37.55412674
232,"RIDGELAND MS",12,8,2,2,4,8,-90.13221741,32.42857742
232,"RIVERDALE GA",12,4,0,2,2,4,-84.4131012,33.57296371
232,"RIVERDALE IL",12,2,2,0,0,2,-87.633255,41.6336174
232,"RIVERSIDE CA",12,14,4,2,8,14,-117.3973999,33.95311737
232,"ROANOKE VA",12,2,0,0,2,2,-79.94111633,37.27119827
232,"ROBARDS KY",12,4,0,4,0,4,-87.546875,37.67383957
232,"ROCHESTER NH",12,2,0,0,2,2,-70.97436523,43.30452728
232,"ROCHESTER NY",12,38,14,2,22,38,-77.61522675,43.15487671
232,"ROCK HILL SC",12,2,0,0,2,2,-81.02463531,34.92498779
232,"ROCKFORD IL",12,8,2,0,6,8,-89.09428406,42.27135086
232,"ROCKLAND MA",12,2,0,0,2,2,-70.91507721,42.13067245
232,"ROCKLIN CA",12,2,2,0,0,2,-121.2383118,38.79031754
232,"ROCKPORT MA",12,2,0,0,2,2,-70.61954498,42.65607071
232,"ROCKVILLE MD",12,10,2,4,4,10,-77.15235901,39.08402252
232,"ROCKY MOUNT NC",12,2,0,0,2,2,-77.78997803,35.93837738
232,"ROME GA",12,2,0,0,2,2,-85.16900635,34.24008942
232,"ROSEMOUNT MN",12,2,2,0,0,2,-93.12598419,44.73943329
232,"ROUND ROCK TX",12,2,2,0,0,2,-97.67939758,30.50861359
232,"ROWLETT TX",12,2,2,0,0,2,-96.56422424,32.90298462
232,"RYE CO",12,4,2,0,2,4,-104.9316177,37.92366791
232,"SACRAMENTO CA",12,54,20,12,22,54,-121.4959793,38.58154297
232,"SALEM MA",12,2,0,2,0,2,-70.89565277,42.51993179
232,"SALISBURY MD",12,10,0,4,6,10,-75.5984726,38.36100388
232,"SALISBURY NC",12,8,0,0,8,8,-80.47377014,35.67113495
232,"SALT LAKE CITY UT",12,12,4,6,2,12,-111.8912659,40.77029037
232,"SAN ANTONIO TX",12,78,20,12,46,78,-98.49394989,29.42439651
232,"SAN BERNARDINO CA",12,2,0,0,2,2,-117.304596,34.12142563
232,"SAN DIEGO CA",12,132,44,32,56,132,-117.1587296,32.71524429
232,"SAN FRANCISCO CA",12,172,78,26,68,172,-122.4213257,37.77465057
232,"SAN JOSE CA",12,32,16,6,10,32,-121.8973846,37.33491516
232,"SAN LEANDRO CA",12,2,0,0,2,2,-122.155983,37.70180511
232,"SAN LUIS OBISPO CA",12,6,2,2,2,6,-120.6622849,35.28281021
232,"SAN MARCOS CA",12,12,6,4,2,12,-117.1673966,33.14345551
232,"SAN MATEO CA",12,4,2,0,2,4,-122.3270264,37.56283569
232,"SAN RAMON CA",12,4,2,0,2,4,-121.9799347,37.77985764
232,"SANDUSKY OH",12,2,0,0,2,2,-82.7080307,41.44903183
232,"SANFORD FL",12,6,2,2,2,6,-81.27256012,28.80128288
232,"SANTA BARBARA CA",12,18,6,2,10,18,-119.7056656,34.4233017
232,"SANTA CRUZ CA",12,6,2,2,2,6,-122.0333557,36.97389984
232,"SANTA MONICA CA",12,12,4,6,2,12,-118.4925232,34.01921082
232,"SANTA ROSA CA",12,16,8,4,4,16,-122.7165146,38.44017792
232,"SAPULPA OK",12,2,0,0,2,2,-96.11476135,35.99878311
232,"SARANAC LAKE NY",12,2,0,2,0,2,-74.1305542,44.32965851
232,"SARASOTA FL",12,14,4,4,6,14,-82.53031158,27.33688736
232,"SARATOGA SPRINGS NY",12,2,2,0,0,2,-73.78382111,43.08345032
232,"SAUGUS MA",12,2,0,0,2,2,-71.00926971,42.46496964
232,"SAVANNAH GA",12,14,6,0,8,14,-81.09463501,32.07280731
232,"SCOTTSDALE AZ",12,6,2,2,2,6,-111.9002533,33.50918579
232,"SEATTLE WA",12,300,94,72,134,300,-122.3343964,47.60571289
232,"SEILING OK",12,2,0,0,2,2,-98.9247818,36.14834976
232,"SENECA SC",12,2,2,0,0,2,-82.95318604,34.68600845
232,"SHAWNEE KS",12,2,2,0,0,2,-94.7208786,39.0417366
232,"SHAWNEE OK",12,2,0,0,2,2,-96.92608643,35.32754898
232,"SHEBOYGAN WI",12,2,2,0,0,2,-87.71476746,43.75089264
232,"SHELTON CT",12,2,2,0,0,2,-73.09243011,41.31684494
232,"SHREVEPORT LA",12,10,2,2,6,10,-93.7507019,32.52565002
232,"SIERRA MADRE CA",12,2,0,0,2,2,-118.0547943,34.16183853
232,"SIOUX FALLS SD",12,14,10,0,4,14,-96.73429108,43.54177475
232,"SMITHVILLE TN",12,8,6,0,2,8,-85.81411743,35.96058273
232,"SMYRNA GA",12,4,2,2,0,4,-84.51447296,33.88409042
232,"SOLEDAD CA",12,2,0,0,2,2,-121.3278732,36.42473984
232,"SOMERVILLE MA",12,10,2,6,2,10,-71.09860992,42.38757324
232,"SONORA CA",12,6,2,0,4,6,-120.3842011,37.98400497
232,"SOUTH BEND IN",12,12,4,4,4,12,-86.25171661,41.67295837
232,"SOUTH LAKE TAHOE CA",12,2,2,0,0,2,-119.972786,38.94574356
232,"SOUTH PORTLAND ME",12,2,0,0,2,2,-70.23975372,43.6415062
232,"SOUTHAMPTON NY",12,6,2,0,4,6,-72.38861084,40.88444519
232,"SPARKS NV",12,4,4,0,0,4,-119.7548142,39.53468704
232,"SPARTANBURG SC",12,2,0,2,0,2,-81.93160248,34.94982529
232,"SPOKANE WA",12,12,2,0,10,12,-117.4281387,47.65847015
232,"SPRINGDALE AR",12,4,0,0,4,4,-94.12921143,36.1869278
232,"SPRINGFIELD IL",12,4,0,2,2,4,-89.6439743,39.80184174
232,"SPRINGFIELD MA",12,10,4,0,6,10,-72.57289124,42.10980606
232,"SPRINGFIELD MO",12,88,14,22,52,88,-93.29862213,37.21548843
232,"SPRINGFIELD OR",12,2,0,0,2,2,-123.024704,44.04590988
232,"SPRINGFIELD VT",12,2,2,0,0,2,-72.48161316,43.29873657
232,"ST LOUIS MO",12,938,312,220,406,938,-90.19819641,38.62716675
232,"STAMFORD CT",12,4,0,0,4,4,-73.53807068,41.05353165
232,"STATESBORO GA",12,6,0,2,4,6,-81.78266907,32.44914246
232,"STERLING CO",12,2,0,2,0,2,-103.2093811,40.62519073
232,"STERLING HEIGHTS MI",12,2,2,0,0,2,-83.03016663,42.58047485
232,"STOCKTON CA",12,2,2,0,0,2,-121.293457,37.95776749
232,"STOUGHTON MA",12,2,0,2,0,2,-71.10134888,42.12547302
232,"SUFFOLK VA",12,2,0,0,2,2,-76.58317566,36.72846985
232,"SUGAR LAND TX",12,20,8,2,10,20,-95.6352005,29.61997795
232,"SUMMERVILLE SC",12,4,0,2,2,4,-80.17547607,33.01868439
232,"SUMMIT NJ",12,2,0,2,0,2,-74.3586731,40.74148178
232,"SUNNYVALE CA",12,4,2,0,2,4,-122.0380707,37.36878967
232,"SYRACUSE NY",12,22,6,8,8,22,-76.14653015,43.04846191
232,"TACOMA WA",12,26,14,2,10,26,-122.4466705,47.25242233
232,"TAKOMA PARK MD",12,2,0,2,0,2,-77.00667572,38.97793198
232,"TALLAHASSEE FL",12,22,2,6,14,22,-84.27896881,30.44669914
232,"TAMPA FL",12,78,22,16,40,78,-82.4580307,27.94833755
232,"TAOS NM",12,24,6,2,16,24,-105.5769424,36.40658188
232,"TARPON SPRINGS FL",12,6,4,2,0,6,-82.75656128,28.14682198
232,"TAYLOR TX",12,2,2,0,0,2,-97.41002655,30.57122421
232,"TAYLORVILLE IL",12,2,0,0,2,2,-89.29446411,39.5492363
232,"TEANECK NJ",12,2,0,2,0,2,-74.01485443,40.89759064
232,"TEMPE AZ",12,18,6,2,10,18,-111.9108276,33.41504288
232,"TERRELL TX",12,2,0,2,0,2,-96.27573395,32.73627472
232,"TEWKSBURY MA",12,8,2,2,4,8,-71.23313904,42.61103439
232,"THORNTON CO",12,6,0,0,6,6,-104.9727631,39.86811829
232,"THOUSAND OAKS CA",12,2,0,0,2,2,-118.8398514,34.17078018
232,"TOLEDO OH",12,30,8,10,12,30,-83.55497742,41.66411591
232,"TOMBALL TX",12,4,0,2,2,4,-95.6162262,30.09776115
232,"TOMBSTONE AZ",12,10,4,2,4,10,-110.0689316,31.71310997
232,"TOMS RIVER NJ",12,2,0,0,2,2,-74.19700623,39.95401382
232,"TOPEKA KS",12,12,2,2,8,12,-95.67857361,39.04813766
232,"TORONTO KS",12,6,2,0,4,6,-95.94944,37.79908752
232,"TORRINGTON CT",12,2,0,0,2,2,-73.12056732,41.80105209
232,"TRACY CA",12,2,0,0,2,2,-121.427269,37.73949814
232,"TRAVERSE CITY MI",12,4,0,4,0,4,-85.6207962,44.76324844
232,"TRENTON NJ",12,2,0,2,0,2,-74.74206543,40.21709442
232,"TROY MO",12,2,2,0,0,2,-90.98098755,38.979702
232,"TROY NY",12,2,2,0,0,2,-73.69088745,42.72839737
232,"TROY OH",12,2,0,0,2,2,-84.20330811,40.03966141
232,"TUCSON AZ",12,40,8,16,16,40,-110.9277954,32.22209167
232,"TULSA OK",12,30,4,6,20,30,-95.98488617,36.1603241
232,"TUPELO MS",12,2,2,0,0,2,-88.71934509,34.26508713
232,"TURLOCK CA",12,2,0,0,2,2,-120.8488617,37.49431229
232,"TUSCALOOSA AL",12,10,2,2,6,10,-87.56897736,33.21024704
232,"TWENTYNINE PALMS CA",12,2,0,0,2,2,-116.055397,34.13557053
232,"TYLER TX",12,4,0,0,4,4,-95.3013916,32.35176468
232,"UNION MO",12,2,2,0,0,2,-91.00618744,38.44558716
232,"UNIONTOWN PA",12,2,0,0,2,2,-79.7276535,39.89894104
232,"UNIVERSITY CITY MO",12,14,8,2,4,14,-90.33391571,38.66000748
232,"UPPER MARLBORO MD",12,8,4,0,4,8,-76.74905396,38.81620026
232,"URBANA IL",12,6,2,0,4,6,-88.20746613,40.11079025
232,"VALDOSTA GA",12,10,4,0,6,10,-83.27806854,30.83293533
232,"VALLEJO CA",12,4,0,2,2,4,-122.2594299,38.1039505
232,"VARNADO LA",12,2,0,2,0,2,-89.82972717,30.89409256
232,"VENICE FL",12,2,0,0,2,2,-82.45388031,27.10065269
232,"VICKSBURG MS",12,2,0,0,2,2,-90.87818909,32.35280991
232,"VICTORIA TX",12,2,0,2,0,2,-97.00409698,28.80560303
232,"VIENNA VA",12,2,0,0,2,2,-77.2645874,38.90164566
232,"VIRGINIA BEACH VA",12,20,6,6,8,20,-75.97751617,36.8533783
232,"WACO TX",12,12,2,2,8,12,-97.14704895,31.54987144
232,"WALTHAM MA",12,2,0,0,2,2,-71.2346344,42.37656403
232,"WARNER ROBINS GA",12,10,2,2,6,10,-83.59963989,32.62118149
232,"WARREN MI",12,16,6,6,4,16,-83.02783203,42.47764969
232,"WARREN OH",12,4,2,0,2,4,-80.81771851,41.23757935
232,"WARWICK NY",12,2,2,0,0,2,-74.35926819,41.25672531
232,"WARWICK RI",12,2,0,0,2,2,-71.37738037,41.69232941
232,"WASHINGTON DC",12,890,304,194,392,890,-77.01257324,38.88911819
232,"WATERTOWN SD",12,2,2,0,0,2,-97.11455536,44.9015274
232,"WAUKESHA WI",12,4,2,0,2,4,-88.23146057,43.01194382
232,"WAUWATOSA WI",12,2,2,0,0,2,-88.00754547,43.04960632
232,"WAYNE NE",12,2,0,2,0,2,-97.01864624,42.23064804
232,"WEAVERVILLE NC",12,4,2,2,0,4,-82.56031799,35.6974411
232,"WEBSTER NY",12,2,2,0,0,2,-77.42967224,43.21234131
232,"WEEHAWKEN NJ",12,4,2,0,2,4,-74.01938629,40.7696991
232,"WESLACO TX",12,2,0,2,0,2,-97.99131775,26.16018867
232,"WEST DES MOINES IA",12,4,2,0,2,4,-93.71179962,41.57717514
232,"WEST HOLLYWOOD CA",12,22,8,2,12,22,-118.3634567,34.08982468
232,"WEST LAFAYETTE IN",12,2,2,0,0,2,-86.9082489,40.42613983
232,"WEST ORANGE NJ",12,2,0,0,2,2,-74.23833466,40.7989006
232,"WEST PALM BEACH FL",12,24,4,6,14,24,-80.05298615,26.71585464
232,"WEST PLAINS MO",12,2,2,0,0,2,-91.85284424,36.72810745
232,"WEST SACRAMENTO CA",12,2,0,0,2,2,-121.5324554,38.58049393
232,"WEST TX",12,2,2,0,0,2,-97.09226227,31.80267906
232,"WEST VALLEY CITY UT",12,2,2,0,0,2,-111.9695816,40.69639969
232,"WESTERVILLE OH",12,2,0,0,2,2,-82.92906952,40.12620926
232,"WESTFIELD IN",12,4,2,0,2,4,-86.12757111,40.04309464
232,"WESTPORT CT",12,2,2,0,0,2,-73.35696411,41.14154053
232,"WESTPORT NY",12,2,0,0,2,2,-73.43728638,44.18396759
232,"WHEELING IL",12,4,0,0,4,4,-87.92919159,42.13937759
232,"WICHITA KS",12,4,2,2,0,4,-97.3383255,37.69230652
232,"WILKINSBURG PA",12,6,2,2,2,6,-79.88179016,40.44174194
232,"WILMINGTON DE",12,6,2,2,2,6,-75.54558563,39.74601364
232,"WILMINGTON NC",12,10,0,2,8,10,-77.94431305,34.22592926
232,"WINCHESTER VA",12,4,4,0,0,4,-78.16301727,39.18608475
232,"WINSTON-SALEM NC",12,4,0,0,4,4,-80.24356842,36.1001091
232,"WINTER PARK FL",12,2,0,2,0,2,-81.33872223,28.6003685
232,"WOODBURY MN",12,2,2,0,0,2,-92.95999908,44.92368698
232,"WOODLAND CA",12,2,0,2,0,2,-121.7751541,38.67827225
232,"WOODSTOCK VA",12,2,0,0,2,2,-78.50556183,38.88199234
232,"WORCESTER MA",12,4,0,0,4,4,-71.801651,42.26288986
232,"WORTHINGTON MN",12,2,0,2,0,2,-95.5971756,43.62000275
232,"WORTHINGTON OH",12,2,2,0,0,2,-83.01785278,40.09322739
232,"YOUNGSTOWN OH",12,174,36,28,110,174,-80.64901733,41.1000061
232,"YPSILANTI MI",12,12,0,0,12,12,-83.61315155,42.24105453
232,"YUBA CITY CA",12,2,0,2,0,2,-121.6193237,39.14025497
232,"YUKON OK",12,4,0,2,2,4,-97.76316071,35.50673294
